key_bits,recovered_zeros_x,recovered_zeros_y,wrong_zeros_x,wrong_zeros_y,queries,traces,calibration_traces,threshold,tpr,tnr,attack_tpr,attack_tnr,duration_seconds,test_outcomes_0_false,test_outcomes_0_true,test_outcomes_1_false,test_outcomes_1_true,test_outcomes_2_false,test_outcomes_2_true
17669,10801,11796,6,4,33883,,,,,,1,1,6.871027651,17527,8022,7710,312,1,311
17669,11113,9767,3,0,34139,,,,,,1,1,7.037841823,18153,7865,7609,256,1,255
17669,9853,11346,2,2,34764,,,,,,1,1,7.093905904,18273,8076,7737,339,15,324
17669,10061,12227,2,2,34518,,,,,,1,1,7.10496228,17949,8119,7788,331,2,329
17669,9690,10568,4,0,35181,,,,,,1,1,7.1255593,18291,8306,8028,278,1,277
17669,10896,9351,1,1,35364,,,,,,1,1,7.193919755,18619,8243,7984,259,1,258
17669,10229,9893,2,0,35542,,,,,,1,1,7.22482945,18522,8358,8054,304,2,302
17669,10013,10479,0,2,35612,,,,,,1,1,7.29856562,18351,8467,8140,327,4,323
17669,11500,10477,2,0,36044,,,,,,1,1,7.321469413,18499,8607,8276,331,1,330
17669,11332,10269,2,0,35423,,,,,,1,1,7.325127395,18292,8406,8087,319,8,311
17669,10496,9551,2,0,35840,,,,,,1,1,7.329417525,18631,8455,8156,299,7,292
17669,9619,9271,2,2,35752,,,,,,1,1,7.385585487,18726,8378,8108,270,11,259
17669,10436,10417,0,0,36707,,,,,,1,1,7.415357927,18516,8931,8602,329,1,328
17669,10413,10261,2,0,36196,,,,,,1,1,7.419384163,18561,8661,8348,313,1,312
17669,10999,9018,3,0,36591,,,,,,1,1,7.422556868,19217,8526,8204,322,2,320
17669,10102,10412,0,0,36743,,,,,,1,1,7.464647332,19076,8681,8376,305,1,304
17669,10230,11263,0,1,37302,,,,,,1,1,7.559865254,18925,9025,8698,327,0,327
17669,10199,9012,2,0,37511,,,,,,1,1,7.568476866,19379,8933,8667,266,1,265
17669,9514,10878,2,0,36191,,,,,,1,1,7.577782557,18260,8829,8556,273,2,271
17669,10902,10424,4,0,36526,,,,,,1,1,7.645685845,18746,8732,8416,316,7,309
17669,11143,10930,2,5,38247,,,,,,1,1,7.824304813,19094,9395,9032,363,7,356
17669,10845,8230,2,0,38985,,,,,,1,1,7.880000859,19678,9509,9220,289,5,284
17669,9507,10574,0,2,38640,,,,,,1,1,7.971418247,19557,9393,9096,297,7,290
17669,10030,11147,0,2,39034,,,,,,1,1,8.003387209,19461,9610,9257,353,9,344
17669,11887,11314,2,0,6691,,,,,,1,1,1.360618225,3207,1634,1418,216,0,216
17669,11017,9763,1,2,35989,,,,,,1,1,7.307852958,18559,8547,8211,336,7,329
17669,10003,11079,0,0,35426,,,,,,1,1,7.18397336,18446,8345,8055,290,1,289
17669,10888,9079,0,0,37194,,,,,,1,1,7.525407792,18980,8950,8636,314,1,313
17669,10736,9657,2,2,35456,,,,,,1,1,7.186451252,18402,8388,8110,278,3,275
17669,10341,8234,0,0,36753,,,,,,1,1,7.527634003,18950,8776,8525,251,2,249
17669,10951,9302,1,0,35764,,,,,,1,1,7.254214658,18221,8630,8347,283,2,281
17669,9660,10907,0,0,35814,,,,,,1,1,7.398157466,18450,8516,8184,332,0,332
17669,10382,10766,2,2,36117,,,,,,1,1,7.320535792,18462,8678,8379,299,5,294
17669,8555,10889,0,0,37380,,,,,,1,1,7.576223777,19068,8997,8679,318,10,308
17669,10096,10070,0,2,37165,,,,,,1,1,7.626475135,19053,8905,8603,302,2,300
17669,10167,11640,0,0,36390,,,,,,1,1,7.495362696,18445,8808,8479,329,2,327
17669,10490,9100,0,0,36146,,,,,,1,1,7.270228682,18444,8700,8398,302,3,299
17669,10820,10876,0,0,37624,,,,,,1,1,7.559524241,19038,9116,8762,354,3,351
17669,10800,10463,0,0,37612,,,,,,1,1,7.56226832,19103,9086,8749,337,1,336
17669,10410,12358,4,2,36277,,,,,,1,1,7.493306557,18631,8648,8298,350,11,339
17669,9572,9736,0,0,38912,,,,,,1,1,8.010785723,19413,9582,9247,335,4,331
17669,10377,10543,0,0,36269,,,,,,1,1,7.529394534,18750,8604,8293,311,4,307
17669,10889,10304,5,0,37284,,,,,,1,1,7.615706621,19185,8897,8592,305,1,304
17669,10549,9811,0,2,35198,,,,,,1,1,7.199315399,18490,8224,7964,260,4,256
17669,9666,11616,2,0,38070,,,,,,1,1,7.655320639,19114,9302,8950,352,4,348
17669,11271,10780,0,0,36021,,,,,,1,1,7.262853186,18416,8622,8261,361,5,356
17669,9158,10676,0,0,36571,,,,,,1,1,7.365366351,19037,8621,8329,292,1,291
17669,10686,9868,0,0,36762,,,,,,1,1,7.426937729,18952,8756,8458,298,3,295
17669,9633,10520,2,2,36180,,,,,,1,1,7.395711163,18860,8509,8207,302,8,294
17669,11397,11789,4,0,27971,,,,,,1,1,5.684985271,14208,6704,6349,355,6,349
17669,9476,11230,0,2,34805,,,,,,1,1,7.086879198,18241,8145,7871,274,5,269
17669,9609,11629,2,0,32660,,,,,,1,1,6.689937552,17475,7440,7135,305,2,303
17669,10379,10400,2,0,32058,,,,,,1,1,6.764079575,17002,7403,7153,250,3,247
17669,10130,10455,2,2,37364,,,,,,1,1,7.580685454,19275,8873,8530,343,2,341
17669,12027,9539,0,0,34209,,,,,,1,1,7.070100848,17968,7969,7666,303,1,302
17669,10224,11254,3,0,35686,,,,,,1,1,7.300424523,18339,8517,8204,313,9,304
17669,10788,9178,0,3,36147,,,,,,1,1,7.315623528,18585,8628,8322,306,5,301
17669,9752,12383,0,0,37050,,,,,,1,1,7.500882528,18748,8974,8620,354,1,353
17669,11495,9126,3,2,35538,,,,,,1,1,7.226856936,18272,8483,8183,300,4,296
17669,11089,11550,0,4,35455,,,,,,1,1,7.296218293,18459,8343,8033,310,4,306
17669,12078,10376,0,2,35691,,,,,,1,1,7.250358256,18179,8589,8255,334,4,330
17669,10169,10384,0,1,36264,,,,,,1,1,7.344643056,18746,8601,8285,316,0,316
17669,9878,9736,7,2,35316,,,,,,1,1,7.239333221,18436,8307,8041,266,5,261
17669,10324,10933,1,2,36934,,,,,,1,1,7.604394545,18985,8813,8490,323,3,320
17669,10866,11704,6,2,34981,,,,,,1,1,7.130288812,18189,8237,7919,318,8,310
17669,8807,10122,0,2,35143,,,,,,1,1,7.185608522,18381,8249,7985,264,3,261
17669,10521,11357,4,0,35769,,,,,,1,1,7.260289464,18271,8582,8248,334,2,332
17669,8550,9701,0,2,36438,,,,,,1,1,7.398945208,19213,8485,8230,255,7,248
17669,9377,11126,0,0,36455,,,,,,1,1,7.529123152,18628,8761,8456,305,2,303
17669,10454,9687,4,1,38461,,,,,,1,1,7.84756491,19777,9182,8862,320,19,301
17669,11656,11235,1,0,36507,,,,,,1,1,7.569706544,18568,8787,8422,365,1,364
17669,11168,9780,4,0,38461,,,,,,1,1,7.7304084379999995,19281,9405,9035,370,17,353
17669,7995,9070,4,2,37020,,,,,,1,1,7.735144679,18972,8914,8694,220,3,217
17669,10463,10971,0,2,36251,,,,,,1,1,7.353593633,18547,8693,8375,318,9,309
17669,9712,10758,1,2,36950,,,,,,1,1,7.473436959,18973,8834,8525,309,4,305
17669,12068,10275,2,2,34179,,,,,,1,1,7.016985627,17824,8005,7660,345,2,343
17669,10796,11392,2,0,36283,,,,,,1,1,7.333186031,18518,8724,8407,317,3,314
17669,10382,10026,0,0,37247,,,,,,1,1,7.514967242,18866,9024,8691,333,2,331
17669,10801,10537,4,1,34573,,,,,,1,1,7.057265503,18195,8041,7745,296,4,292
17669,10598,9873,2,0,34187,,,,,,1,1,7.015350292,17864,8019,7734,285,1,284
17669,10355,10827,2,4,35453,,,,,,1,1,7.171677785,18428,8350,8025,325,4,321
17669,9047,10326,0,0,35847,,,,,,1,1,7.262057177,18396,8578,8283,295,0,295
17669,10609,10691,1,4,36027,,,,,,1,1,7.340217507,18632,8549,8252,297,2,295
17669,7964,10771,0,0,37209,,,,,,1,1,7.5211341449999995,19094,8906,8603,303,3,300
17669,9771,8009,0,0,38421,,,,,,1,1,7.748346646,19640,9266,9017,249,3,246
17669,10514,10369,0,2,38253,,,,,,1,1,7.87428132,19392,9252,8895,357,1,356
17669,10328,9710,0,0,37638,,,,,,1,1,7.6467825430000005,19095,9124,8829,295,5,290
17669,10333,10046,2,0,34910,,,,,,1,1,7.197624486,18240,8167,7831,336,6,330
17669,11160,9551,3,0,35291,,,,,,1,1,7.265479432,18570,8212,7915,297,5,292
17669,9456,10514,0,0,37760,,,,,,1,1,7.5812940300000005,19189,9125,8804,321,4,317
17669,9727,11423,0,2,35052,,,,,,1,1,7.102051059,18017,8357,8036,321,5,316
17669,9517,11718,0,0,37921,,,,,,1,1,7.892837409,18895,9340,8994,346,2,344
17669,10476,10432,0,0,37579,,,,,,1,1,7.728637104,19051,9101,8775,326,4,322
17669,10341,10864,4,0,38578,,,,,,1,1,7.831579855,19569,9324,8963,361,7,354
17669,10011,10511,0,0,37051,,,,,,1,1,7.607938783,18809,8959,8635,324,1,323
17669,10020,9149,2,0,37848,,,,,,1,1,7.750075666,19175,9184,8879,305,4,301
17669,11854,11618,2,0,5203,,,,,,1,1,1.062760305,2558,1218,1009,209,0,209
17669,10364,9734,0,0,35218,,,,,,1,1,7.32768092,18372,8271,7967,304,3,301
17669,9334,9937,2,2,37008,,,,,,1,1,7.603635457,18983,8885,8630,255,1,254
17669,10742,11036,2,0,34463,,,,,,1,1,6.976497095,18132,8013,7708,305,3,302
17669,9328,10888,0,4,36251,,,,,,1,1,7.436792457,18749,8601,8301,300,0,300
17669,9589,11362,0,4,35878,,,,,,1,1,7.354512227,18373,8593,8274,319,6,313
17669,10905,10413,2,0,36354,,,,,,1,1,7.406937934,18556,8732,8398,334,2,332
17669,11707,11202,0,0,33920,,,,,,1,1,6.962469505,17890,7861,7553,308,3,305
17669,10832,10742,0,2,36713,,,,,,1,1,7.667174217,18548,8928,8619,309,5,304
17669,8674,11416,0,2,37584,,,,,,1,1,7.71014267,19039,9127,8836,291,3,288
17669,11814,10124,3,0,38066,,,,,,1,1,7.867038969,18746,9474,9102,372,6,366
17669,11578,11298,2,0,35163,,,,,,1,1,7.241161846,18428,8184,7817,367,12,355
17669,9628,9453,0,2,36949,,,,,,1,1,7.729937738,19052,8800,8503,297,2,295
17669,10042,12784,2,0,33006,,,,,,1,1,7.14058234,17482,7605,7291,314,2,312
17669,9940,9956,0,0,36761,,,,,,1,1,7.517524087,18698,8891,8610,281,2,279
17669,9494,10974,2,1,34388,,,,,,1,1,7.219632102,17903,8086,7773,313,6,307
17669,9723,10928,2,0,34624,,,,,,1,1,7.248559599,18028,8147,7845,302,3,299
17669,11364,11093,2,3,36707,,,,,,1,1,7.531668915,18563,8895,8541,354,4,350
17669,10016,10626,5,2,35584,,,,,,1,1,7.416447772,18618,8336,8042,294,7,287
17669,8963,10282,0,2,34475,,,,,,1,1,7.125604926,18498,7869,7630,239,1,238
17669,9633,10889,2,0,34605,,,,,,1,1,7.237948068,18117,8100,7812,288,7,281
17669,10053,12397,4,2,34206,,,,,,1,1,6.964051481,17880,8003,7683,320,11,309
17669,11410,10390,0,0,36892,,,,,,1,1,7.614742571,18802,8868,8514,354,0,354
17669,9925,11312,0,1,36079,,,,,,1,1,7.484332795,18422,8658,8317,341,1,340
17669,9510,10899,0,0,37192,,,,,,1,1,8.035810857,18874,9000,8682,318,2,316
17669,8927,8964,0,0,38897,,,,,,1,1,8.015262583,19877,9358,9054,304,1,303
17669,11128,9233,1,0,35369,,,,,,1,1,7.382901384,18440,8317,8022,295,5,290
17669,12004,10408,2,2,33785,,,,,,1,1,7.046603229,17581,7941,7619,322,4,318
17669,9312,9402,0,4,36469,,,,,,1,1,7.486338838,19275,8460,8186,274,2,272
17669,9961,11595,3,2,35705,,,,,,1,1,7.2937140750000005,18368,8518,8217,301,2,299
17669,10126,12825,0,2,32110,,,,,,1,1,6.724798336,17460,7166,6848,318,1,317
17669,10342,9789,3,0,36976,,,,,,1,1,7.55202416,18919,8864,8535,329,4,325
17669,10023,10985,0,0,36550,,,,,,1,1,7.342788604,18215,9028,8749,279,0,279
17669,10394,11395,0,0,34875,,,,,,1,1,7.156585073,18415,8074,7762,312,1,311
17669,8481,10554,0,0,37542,,,,,,1,1,8.05440318,18914,9165,8867,298,2,296
17669,11026,10104,2,3,34589,,,,,,1,1,7.272060328,18070,8098,7775,323,3,320
17669,10203,11471,2,4,34907,,,,,,1,1,7.354298764,17933,8323,7995,328,6,322
17669,11379,11149,2,0,34192,,,,,,1,1,7.1300245780000004,17746,8064,7746,318,1,317
17669,8807,10608,0,0,35599,,,,,,1,1,7.30787349,18542,8386,8101,285,4,281
17669,10098,9364,0,2,36601,,,,,,1,1,7.588767183,19007,8650,8356,294,5,289
17669,10666,10952,0,6,37049,,,,,,1,1,7.866866797,18550,9083,8750,333,3,330
17669,11090,10446,0,2,36615,,,,,,1,1,7.428214233,18806,8739,8408,331,3,328
17669,11051,10122,0,0,36180,,,,,,1,1,7.510806635,18397,8725,8392,333,5,328
17669,10357,10320,5,0,37597,,,,,,1,1,7.6926759239999996,18851,9219,8911,308,5,303
17669,10581,10804,2,2,35750,,,,,,1,1,7.316014562,18511,8445,8096,349,14,335
17669,10569,10610,0,0,37101,,,,,,1,1,7.60032255,18982,8898,8575,323,2,321
17669,9856,11465,0,1,35058,,,,,,1,1,7.878877952,18433,8158,7849,309,3,306
17669,8980,9279,2,2,38285,,,,,,1,1,7.919942689,19030,9485,9200,285,4,281
17669,10382,9607,2,0,35326,,,,,,1,1,7.431466632,18431,8305,8020,285,1,284
17669,12195,10980,2,0,8343,,,,,,1,1,1.814141883,4102,2001,1762,239,1,238
17669,8946,9186,0,0,36798,,,,,,1,1,7.631175947,19040,8751,8495,256,2,254
17669,9126,12103,0,5,35218,,,,,,1,1,7.436258439,18499,8199,7878,321,9,312
17669,9998,9898,0,0,35970,,,,,,1,1,7.908850638,18724,8480,8194,286,4,282
17669,9572,10906,0,2,37170,,,,,,1,1,7.881205667,18927,8964,8649,315,3,312
17669,10574,11205,2,0,35022,,,,,,1,1,7.422014867,18321,8188,7863,325,4,321
17669,11156,11303,0,3,32831,,,,,,1,1,6.985650395,17132,7693,7380,313,0,313
17669,9968,8507,2,0,35498,,,,,,1,1,7.714324948,18270,8483,8221,262,4,258
17669,11071,8738,0,0,36942,,,,,,1,1,7.927364764,18760,8937,8629,308,3,305
17669,10576,9802,1,0,34848,,,,,,1,1,7.525155573,18209,8170,7871,299,0,299
17669,10361,10260,2,2,35343,,,,,,1,1,7.510701829,18011,8526,8246,280,6,274
17669,9387,11315,0,0,34525,,,,,,1,1,7.493236953,17775,8237,7961,276,2,274
17669,10258,10613,0,0,37681,,,,,,1,1,7.92727407,19061,9140,8800,340,1,339
17669,9989,10379,0,0,36087,,,,,,1,1,7.998336618,18647,8543,8189,354,2,352
17669,10078,9989,0,0,35159,,,,,,1,1,7.779302035,18451,8208,7916,292,1,291
17669,10223,8637,0,0,38108,,,,,,1,1,8.109659684,19448,9184,8892,292,1,291
17669,12037,10502,2,4,37348,,,,,,1,1,8.191637625,18656,9177,8839,338,1,337
17669,11547,11643,0,0,2837,,,,,,1,1,0.572605572,1216,722,545,177,0,177
17669,10358,10907,0,3,34677,,,,,,1,1,7.362205345,18190,8079,7750,329,1,328
17669,10796,10889,0,0,37484,,,,,,1,1,8.103633606,19175,8982,8637,345,2,343
17669,10772,10447,0,0,34271,,,,,,1,1,7.227574141,17838,8065,7762,303,4,299
17669,10374,9215,2,0,38074,,,,,,1,1,8.073886108,19550,9120,8836,284,2,282
17669,10716,9284,0,0,35851,,,,,,1,1,7.68536262,18643,8460,8172,288,3,285
17669,10826,9781,2,0,37635,,,,,,1,1,8.348013641,19080,9121,8808,313,2,311
17669,10431,11336,0,4,36454,,,,,,1,1,7.96690292,18553,8778,8433,345,6,339
17669,9560,9700,0,2,37072,,,,,,1,1,7.7411356399999995,18985,8893,8592,301,10,291
17669,9869,10891,0,0,35503,,,,,,1,1,7.458822127,18299,8447,8137,310,5,305
17669,10868,12416,0,0,6506,,,,,,1,1,1.3303585359999999,3163,1557,1328,229,1,228
17669,10183,10549,2,0,36592,,,,,,1,1,7.503388237,18887,8687,8356,331,4,327
17669,11027,11095,0,0,32617,,,,,,1,1,6.78336082,17032,7625,7290,335,1,334
17669,11241,11245,0,2,35318,,,,,,1,1,7.287402349,18274,8342,7982,360,6,354
17669,11312,11156,2,2,34333,,,,,,1,1,6.967633342,17794,8099,7758,341,2,339
17669,10500,11177,0,0,36074,,,,,,1,1,7.465530093,18305,8713,8370,343,3,340
17669,9104,9819,0,2,37340,,,,,,1,1,7.875449645,18984,9035,8749,286,1,285
17669,12076,11146,5,0,18275,,,,,,1,1,3.708747802,8898,4531,4216,315,0,315
17669,10521,9685,0,0,36457,,,,,,1,1,7.520502833,18476,8832,8515,317,4,313
17669,11002,10369,2,0,34587,,,,,,1,1,7.16053749,18042,8119,7812,307,4,303
17669,10797,9107,2,0,36087,,,,,,1,1,7.410664757,18644,8572,8273,299,2,297
17669,9737,9330,0,0,37859,,,,,,1,1,7.900066379,19277,9146,8856,290,1,289
17669,9137,10221,3,0,36281,,,,,,1,1,7.555571063,18672,8670,8401,269,4,265
17669,8604,10786,0,0,35101,,,,,,1,1,7.333002433,18299,8260,7978,282,2,280
17669,10797,10597,0,4,36080,,,,,,1,1,7.654221968,18257,8747,8418,329,8,321
17669,10298,9615,2,0,35650,,,,,,1,1,7.423588776,18351,8491,8174,317,2,315
17669,10423,10075,0,0,35549,,,,,,1,1,7.434462307,18040,8598,8285,313,0,313
17669,9845,11129,0,2,35968,,,,,,1,1,7.370134452,18509,8567,8242,325,4,321
17669,10848,11286,0,0,34313,,,,,,1,1,7.098326509,17591,8193,7857,336,2,334
17669,10533,10043,3,2,36640,,,,,,1,1,7.605208036,18633,8844,8525,319,3,316
17669,9976,10953,0,2,36321,,,,,,1,1,7.673227732,18718,8642,8323,319,14,305
17669,10554,9409,2,2,38403,,,,,,1,1,7.980207957,19362,9360,9039,321,12,309
17669,9324,11229,4,0,33875,,,,,,1,1,7.143781605,17843,7865,7563,302,5,297
17669,10386,10814,0,0,34254,,,,,,1,1,7.497469539,17873,8041,7742,299,3,296
17669,8813,10486,0,4,37006,,,,,,1,1,7.741279956,18954,8873,8567,306,8,298
17669,10819,10415,0,1,32972,,,,,,1,1,6.797849638,17625,7532,7249,283,3,280
17669,12263,10516,2,2,34006,,,,,,1,1,6.94531792,17778,7953,7631,322,4,318
17669,11273,10986,0,3,35000,,,,,,1,1,7.207576496,18180,8243,7909,334,2,332
17669,11326,11010,1,1,35590,,,,,,1,1,7.320827738,18254,8515,8209,306,0,306
17669,11081,10948,0,0,34848,,,,,,1,1,7.161788241,18038,8236,7898,338,2,336
17669,9519,11657,0,4,34690,,,,,,1,1,7.095560307,17675,8345,8020,325,17,308
17669,10542,10384,0,0,35773,,,,,,1,1,7.239367128,18486,8486,8171,315,1,314
17669,10571,10997,0,3,35456,,,,,,1,1,7.387226376,18368,8376,8040,336,9,327
17669,11167,10821,0,3,33724,,,,,,1,1,6.850956877,17945,7731,7414,317,0,317
17669,9507,11301,3,2,35896,,,,,,1,1,7.354245411,18580,8505,8199,306,2,304
17669,10249,10018,0,4,37021,,,,,,1,1,7.553955858,18798,8952,8633,319,2,317
17669,10507,8899,0,2,37376,,,,,,1,1,7.868698421,19223,8940,8667,273,4,269
17669,9995,10545,2,2,36485,,,,,,1,1,7.418650232,18849,8668,8368,300,4,296
17669,10422,10382,2,0,35932,,,,,,1,1,7.438266888,18600,8514,8210,304,2,302
17669,8993,10510,0,3,38562,,,,,,1,1,7.868298434,19413,9435,9156,279,1,278
17669,9981,11955,0,0,35729,,,,,,1,1,7.368430196,18098,8648,8313,335,3,332
17669,10365,10221,0,2,36373,,,,,,1,1,7.447142653,18544,8769,8478,291,6,285
17669,11410,11224,2,2,35013,,,,,,1,1,7.175481983,18166,8260,7933,327,12,315
17669,10166,11523,4,0,36506,,,,,,1,1,7.609431704,18633,8768,8431,337,9,328
17669,10938,10694,0,2,34175,,,,,,1,1,7.013327523,17826,8034,7753,281,5,276
17669,10578,9485,4,2,37075,,,,,,1,1,7.845454568,18998,8870,8533,337,6,331
17669,9906,9229,0,4,35975,,,,,,1,1,7.642558985,18754,8479,8216,263,4,259
17669,11109,10922,0,4,36943,,,,,,1,1,7.546746886,18558,9009,8642,367,2,365
17669,11227,11996,0,0,11394,,,,,,1,1,2.32368769,5627,2744,2465,279,0,279
17669,10872,10859,0,0,37980,,,,,,1,1,8.038441937,19324,9161,8827,334,0,334
17669,10726,10317,2,2,35198,,,,,,1,1,7.252625121,18208,8349,8057,292,4,288
17669,11629,9182,2,0,35958,,,,,,1,1,7.501739529,18576,8532,8214,318,5,313
17669,10405,9700,0,0,36023,,,,,,1,1,7.344365057,18329,8695,8391,304,3,301
17669,11581,10289,0,2,35728,,,,,,1,1,7.516225292,18279,8558,8225,333,8,325
17669,9803,8757,0,0,38890,,,,,,1,1,8.02799685,19362,9602,9278,324,1,323
17669,12590,9412,3,0,34989,,,,,,1,1,7.051376325,18008,8327,8000,327,1,326
17669,11065,9689,6,2,37147,,,,,,1,1,7.567996595,18949,8958,8676,282,1,281
17669,10899,11419,0,3,35260,,,,,,1,1,7.202290745,18163,8357,7974,383,5,378
17669,11478,10591,0,4,36548,,,,,,1,1,7.709712523,18317,8946,8607,339,4,335
17669,11588,10262,0,0,36239,,,,,,1,1,7.553163951,18629,8623,8259,364,0,364
17669,10561,10036,0,0,35777,,,,,,1,1,7.365707227,18305,8593,8307,286,2,284
17669,9548,10312,0,0,35501,,,,,,1,1,7.214650375,18558,8319,8014,305,3,302
17669,9549,11648,2,0,35369,,,,,,1,1,7.313130608,18352,8353,8042,311,7,304
17669,11928,10346,0,0,35691,,,,,,1,1,7.294294043,18322,8503,8140,363,2,361
17669,9504,10335,0,0,35912,,,,,,1,1,7.3363506130000005,18896,8366,8082,284,1,283
17669,9570,11076,2,0,34464,,,,,,1,1,7.16681807,18096,8045,7767,278,0,278
17669,11195,11020,0,4,36595,,,,,,1,1,7.5498434020000005,18995,8636,8308,328,1,327
17669,9008,8830,0,0,37997,,,,,,1,1,7.781685567,19322,9190,8895,295,2,293
17669,9712,7907,0,0,38698,,,,,,1,1,7.960825424,19756,9334,9060,274,0,274
17669,11552,10221,4,6,36063,,,,,,1,1,7.433156579,18570,8589,8274,315,8,307
17669,10521,10477,1,0,35013,,,,,,1,1,7.429117611,18442,8145,7864,281,1,280
17669,10932,10968,4,2,35201,,,,,,1,1,7.120787139,18424,8198,7817,381,4,377
17669,9992,11027,0,4,36494,,,,,,1,1,7.434733619,18581,8784,8439,345,3,342
17669,11824,11348,0,0,9967,,,,,,1,1,2.052995724,4947,2374,2102,272,0,272
17669,10271,8485,0,0,38469,,,,,,1,1,7.821199386,19271,9458,9176,282,3,279
17669,10496,10439,1,1,35722,,,,,,1,1,7.244918692,18655,8388,8097,291,4,287
17669,10816,11752,0,2,34390,,,,,,1,1,7.028812884,17913,8089,7790,299,0,299
17669,10196,11549,0,0,35129,,,,,,1,1,7.202170537,18321,8235,7897,338,4,334
17669,11125,10237,2,2,38852,,,,,,1,1,7.858360052,19341,9574,9211,363,4,359
17669,9362,11702,4,0,35402,,,,,,1,1,7.282613654,17941,8574,8261,313,11,302
17669,12093,9923,0,0,35407,,,,,,1,1,7.188850427,18343,8351,7989,362,2,360
17669,10828,10044,2,0,36493,,,,,,1,1,7.490944979,18655,8760,8442,318,3,315
17669,10290,8099,0,0,36591,,,,,,1,1,7.639684729,18740,8797,8540,257,0,257
17669,11511,9656,0,4,33666,,,,,,1,1,6.85041308,17688,7853,7581,272,4,268
17669,11332,10244,0,0,34074,,,,,,1,1,7.152792916,18118,7819,7501,318,6,312
17669,10281,10371,4,2,35754,,,,,,1,1,7.374524999,18677,8400,8123,277,6,271
17669,11445,10340,0,0,34109,,,,,,1,1,7.161454406,17666,8065,7752,313,3,310
17669,9501,10378,1,0,39748,,,,,,1,1,8.173021993,19741,9834,9495,339,1,338
17669,10210,9359,3,2,37272,,,,,,1,1,7.691048743,18960,9009,8715,294,3,291
17669,8455,9958,2,2,36405,,,,,,1,1,7.525946083,18891,8641,8409,232,0,232
17669,10653,9786,2,0,37801,,,,,,1,1,7.672168076,18980,9253,8938,315,4,311
17669,11421,11684,5,0,35442,,,,,,1,1,7.286863674,18354,8377,8043,334,2,332
17669,10280,11315,4,0,37061,,,,,,1,1,7.537830828,18966,8888,8569,319,10,309
17669,10952,10749,0,0,35268,,,,,,1,1,7.213974358,18123,8428,8139,289,4,285
17669,12200,10531,4,3,34454,,,,,,1,1,7.201504153,17748,8198,7888,310,7,303
17669,11338,11019,2,2,37244,,,,,,1,1,7.678874695,18937,8970,8603,367,3,364
17669,10575,10823,3,2,37801,,,,,,1,1,7.740515752,19399,9035,8703,332,0,332
17669,11581,11971,4,2,6171,,,,,,1,1,1.255820141,3023,1460,1232,228,5,223
17669,11101,10576,0,0,35429,,,,,,1,1,7.199723593,18162,8464,8125,339,3,336
17669,10570,9536,2,2,37981,,,,,,1,1,7.855215447,19167,9249,8933,316,2,314
17669,11166,12004,2,0,14071,,,,,,1,1,3.050142937,6887,3442,3142,300,1,299
17669,11092,10848,2,0,36284,,,,,,1,1,7.568577375,18827,8563,8232,331,1,330
17669,8738,10186,0,1,37974,,,,,,1,1,7.670103728,19390,9156,8884,272,3,269
17669,10687,9102,0,0,36358,,,,,,1,1,7.48079366,18543,8766,8483,283,3,280
17669,11022,9888,0,0,33245,,,,,,1,1,6.925236698,17897,7532,7248,284,2,282
17669,10423,11005,0,0,35043,,,,,,1,1,7.153676464,18145,8304,8014,290,2,288
17669,10297,10871,0,3,35503,,,,,,1,1,7.535014185,18428,8360,8005,355,6,349
17669,9774,11116,0,3,36469,,,,,,1,1,7.619330449,18640,8754,8433,321,5,316
17669,10767,12055,0,0,38532,,,,,,1,1,7.8442602059999995,19041,9552,9165,387,3,384
17669,11475,10050,0,0,37212,,,,,,1,1,7.509566715,18980,8949,8615,334,1,333
17669,12091,10650,2,6,37392,,,,,,1,1,7.738904805,18507,9255,8880,375,19,356
17669,9228,10249,0,1,35990,,,,,,1,1,7.399027332,18734,8499,8241,258,0,258
17669,10196,10619,0,2,34090,,,,,,1,1,6.984282638,17988,7912,7634,278,3,275
17669,10260,11553,0,0,35636,,,,,,1,1,7.317285232,18371,8476,8163,313,3,310
17669,11498,9826,2,0,35912,,,,,,1,1,7.309098907,18294,8657,8353,304,2,302
17669,10940,12190,0,0,33350,,,,,,1,1,7.111684535,17398,7800,7448,352,1,351
17669,10927,10069,0,0,36224,,,,,,1,1,7.548208874,18590,8671,8379,292,2,290
17669,10613,10037,0,0,35641,,,,,,1,1,7.221663308,18417,8454,8138,316,1,315
17669,12277,9380,0,0,35715,,,,,,1,1,7.345856651,18646,8371,8044,327,3,324
17669,10869,10321,0,0,35299,,,,,,1,1,7.392092609,18391,8302,7998,304,5,299
17669,10565,9329,4,0,36012,,,,,,1,1,7.401293116,18479,8621,8330,291,4,287
17669,10649,10812,0,2,36877,,,,,,1,1,7.511452242,18659,8949,8629,320,2,318
17669,10379,10159,4,0,38389,,,,,,1,1,7.843765594,19573,9239,8901,338,0,338
17669,8175,11577,2,5,36533,,,,,,1,1,7.565792349,18814,8715,8426,289,7,282
17669,10701,10785,0,2,34948,,,,,,1,1,7.194460788,18396,8125,7823,302,1,301
17669,11269,10957,0,0,35146,,,,,,1,1,7.211237339,18162,8316,7964,352,3,349
17669,9812,9487,0,2,36586,,,,,,1,1,7.425689065,18663,8814,8519,295,2,293
17669,8687,10486,0,2,37984,,,,,,1,1,7.831138603,18992,9345,9043,302,2,300
17669,10607,11968,0,4,33682,,,,,,1,1,6.902697482,17460,7959,7655,304,6,298
17669,10779,9900,3,0,35685,,,,,,1,1,7.618073511,18497,8432,8108,324,1,323
17669,9380,9052,0,0,38852,,,,,,1,1,8.115106627,19572,9492,9196,296,1,295
17669,10082,9496,2,1,34800,,,,,,1,1,7.148203925,18222,8147,7863,284,11,273
17669,9888,11664,0,4,36068,,,,,,1,1,7.599936265,18534,8603,8275,328,15,313
17669,10838,9737,0,2,35874,,,,,,1,1,7.357809855,18599,8490,8195,295,4,291
17669,11353,10890,2,2,35040,,,,,,1,1,7.223122323,18134,8295,7979,316,3,313
17669,10991,11895,0,4,33813,,,,,,1,1,6.886122255,17603,7939,7607,332,5,327
17669,9743,11494,2,0,36019,,,,,,1,1,7.319732939,18494,8591,8248,343,4,339
17669,10012,10814,6,2,35479,,,,,,1,1,7.285387506,18204,8484,8177,307,14,293
17669,9466,9714,0,0,37742,,,,,,1,1,7.737601722,19164,9145,8857,288,0,288
17669,9830,10828,2,0,33800,,,,,,1,1,7.032491595,18228,7650,7378,272,3,269
17669,10280,9746,0,2,36789,,,,,,1,1,7.751409752,18756,8843,8496,347,2,345
17669,11528,10461,2,4,35088,,,,,,1,1,7.168191248,17802,8493,8193,300,2,298
17669,10361,8125,0,0,37537,,,,,,1,1,7.619756933,19179,9042,8768,274,2,272
17669,8779,9262,0,3,38943,,,,,,1,1,8.030347395,19596,9545,9288,257,1,256
17669,10412,9028,4,2,37628,,,,,,1,1,7.771565549,19230,9036,8710,326,5,321
17669,11260,11071,0,1,35657,,,,,,1,1,7.668764576,18289,8519,8189,330,3,327
17669,10730,10700,4,4,34911,,,,,,1,1,7.12458682,18177,8222,7932,290,4,286
17669,9853,11481,0,0,35190,,,,,,1,1,7.273173193,18346,8250,7906,344,3,341
17669,10459,9714,0,0,35229,,,,,,1,1,7.162772295,18142,8402,8119,283,1,282
17669,11988,10910,2,2,34688,,,,,,1,1,7.149978211,18076,8140,7808,332,3,329
17669,10475,10664,0,0,36693,,,,,,1,1,7.539269668,18709,8828,8500,328,2,326
17669,9748,9048,0,4,35801,,,,,,1,1,7.275527996,18931,8298,8024,274,7,267
17669,11457,11187,0,2,33597,,,,,,1,1,6.969921298,17254,8010,7687,323,7,316
17669,10680,10195,0,0,35118,,,,,,1,1,7.105875334,18438,8191,7893,298,0,298
17669,10715,9479,0,2,36633,,,,,,1,1,7.394971939,19092,8611,8292,319,6,313
17669,9501,11105,1,2,38527,,,,,,1,1,7.83558079,19499,9346,9010,336,1,335
17669,12439,10177,2,4,36458,,,,,,1,1,7.56629819,18925,8573,8186,387,2,385
17669,10092,9487,3,0,36170,,,,,,1,1,7.342332467,18767,8571,8310,261,1,260
17669,10970,10100,4,2,36511,,,,,,1,1,7.398241731,18476,8862,8551,311,5,306
17669,10338,10408,1,1,36163,,,,,,1,1,7.346240171,18494,8689,8398,291,3,288
17669,10878,10426,2,2,34297,,,,,,1,1,7.110199529,17744,8116,7795,321,15,306
17669,9913,11662,0,1,37547,,,,,,1,1,7.6505701,18817,9204,8882,322,2,320
17669,11809,9792,0,2,37085,,,,,,1,1,7.542638904,19061,8827,8457,370,6,364
17669,10359,11804,1,0,33455,,,,,,1,1,6.810415693,17630,7747,7416,331,1,330
17669,11046,11070,0,1,35274,,,,,,1,1,7.145510162,18166,8394,8074,320,1,319
17669,8287,11605,0,2,36748,,,,,,1,1,7.59665052,18774,8840,8546,294,4,290
17669,10464,11275,6,0,36808,,,,,,1,1,7.462610497,18809,8829,8488,341,2,339
17669,10567,9137,5,0,37770,,,,,,1,1,7.70023303,19216,9124,8818,306,15,291
17669,10953,10056,0,2,36116,,,,,,1,1,7.339567047,18701,8557,8256,301,1,300
17669,9969,10162,4,5,37704,,,,,,1,1,7.64853422,19348,9022,8710,312,13,299
17669,10141,9952,3,0,36067,,,,,,1,1,7.59219515,18523,8621,8319,302,4,298
17669,10773,10762,0,0,36133,,,,,,1,1,7.373380249,18469,8670,8346,324,0,324
17669,10737,10401,0,0,37382,,,,,,1,1,7.611308596,18723,9177,8872,305,0,305
17669,10318,11897,0,0,36238,,,,,,1,1,7.352688207,18456,8742,8444,298,1,297
17669,10713,9239,0,0,35929,,,,,,1,1,7.277093911,18710,8457,8152,305,4,301
17669,10796,9748,0,2,37209,,,,,,1,1,7.621128492,18742,9066,8731,335,2,333
17669,10852,9485,4,0,36009,,,,,,1,1,7.300772369,18610,8554,8263,291,3,288
17669,11003,8909,2,0,37262,,,,,,1,1,7.510281727,18990,8984,8680,304,2,302
17669,9280,10307,0,4,38384,,,,,,1,1,7.989574539,19244,9426,9138,288,3,285
17669,10970,10154,2,2,35702,,,,,,1,1,7.353223221,18266,8564,8256,308,12,296
17669,11397,9582,0,2,37537,,,,,,1,1,7.749323007,18927,9145,8825,320,2,318
17669,12029,9965,0,0,35385,,,,,,1,1,7.173809495,18328,8361,8026,335,2,333
17669,10708,10761,2,2,34771,,,,,,1,1,7.398093891,18002,8246,7969,277,2,275
17669,11147,11267,0,0,37181,,,,,,1,1,7.5602882430000005,18731,9062,8736,326,1,325
17669,11088,10901,1,3,36419,,,,,,1,1,7.412288458,18517,8793,8477,316,2,314
17669,9510,11635,0,2,36487,,,,,,1,1,7.550979563,18889,8637,8313,324,3,321
17669,10765,11042,0,2,36899,,,,,,1,1,7.636430888,18685,8947,8627,320,2,318
17669,10024,8202,2,0,37817,,,,,,1,1,7.644290908,19352,9111,8868,243,7,236
17669,9838,9070,2,2,35673,,,,,,1,1,7.32640756,18671,8367,8099,268,8,260
17669,10812,12330,0,4,36598,,,,,,1,1,7.370598699,18721,8764,8415,349,6,343
17669,11212,10479,2,2,33081,,,,,,1,1,6.716914333,17530,7633,7348,285,2,283
17669,9379,9695,2,2,36848,,,,,,1,1,7.601789657,19031,8766,8481,285,4,281
17669,11675,10708,2,2,35019,,,,,,1,1,7.267810813,18586,8066,7765,301,10,291
17669,9177,10075,2,0,35382,,,,,,1,1,7.25423549,18375,8367,8094,273,4,269
17669,10680,9779,2,0,36515,,,,,,1,1,7.439277035,18527,8828,8496,332,1,331
17669,10094,10775,4,0,35659,,,,,,1,1,7.339264481,18653,8358,8068,290,6,284
17669,9329,10272,2,0,37004,,,,,,1,1,7.539316566,19185,8755,8446,309,8,301
17669,10826,9259,0,4,36775,,,,,,1,1,7.588029277,18674,8902,8605,297,3,294
17669,10918,11856,5,2,36735,,,,,,1,1,7.409376247,18225,9061,8673,388,8,380
17669,10869,9971,0,0,31938,,,,,,1,1,6.701944576,16998,7338,7074,264,1,263
17669,11716,9612,0,2,36989,,,,,,1,1,7.591694089,18294,9193,8884,309,3,306
17669,9943,11656,0,1,36188,,,,,,1,1,7.505566681,18399,8725,8386,339,1,338
17669,10090,10447,0,0,37591,,,,,,1,1,7.711290055,18918,9188,8891,297,4,293
17669,11573,8990,0,1,37040,,,,,,1,1,7.5170193,18769,8980,8669,311,2,309
17669,10154,10162,0,0,35073,,,,,,1,1,7.149097872,18075,8347,8043,304,1,303
17669,11103,11620,0,2,35713,,,,,,1,1,7.3146650619999996,18142,8608,8253,355,1,354
17669,9294,9708,0,3,37247,,,,,,1,1,7.54291642,19218,8866,8569,297,5,292
17669,9829,10805,0,0,34288,,,,,,1,1,7.002108768,18118,7951,7683,268,0,268
17669,10446,9804,2,0,37220,,,,,,1,1,7.637828549,19090,8921,8633,288,7,281
17669,11337,8526,2,1,37422,,,,,,1,1,7.645364914,18931,9100,8809,291,2,289
17669,10941,10178,0,3,35190,,,,,,1,1,7.214716597,17967,8457,8148,309,0,309
17669,10085,11023,2,2,34737,,,,,,1,1,7.089590043,18270,8080,7773,307,4,303
17669,10663,10483,2,0,37948,,,,,,1,1,7.925355207,19283,9160,8815,345,4,341
17669,11250,10590,2,0,35656,,,,,,1,1,7.418605643,18436,8457,8151,306,3,303
17669,8269,10987,0,2,37072,,,,,,1,1,7.677081547,19027,8881,8598,283,2,281
17669,10053,11440,2,0,33569,,,,,,1,1,6.9017742250000005,17208,8033,7738,295,1,294
17669,11809,11276,0,2,34273,,,,,,1,1,6.950490206,17989,7981,7659,322,0,322
17669,8567,10821,2,0,38952,,,,,,1,1,7.97452278,19232,9690,9350,340,7,333
17669,10974,9646,2,2,38392,,,,,,1,1,7.815712893,19591,9240,8919,321,4,317
17669,9571,10612,2,0,37021,,,,,,1,1,7.6052124800000005,18745,8981,8667,314,5,309
17669,9489,11382,0,0,34214,,,,,,1,1,6.966503679,17940,7967,7627,340,2,338
17669,10925,12375,0,3,20248,,,,,,1,1,4.161480549,10192,4874,4566,308,5,303
17669,11241,10997,2,4,36268,,,,,,1,1,7.325497397,18687,8628,8303,325,5,320
17669,11571,10816,6,3,31973,,,,,,1,1,6.796977219,17352,7163,6868,295,4,291
17669,10338,11480,2,0,35160,,,,,,1,1,7.121756813,18183,8322,7989,333,0,333
17669,10349,11609,2,0,36393,,,,,,1,1,7.332398465,18389,8835,8501,334,0,334
17669,9106,11016,0,0,36963,,,,,,1,1,7.6876297430000005,18977,8825,8489,336,1,335
17669,9843,9819,7,0,35608,,,,,,1,1,7.291866716,18153,8589,8312,277,4,273
17669,11388,10192,0,0,37873,,,,,,1,1,7.647596341,18971,9283,8947,336,1,335
17669,10549,9468,2,4,36473,,,,,,1,1,7.412383464,18961,8607,8309,298,9,289
17669,10886,12422,6,2,31587,,,,,,1,1,6.385649677,15833,7700,7346,354,8,346
17669,11142,10261,2,0,36689,,,,,,1,1,7.468161965,18958,8710,8399,311,1,310
17669,10612,11078,0,2,34924,,,,,,1,1,7.115057007,18046,8277,7953,324,0,324
17669,11393,10831,2,0,33488,,,,,,1,1,6.949162821,17427,7872,7555,317,0,317
17669,10826,10280,0,3,36117,,,,,,1,1,7.382552641,18545,8632,8324,308,2,306
17669,11837,11020,0,2,34752,,,,,,1,1,7.253105447,17963,8234,7913,321,5,316
17669,10733,10585,0,2,36429,,,,,,1,1,7.413126178,18663,8716,8382,334,6,328
17669,9344,8593,0,0,36989,,,,,,1,1,7.733421996,19219,8760,8510,250,3,247
17669,8799,10213,0,0,38054,,,,,,1,1,7.668742818,19188,9289,9001,288,0,288
17669,10798,10644,2,0,35966,,,,,,1,1,7.294647384,18432,8599,8263,336,4,332
17669,9070,9613,1,0,36201,,,,,,1,1,7.3449868689999995,18920,8488,8183,305,4,301
17669,9429,9791,5,0,35030,,,,,,1,1,7.191573239,18066,8361,8119,242,5,237
17669,9453,9795,0,0,36332,,,,,,1,1,7.343266873,18925,8555,8258,297,4,293
17669,9201,8844,2,0,36800,,,,,,1,1,7.564748023,19134,8719,8491,228,4,224
17669,11099,10691,6,0,33078,,,,,,1,1,6.782037859,17403,7694,7407,287,9,278
17669,10972,12474,0,2,10498,,,,,,1,1,2.248727035,5139,2550,2291,259,1,258
17669,10347,8033,0,0,38098,,,,,,1,1,7.724407961,19554,9141,8879,262,5,257
17669,9541,11380,0,2,36812,,,,,,1,1,7.6011648019999996,18869,8834,8559,275,1,274
17669,11354,10366,2,0,35322,,,,,,1,1,7.149434173,18139,8436,8125,311,4,307
17669,10448,9439,0,0,35511,,,,,,1,1,7.261571627,18427,8405,8131,274,0,274
17669,10127,10818,0,4,36548,,,,,,1,1,7.383426623,19069,8576,8249,327,2,325
17669,9812,10591,0,0,35717,,,,,,1,1,7.230773213,18791,8312,8010,302,2,300
17669,10485,11156,0,0,35175,,,,,,1,1,7.132933693,18286,8311,8044,267,1,266
17669,9877,10511,0,0,36440,,,,,,1,1,7.482669031,18866,8636,8334,302,1,301
17669,10013,10124,0,2,36897,,,,,,1,1,7.578715856,18863,8855,8531,324,2,322
17669,10010,10326,0,0,37512,,,,,,1,1,7.7329985279999995,18725,9231,8906,325,0,325
17669,11297,10610,0,0,36175,,,,,,1,1,7.349562446,18500,8666,8323,343,3,340
17669,11522,11647,2,2,31053,,,,,,1,1,6.295197146,16015,7332,6958,374,5,369
17669,10485,10214,1,2,38048,,,,,,1,1,7.7068831410000005,19189,9260,8921,339,0,339
17669,8873,9408,1,2,37313,,,,,,1,1,7.679525985,19242,8908,8653,255,1,254
17669,10708,9109,6,4,35091,,,,,,1,1,7.100114488,18051,8386,8118,268,9,259
17669,10539,11483,0,0,34751,,,,,,1,1,7.073743848,18122,8152,7827,325,1,324
17669,11008,10070,0,2,38748,,,,,,1,1,7.892287742,19265,9559,9194,365,4,361
17669,10425,9983,2,2,37396,,,,,,1,1,7.722831455,19272,8898,8570,328,2,326
17669,11172,8575,3,0,36319,,,,,,1,1,7.367311535,18831,8604,8324,280,5,275
17669,10923,9583,0,0,36932,,,,,,1,1,7.559906011,18890,8871,8571,300,0,300
17669,8569,10498,0,1,38401,,,,,,1,1,7.718813155,19513,9298,9006,292,8,284
17669,10149,10297,0,0,37610,,,,,,1,1,7.69094683,19116,9094,8788,306,5,301
17669,10294,11128,0,2,34143,,,,,,1,1,7.021101882,17897,7974,7676,298,7,291
17669,9717,9993,0,2,35461,,,,,,1,1,7.377030947,18426,8380,8105,275,2,273
17669,10967,8778,0,0,36876,,,,,,1,1,7.428840212,18986,8788,8474,314,1,313
17669,9953,9421,0,0,36140,,,,,,1,1,7.321931782,18809,8527,8250,277,2,275
17669,10164,10874,3,1,38419,,,,,,1,1,8.072384582,19478,9307,8980,327,13,314
17669,10629,10716,7,0,36032,,,,,,1,1,7.575360044,18527,8593,8274,319,6,313
17669,10617,10554,2,0,34843,,,,,,1,1,7.105661795,18207,8155,7829,326,5,321
17669,12246,9655,4,0,37733,,,,,,1,1,7.624432469,19040,9173,8826,347,4,343
17669,11615,10714,0,0,37261,,,,,,1,1,7.520081397,18909,9000,8648,352,1,351
17669,10134,10446,0,0,36235,,,,,,1,1,7.442840715,18693,8621,8321,300,0,300
17669,10999,9651,4,0,35828,,,,,,1,1,7.363667636,18173,8685,8400,285,7,278
17669,11286,8778,4,0,38009,,,,,,1,1,7.831422926,19170,9256,8929,327,9,318
17669,11476,9800,0,4,37611,,,,,,1,1,7.6560967699999996,19122,9073,8730,343,7,336
17669,9183,11118,2,0,37087,,,,,,1,1,7.585096806,19077,8848,8534,314,5,309
17669,8825,9915,2,4,38587,,,,,,1,1,7.858874118,19613,9348,9070,278,7,271
17669,9667,9498,0,4,36407,,,,,,1,1,7.401799147,18987,8581,8323,258,0,258
17669,9136,9123,2,1,38642,,,,,,1,1,7.8470344690000005,19697,9324,9027,297,4,293
17669,9851,10557,2,0,35351,,,,,,1,1,7.290836441,18354,8351,8056,295,0,295
17669,9393,7828,0,0,38364,,,,,,1,1,7.857693709,19363,9361,9082,279,3,276
17669,12297,10260,4,0,34201,,,,,,1,1,7.052616694,18065,7913,7603,310,8,302
17669,10046,10958,0,0,34937,,,,,,1,1,7.135703806,18333,8157,7867,290,2,288
17669,10422,10467,3,0,37014,,,,,,1,1,7.602921344,18810,8953,8655,298,1,297
17669,11383,11786,2,2,10359,,,,,,1,1,2.116412294,5085,2502,2232,270,1,269
17669,9947,9229,0,0,38439,,,,,,1,1,7.876001316,19207,9477,9199,278,2,276
17669,9916,10097,0,2,35472,,,,,,1,1,7.383571678,18404,8378,8066,312,1,311
17669,11691,9550,0,0,34206,,,,,,1,1,6.948912309,17867,8015,7706,309,4,305
17669,11050,9175,1,0,34990,,,,,,1,1,7.273248668,18367,8183,7926,257,3,254
17669,11433,11163,2,2,36797,,,,,,1,1,7.438603971,18792,8837,8506,331,5,326
17669,9557,10624,3,1,36451,,,,,,1,1,7.370907562,18632,8754,8443,311,13,298
17669,11681,10816,4,3,36146,,,,,,1,1,7.452053418,18294,8751,8401,350,19,331
17669,10475,11145,0,2,35929,,,,,,1,1,7.361678214,18592,8495,8148,347,1,346
17669,9218,10993,2,4,34625,,,,,,1,1,7.142601907,18364,7992,7715,277,5,272
17669,9543,9257,0,0,36590,,,,,,1,1,7.364476094,18765,8770,8485,285,2,283
17669,10812,9583,2,0,36677,,,,,,1,1,7.363245712,18643,8863,8555,308,1,307
17669,9768,10619,0,0,37675,,,,,,1,1,7.681844842,19168,9103,8802,301,3,298
17669,9694,10179,0,0,37761,,,,,,1,1,7.709762492,19294,9090,8803,287,2,285
17669,10634,9222,2,0,39620,,,,,,1,1,7.949251984,19899,9694,9361,333,0,333
17669,9282,10863,1,0,36868,,,,,,1,1,7.6276952829999995,18954,8812,8522,290,1,289
17669,11808,11356,4,0,35050,,,,,,1,1,7.169831474,17999,8349,7996,353,2,351
17669,9587,8730,0,0,37388,,,,,,1,1,7.638339622,19015,9030,8717,313,3,310
17669,10916,11040,5,0,35024,,,,,,1,1,7.187443289,18124,8297,7991,306,1,305
17669,10785,11515,2,2,34726,,,,,,1,1,7.158922749,17694,8352,8024,328,0,328
17669,11742,10467,0,2,35215,,,,,,1,1,7.111554375,18009,8449,8141,308,1,307
17669,10194,11811,0,2,34645,,,,,,1,1,7.121452254,18206,8063,7750,313,6,307
17669,10017,10096,0,4,38448,,,,,,1,1,7.853540939,19690,9231,8935,296,0,296
17669,11361,11755,2,0,37164,,,,,,1,1,7.5615421860000005,18716,9029,8639,390,2,388
17669,8607,9613,1,2,37865,,,,,,1,1,7.597665401,19493,9042,8754,288,3,285
17669,11291,11880,0,0,8388,,,,,,1,1,1.7158564680000001,4164,1994,1758,236,0,236
17669,10880,10394,0,0,37494,,,,,,1,1,7.657145132,19202,8979,8645,334,0,334
17669,10434,10684,0,4,35196,,,,,,1,1,7.279163861,17995,8434,8101,333,19,314
17669,8810,10726,0,3,37264,,,,,,1,1,7.614540449,19049,8957,8656,301,2,299
17669,10875,10663,0,0,35384,,,,,,1,1,7.156926274,18360,8367,8077,290,2,288
17669,10152,9606,2,1,37017,,,,,,1,1,7.706805578,18909,8903,8601,302,2,300
17669,11359,11058,0,2,35008,,,,,,1,1,7.215687263,18001,8341,8016,325,1,324
17669,10589,10685,0,2,36358,,,,,,1,1,7.431437582,18786,8631,8321,310,3,307
17669,10259,10149,3,2,34760,,,,,,1,1,7.073545318,18109,8195,7934,261,2,259
17669,11486,9853,0,0,34669,,,,,,1,1,7.186502217,18013,8168,7848,320,1,319
17669,10803,9932,0,4,35800,,,,,,1,1,7.368786647,18769,8373,8088,285,2,283
17669,11452,10623,2,2,34281,,,,,,1,1,7.096604315,17748,8104,7779,325,14,311
17669,10920,11024,2,0,35598,,,,,,1,1,7.23271556,18474,8406,8094,312,0,312
17669,10463,9184,0,2,37151,,,,,,1,1,7.453437539,18887,8977,8667,310,0,310
17669,9444,10991,5,0,34675,,,,,,1,1,7.41292328,18515,7938,7654,284,2,282
17669,10122,11157,0,0,35453,,,,,,1,1,7.381457711,18113,8512,8196,316,1,315
17669,10481,10230,0,0,38529,,,,,,1,1,7.728236201,19191,9517,9213,304,1,303
17669,10951,10414,0,1,35773,,,,,,1,1,7.307488683,18553,8440,8100,340,2,338
17669,9687,11220,0,0,38839,,,,,,1,1,7.977060163,19443,9515,9149,366,0,366
17669,11049,10704,0,1,35793,,,,,,1,1,7.221455679,18476,8480,8123,357,4,353
17669,7595,9782,0,1,39050,,,,,,1,1,8.116016522,19842,9474,9214,260,2,258
17669,11925,11518,2,1,32496,,,,,,1,1,6.681106293,16632,7731,7329,402,1,401
17669,8881,10197,0,0,39427,,,,,,1,1,7.923383346,19972,9585,9300,285,0,285
17669,10139,9310,0,0,36160,,,,,,1,1,7.338776702,18713,8572,8269,303,4,299
17669,8734,11909,0,2,36009,,,,,,1,1,7.32727946,18612,8550,8253,297,1,296
17669,10439,9704,0,0,35192,,,,,,1,1,7.171296287,18292,8301,8003,298,2,296
17669,11341,10426,0,0,36553,,,,,,1,1,7.57466546,19152,8531,8192,339,5,334
17669,12280,10227,2,0,34698,,,,,,1,1,7.02037802,18090,8125,7767,358,3,355
17669,10084,10381,4,2,35876,,,,,,1,1,7.27349174,18489,8547,8254,293,3,290
17669,11859,9603,2,0,35285,,,,,,1,1,7.305247392,17957,8509,8199,310,2,308
17669,8646,9486,0,0,38015,,,,,,1,1,7.659521067,19463,9130,8838,292,2,290
17669,10814,10015,0,2,36270,,,,,,1,1,7.545468551,18456,8740,8406,334,2,332
17669,10560,11315,2,2,33304,,,,,,1,1,6.923940163,17577,7699,7370,329,18,311
17669,10332,10332,4,4,37514,,,,,,1,1,7.7839537100000005,19242,8993,8707,286,1,285
17669,10152,10133,0,2,36041,,,,,,1,1,7.499397378,18684,8538,8257,281,3,278
17669,10204,10221,0,0,35295,,,,,,1,1,7.302139867,18365,8318,8024,294,4,290
17669,11081,9198,4,0,36188,,,,,,1,1,7.330404722,18734,8569,8253,316,2,314
17669,9944,8774,0,0,36579,,,,,,1,1,7.41827035,18875,8721,8459,262,5,257
17669,11614,11069,4,0,35590,,,,,,1,1,7.358603445,18467,8394,8059,335,2,333
17669,10369,10482,0,4,35826,,,,,,1,1,7.29322515,18728,8400,8102,298,1,297
17669,10544,8425,0,0,35919,,,,,,1,1,7.250155717,18326,8653,8366,287,8,279
17669,9770,9921,2,0,37786,,,,,,1,1,7.778651829,19038,9205,8867,338,3,335
17669,9780,10578,1,0,36585,,,,,,1,1,7.427514637,18842,8715,8402,313,2,311
17669,10462,10129,4,2,37121,,,,,,1,1,7.462679868,18741,9030,8710,320,4,316
17669,10726,10778,0,2,34903,,,,,,1,1,7.102049741,18172,8212,7905,307,3,304
17669,11075,9741,0,2,34794,,,,,,1,1,7.050012743,18240,8116,7794,322,4,318
17669,11471,10134,5,0,36856,,,,,,1,1,7.580725825,18445,9038,8703,335,9,326
17669,9277,10223,2,2,37635,,,,,,1,1,7.590581018,19132,9100,8797,303,1,302
17669,12079,8918,3,2,34223,,,,,,1,1,7.123719277,17727,8095,7789,306,1,305
17669,12021,10527,0,2,37675,,,,,,1,1,7.699419278,18800,9264,8917,347,0,347
17669,10573,11548,0,2,38554,,,,,,1,1,8.068499008,19544,9336,8998,338,4,334
17669,10316,11241,2,11,35258,,,,,,1,1,7.155425056,18178,8395,8105,290,3,287
17669,11965,10908,2,0,33288,,,,,,1,1,6.880034352,17589,7679,7338,341,4,337
17669,10061,10387,0,3,37978,,,,,,1,1,7.767421763,19250,9190,8842,348,3,345
17669,10920,8913,0,0,36728,,,,,,1,1,7.439556194,18877,8779,8486,293,5,288
17669,9701,10289,1,0,38434,,,,,,1,1,7.833195278,19255,9425,9096,329,9,320
17669,11202,10653,2,2,35294,,,,,,1,1,7.297231419,18086,8444,8124,320,9,311
17669,11043,11375,0,0,34700,,,,,,1,1,7.062961582,18175,8095,7760,335,2,333
17669,11065,10968,1,2,35030,,,,,,1,1,7.220991299,18095,8294,7947,347,4,343
17669,11186,10163,0,0,37865,,,,,,1,1,7.776285172,19407,9068,8746,322,2,320
17669,10591,10064,0,2,36127,,,,,,1,1,7.443777122,18680,8565,8248,317,1,316
17669,10786,10599,0,2,35738,,,,,,1,1,7.375303534,18591,8410,8083,327,2,325
17669,10234,10314,0,0,35816,,,,,,1,1,7.311352939,18505,8484,8141,343,7,336
17669,10932,10701,3,2,34024,,,,,,1,1,7.008271241,17899,7905,7590,315,3,312
17669,10306,10725,4,0,35570,,,,,,1,1,7.289665165,18498,8384,8080,304,6,298
17669,10008,10977,0,2,36523,,,,,,1,1,7.46021689,18399,8904,8588,316,1,315
17669,9667,11666,2,3,34925,,,,,,1,1,7.231201706,18362,8124,7809,315,8,307
17669,10601,10893,0,0,37177,,,,,,1,1,7.691995979,19029,8913,8591,322,2,320
17669,10848,10514,0,0,36668,,,,,,1,1,7.498325757,19000,8679,8369,310,2,308
17669,11095,10449,4,0,37049,,,,,,1,1,7.532059829,19061,8832,8508,324,3,321
17669,11190,10581,0,0,35462,,,,,,1,1,7.368335559,18581,8292,7995,297,3,294
17669,10299,11469,2,2,35244,,,,,,1,1,7.18052928,18224,8337,7991,346,4,342
17669,9817,9269,2,2,36038,,,,,,1,1,7.547564278,18727,8521,8252,269,6,263
17669,10683,9508,0,2,36069,,,,,,1,1,7.315883139,18851,8464,8174,290,0,290
17669,11785,11048,6,0,35936,,,,,,1,1,7.406479394,18202,8693,8345,348,6,342
17669,11499,11340,3,4,34019,,,,,,1,1,7.051993656,17651,8017,7683,334,7,327
17669,10899,8981,0,2,37107,,,,,,1,1,7.543905613,18747,9036,8748,288,1,287
17669,9898,9902,2,0,37686,,,,,,1,1,7.79504028,18932,9228,8930,298,1,297
17669,10707,9147,0,0,35518,,,,,,1,1,7.264791826,18449,8400,8131,269,1,268
17669,10294,10424,2,0,34443,,,,,,1,1,7.274699904,17893,8134,7852,282,0,282
17669,10285,10316,4,0,35648,,,,,,1,1,7.252850416,18643,8366,8093,273,5,268
17669,11099,8953,2,0,36281,,,,,,1,1,7.366867257,18864,8567,8284,283,1,282
17669,11857,11318,1,0,12125,,,,,,1,1,2.502666917,6027,2908,2626,282,1,281
17669,10334,11309,0,2,35341,,,,,,1,1,7.302834839,18305,8359,8041,318,7,311
17669,11025,10810,2,0,34557,,,,,,1,1,6.977950996,17973,8134,7818,316,6,310
17669,9721,9170,2,0,36886,,,,,,1,1,7.517859062,19081,8758,8469,289,11,278
17669,10738,12214,2,0,35748,,,,,,1,1,7.321867613,18402,8505,8169,336,3,333
17669,10887,10116,1,0,37299,,,,,,1,1,7.556076447,18912,9016,8661,355,3,352
17669,10927,10416,0,4,36933,,,,,,1,1,7.447130902,18834,8888,8565,323,4,319
17669,9873,10546,1,2,34182,,,,,,1,1,6.995678481,18005,7961,7706,255,1,254
17669,10791,10197,0,0,37550,,,,,,1,1,7.592171169,18961,9124,8783,341,1,340
17669,10654,10291,0,2,38040,,,,,,1,1,7.680711105,19383,9152,8799,353,11,342
17669,11215,8866,2,0,36503,,,,,,1,1,7.696832279,18613,8806,8528,278,4,274
17669,9406,10325,0,0,34694,,,,,,1,1,7.091858762,18084,8156,7858,298,1,297
17669,11429,8548,3,0,36693,,,,,,1,1,7.449439669,18818,8795,8510,285,2,283
17669,7951,9949,0,0,38961,,,,,,1,1,7.908020907,19806,9422,9111,311,1,310
17669,11243,11926,2,1,8920,,,,,,1,1,1.9115513800000001,4202,2231,1975,256,2,254
17669,10300,9739,0,0,36975,,,,,,1,1,7.536195927,19004,8837,8540,297,1,296
17669,9463,11441,0,2,35830,,,,,,1,1,7.330610451,18431,8553,8260,293,1,292
17669,9207,10964,0,2,35290,,,,,,1,1,7.377241543,18264,8354,8036,318,3,315
17669,10927,9017,1,0,36097,,,,,,1,1,7.315112444,18492,8663,8384,279,2,277
17669,11334,9706,0,0,36179,,,,,,1,1,7.403798559,18640,8608,8285,323,2,321
17669,10530,9592,0,6,34466,,,,,,1,1,6.9778843649999995,18324,7943,7687,256,3,253
17669,10507,9415,2,2,35724,,,,,,1,1,7.287894724,18401,8531,8270,261,10,251
17669,8940,10684,2,2,37641,,,,,,1,1,7.705739434,19432,8965,8686,279,11,268
17669,9991,11099,2,0,36781,,,,,,1,1,7.595601291,18629,8927,8629,298,2,296
17669,10703,9337,0,2,37220,,,,,,1,1,7.529639137,18917,8984,8649,335,9,326
17669,10744,9793,0,0,36316,,,,,,1,1,7.487765401,18706,8652,8346,306,0,306
17669,10125,10902,0,5,35008,,,,,,1,1,7.10066386,18361,8170,7863,307,11,296
17669,10556,10273,2,0,36595,,,,,,1,1,7.557271841,18642,8816,8495,321,1,320
17669,11526,11197,0,0,34623,,,,,,1,1,7.268672396,17547,8385,8079,306,1,305
17669,10903,9988,2,2,34865,,,,,,1,1,7.246451875,18100,8240,7955,285,6,279
17669,8640,10402,0,2,36983,,,,,,1,1,7.537021374,18924,8888,8605,283,3,280
17669,10516,10759,2,0,36015,,,,,,1,1,7.403587839,18588,8571,8286,285,1,284
17669,10553,10568,0,0,37659,,,,,,1,1,7.750977202,19388,8960,8609,351,3,348
17669,10205,11107,2,4,35036,,,,,,1,1,7.199579577,17863,8426,8105,321,3,318
17669,11226,10484,3,3,37533,,,,,,1,1,7.645962233,19133,9027,8681,346,2,344
17669,10717,10114,2,0,34139,,,,,,1,1,7.281350597,17989,7936,7658,278,2,276
17669,10628,10177,0,0,34770,,,,,,1,1,7.052022072,18196,8132,7822,310,0,310
17669,8891,12273,0,0,36136,,,,,,1,1,7.453843053,18447,8681,8354,327,2,325
17669,10598,9623,0,0,34937,,,,,,1,1,7.188267132,18411,8109,7801,308,2,306
17669,9501,8826,2,0,35185,,,,,,1,1,7.143562177,18734,8099,7846,253,1,252
17669,11712,10535,3,2,33636,,,,,,1,1,7.011310398,17823,7747,7428,319,1,318
17669,10754,10608,4,0,33669,,,,,,1,1,6.98433484,17173,8097,7795,302,2,300
17669,10123,11952,0,4,38247,,,,,,1,1,7.72375222,19255,9316,8956,360,14,346
17669,9918,9533,0,0,34390,,,,,,1,1,7.06487174,18172,7963,7671,292,2,290
17669,10618,9900,2,4,36639,,,,,,1,1,7.407589979,18629,8844,8522,322,14,308
17669,11492,11157,0,2,34529,,,,,,1,1,7.262772729,17938,8123,7778,345,3,342
17669,8934,9722,0,0,38503,,,,,,1,1,7.925643178,19554,9313,8990,323,1,322
17669,12335,10835,0,0,23796,,,,,,1,1,5.014805164,12341,5584,5297,287,1,286
17669,9946,9676,2,2,37616,,,,,,1,1,7.793130514,19250,9036,8742,294,6,288
17669,9772,9768,2,0,35905,,,,,,1,1,7.394312892,18805,8402,8106,296,2,294
17669,11125,8668,2,2,35967,,,,,,1,1,7.581956933,18711,8491,8217,274,2,272
17669,10358,8884,0,2,37146,,,,,,1,1,7.607426947,18908,8968,8666,302,2,300
17669,10836,11176,4,4,33629,,,,,,1,1,7.214779331,17626,7845,7532,313,6,307
17669,9319,10977,0,4,36507,,,,,,1,1,7.634988499,19012,8591,8278,313,3,310
17669,10450,12551,0,2,37114,,,,,,1,1,7.853024865,18706,8995,8577,418,0,418
17669,10899,11023,2,2,34741,,,,,,1,1,7.215478398,18298,8064,7749,315,1,314
17669,8962,10956,0,0,38131,,,,,,1,1,7.750192176,18913,9451,9135,316,1,315
17669,10736,11165,0,0,33756,,,,,,1,1,6.880393356,17779,7834,7525,309,1,308
17669,11376,11461,0,0,35125,,,,,,1,1,7.224139697,17796,8478,8105,373,0,373
17669,10636,10744,1,4,37088,,,,,,1,1,7.781774365,18626,9064,8730,334,20,314
17669,9908,11025,0,2,36754,,,,,,1,1,7.702556087,18601,8928,8631,297,0,297
17669,11580,9778,0,2,36634,,,,,,1,1,7.44385461,18357,8974,8645,329,12,317
17669,8398,10527,0,0,36731,,,,,,1,1,7.519677348,19125,8663,8383,280,2,278
17669,9276,11403,0,0,37294,,,,,,1,1,7.64377189,18990,8996,8684,312,2,310
17669,9642,9345,0,0,36731,,,,,,1,1,7.513023984,19026,8708,8419,289,3,286
17669,10123,12149,0,2,34297,,,,,,1,1,7.151756207,18145,7906,7566,340,5,335
17669,11631,10702,0,3,35421,,,,,,1,1,7.507744289,18391,8345,8005,340,4,336
17669,11456,10795,0,0,35485,,,,,,1,1,7.313587462,18493,8328,7992,336,2,334
17669,10963,9312,0,0,36714,,,,,,1,1,7.521966141,18802,8806,8506,300,1,299
17669,8085,10256,0,0,36623,,,,,,1,1,7.481350369,18876,8733,8452,281,0,281
17669,10281,9578,0,0,35951,,,,,,1,1,7.285736476,18813,8427,8143,284,3,281
17669,10493,10426,0,0,34039,,,,,,1,1,7.035026233,17925,7903,7595,308,1,307
17669,11037,9563,0,0,37387,,,,,,1,1,7.862282875,19085,8989,8665,324,0,324
17669,11273,10484,0,2,34446,,,,,,1,1,7.213385902,18146,7997,7691,306,0,306
17669,10588,9139,0,2,36048,,,,,,1,1,7.383515598,18319,8708,8395,313,7,306
17669,9916,10729,0,2,35745,,,,,,1,1,7.323397085,18599,8428,8138,290,3,287
17669,10418,10233,2,2,36442,,,,,,1,1,7.725707582,18498,8829,8543,286,1,285
17669,10572,10050,0,2,35584,,,,,,1,1,7.289811705,18503,8388,8083,305,3,302
17669,9068,10875,0,3,35475,,,,,,1,1,7.238962655,18637,8261,7945,316,5,311
17669,10063,10085,2,2,37323,,,,,,1,1,7.662518227,19165,8944,8674,270,4,266
17669,11616,11563,2,0,2528,,,,,,1,1,0.52149485,1143,614,457,157,1,156
17669,9697,11280,2,2,35217,,,,,,1,1,7.208914123,18422,8252,7961,291,4,287
17669,10214,9978,0,0,37224,,,,,,1,1,7.607386656,19245,8839,8538,301,2,299
17669,12095,9659,6,0,36188,,,,,,1,1,7.509772154,18017,8922,8595,327,9,318
17669,9706,10698,2,0,36622,,,,,,1,1,7.491334623,18694,8803,8481,322,9,313
17669,10948,10738,2,2,35534,,,,,,1,1,7.459604519,18104,8558,8244,314,5,309
17669,10173,9825,1,0,36915,,,,,,1,1,7.815606586,18760,8929,8632,297,4,293
17669,11275,10457,4,2,36162,,,,,,1,1,7.641852099,18134,8842,8498,344,5,339
17669,10218,11621,2,2,36232,,,,,,1,1,7.56179763,18571,8665,8334,331,5,326
17669,11324,9101,3,0,37182,,,,,,1,1,7.766374886,18994,8912,8548,364,0,364
17669,9929,11881,2,2,36125,,,,,,1,1,7.431847845,18158,8830,8523,307,0,307
17669,10459,9882,0,3,36080,,,,,,1,1,7.616651215,18664,8565,8279,286,5,281
17669,12079,11094,0,0,5514,,,,,,1,1,1.102075764,2531,1382,1163,219,0,219
17669,9597,12135,0,4,35551,,,,,,1,1,7.261355711,18360,8424,8081,343,2,341
17669,10008,10918,0,2,35680,,,,,,1,1,7.263013123,18635,8357,8026,331,1,330
17669,9734,10847,2,2,36604,,,,,,1,1,7.523819928,18763,8759,8436,323,4,319
17669,7665,10535,0,0,37089,,,,,,1,1,7.508862709,19416,8702,8433,269,3,266
17669,9120,9852,0,2,35600,,,,,,1,1,7.26901606,18665,8334,8067,267,1,266
17669,10219,9006,2,0,34646,,,,,,1,1,7.03705088,18276,8058,7804,254,4,250
17669,11031,8703,0,0,34044,,,,,,1,1,7.013011944,17905,7930,7651,279,1,278
17669,9109,10993,2,4,35502,,,,,,1,1,7.473223548,18374,8432,8168,264,2,262
17669,10137,9631,0,0,35122,,,,,,1,1,7.165051084,18262,8294,8022,272,0,272
17669,10486,10477,0,0,37076,,,,,,1,1,7.514402168,18638,9062,8748,314,1,313
17669,9738,11032,1,4,34908,,,,,,1,1,7.385025149,18377,8114,7811,303,5,298
17669,10994,10330,0,0,33720,,,,,,1,1,7.032000792,17534,7922,7580,342,2,340
17669,9251,8511,3,0,38459,,,,,,1,1,7.8069986,19662,9269,9010,259,1,258
17669,11604,8925,3,0,36239,,,,,,1,1,7.41869364,18310,8832,8567,265,0,265
17669,9852,10981,2,8,38308,,,,,,1,1,7.911840422,19367,9301,8962,339,12,327
17669,10464,9024,2,0,35523,,,,,,1,1,7.60579453,18710,8256,7955,301,0,301
17669,10689,8501,2,0,35988,,,,,,1,1,7.314670254,18801,8453,8172,281,2,279
17669,8555,9775,0,0,36681,,,,,,1,1,7.443965538,18859,8767,8479,288,1,287
17669,11683,10765,2,0,35007,,,,,,1,1,7.302970424,18037,8308,7954,354,1,353
17669,11306,11583,0,2,36014,,,,,,1,1,7.667095706,18591,8540,8197,343,2,341
17669,10766,10629,1,4,36816,,,,,,1,1,7.518983539,18797,8858,8555,303,4,299
17669,10759,11815,0,2,36060,,,,,,1,1,7.547491816,18152,8783,8441,342,2,340
17669,10777,9572,0,0,35418,,,,,,1,1,7.297428764,18427,8343,8038,305,4,301
17669,9658,10186,2,3,37890,,,,,,1,1,7.8046481629999995,19160,9214,8912,302,2,300
17669,9258,9858,0,2,35800,,,,,,1,1,7.537893169,18191,8670,8401,269,0,269
17669,10166,10800,0,4,37486,,,,,,1,1,7.650073593,18983,9099,8794,305,7,298
17669,10080,10268,0,0,36519,,,,,,1,1,7.648615946,18973,8604,8266,338,2,336
17669,9924,11765,2,3,36333,,,,,,1,1,7.485759682,18325,8848,8536,312,1,311
17669,10949,11525,2,3,34754,,,,,,1,1,7.371852802,18114,8155,7825,330,4,326
17669,10394,10337,0,0,37780,,,,,,1,1,7.676155818,19184,9139,8821,318,2,316
17669,10122,10552,2,0,35479,,,,,,1,1,7.440398388,18105,8538,8240,298,0,298
17669,10301,10924,1,2,34549,,,,,,1,1,7.339895645,18294,7980,7685,295,2,293
17669,10937,9611,2,0,34175,,,,,,1,1,7.248822949,18135,7875,7585,290,0,290
17669,7981,8355,0,0,39486,,,,,,1,1,8.004306252,19977,9621,9354,267,2,265
17669,10829,11754,2,2,34085,,,,,,1,1,7.172779686,17917,7936,7640,296,1,295
17669,10586,11291,0,4,35939,,,,,,1,1,7.442735292,18313,8640,8294,346,7,339
17669,10611,9278,2,0,35318,,,,,,1,1,7.687815332,18625,8205,7922,283,4,279
17669,10788,9304,4,2,35490,,,,,,1,1,7.4906419,18448,8388,8122,266,5,261
17669,9887,10698,0,0,36411,,,,,,1,1,7.82890556,18519,8789,8475,314,5,309
17669,8455,9585,2,0,36627,,,,,,1,1,7.786100051,18656,8853,8588,265,2,263
17669,10746,10684,0,2,34765,,,,,,1,1,7.574278895,18003,8227,7919,308,2,306
17669,8577,10229,2,2,37853,,,,,,1,1,8.170638783,19317,9118,8818,300,13,287
17669,11094,12114,2,0,6002,,,,,,1,1,1.282819406,2769,1518,1321,197,1,196
17669,9745,11230,2,2,36947,,,,,,1,1,7.80308608,18727,8959,8657,302,4,298
17669,9973,9138,4,0,35604,,,,,,1,1,7.652917803,18348,8488,8208,280,2,278
17669,10996,10983,1,0,35987,,,,,,1,1,7.475985015,18561,8543,8203,340,5,335
17669,9938,10639,0,0,35658,,,,,,1,1,7.929382601,18511,8419,8110,309,3,306
17669,11892,8858,5,0,34222,,,,,,1,1,7.423050014,18150,7899,7625,274,2,272
17669,10632,9032,4,0,35865,,,,,,1,1,7.393002873,18600,8485,8190,295,10,285
17669,10703,12198,2,0,35948,,,,,,1,1,7.791789499,18367,8608,8243,365,5,360
17669,9622,11246,2,3,34722,,,,,,1,1,7.714858042,18129,8149,7854,295,4,291
17669,9785,11138,0,2,36557,,,,,,1,1,7.823929348,18779,8721,8385,336,1,335
17669,10639,9940,0,2,36385,,,,,,1,1,7.727268628,18827,8622,8308,314,2,312
17669,8791,9914,0,2,37258,,,,,,1,1,7.710237549,19098,8955,8705,250,3,247
17669,9765,10766,2,1,37661,,,,,,1,1,7.799693067,19099,9120,8798,322,6,316
17669,11254,8956,2,3,37835,,,,,,1,1,7.882929878,19379,9071,8757,314,6,308
17669,10885,9478,0,0,38002,,,,,,1,1,8.302301419,18902,9394,9082,312,3,309
17669,11437,11097,4,2,34850,,,,,,1,1,7.246003189,18287,8114,7779,335,2,333
17669,11239,10795,2,0,34937,,,,,,1,1,7.243159748,18033,8282,7942,340,8,332
17669,10239,7962,0,0,36543,,,,,,1,1,7.716577141,19165,8559,8299,260,4,256
17669,9415,11981,0,6,33942,,,,,,1,1,7.182168115,17797,7928,7639,289,3,286
17669,11747,9324,2,0,35009,,,,,,1,1,7.188747716,18225,8241,7939,302,2,300
17669,10001,10400,2,0,37765,,,,,,1,1,7.761918852,19064,9193,8878,315,0,315
17669,11197,10184,0,6,35139,,,,,,1,1,7.41779856,18036,8417,8148,269,5,264
17669,11293,10990,0,0,33694,,,,,,1,1,7.21060102,17848,7768,7458,310,0,310
17669,8840,10701,0,0,37074,,,,,,1,1,7.583453336,19105,8841,8554,287,1,286
17669,11192,9441,0,2,35812,,,,,,1,1,7.346776674,18460,8516,8196,320,2,318
17669,9411,11974,0,0,35047,,,,,,1,1,7.346524337,18296,8217,7900,317,3,314
17669,8994,11409,0,2,35119,,,,,,1,1,7.134696312,18621,8097,7793,304,1,303
17669,10662,10487,2,0,36962,,,,,,1,1,7.5903896280000005,18393,9128,8815,313,2,311
17669,9404,11104,0,0,35718,,,,,,1,1,7.380204625,18576,8421,8121,300,1,299
17669,9953,10013,0,5,37702,,,,,,1,1,7.902339598,19286,9054,8746,308,6,302
17669,10182,9946,2,2,35803,,,,,,1,1,7.329677919,18415,8555,8277,278,8,270
17669,10977,10956,0,0,36503,,,,,,1,1,7.430551496,18805,8693,8381,312,2,310
17669,10500,10598,0,2,37106,,,,,,1,1,7.57156011,18531,9113,8764,349,3,346
17669,9533,12035,0,0,34836,,,,,,1,1,7.393796154,18119,8204,7895,309,2,307
17669,11016,9995,1,0,34987,,,,,,1,1,7.165347659,18261,8203,7883,320,4,316
17669,11461,10853,0,0,35005,,,,,,1,1,7.173579712,18049,8314,7986,328,1,327
17669,11297,11555,0,0,34102,,,,,,1,1,7.12186464,17854,7965,7647,318,2,316
17669,9320,9425,2,0,34774,,,,,,1,1,7.284569199,18380,8062,7792,270,8,262
17669,9479,9623,0,0,38823,,,,,,1,1,7.96955032,19023,9752,9456,296,3,293
17669,9339,10759,0,0,35278,,,,,,1,1,7.377755956,18386,8282,7954,328,2,326
17669,10623,10684,2,1,37585,,,,,,1,1,7.740459602,19061,9091,8749,342,6,336
17669,10820,11442,4,4,36746,,,,,,1,1,7.617509287,18689,8876,8571,305,12,293
17669,10592,9509,2,0,36414,,,,,,1,1,7.473849972,18728,8691,8387,304,8,296
17669,9173,8282,0,0,36649,,,,,,1,1,7.540642623,19004,8698,8449,249,0,249
17669,10926,9892,0,0,34797,,,,,,1,1,7.201061157,18153,8163,7845,318,2,316
17669,9258,11466,0,2,36176,,,,,,1,1,7.386666264,18431,8726,8433,293,6,287
17669,9148,11160,0,0,36068,,,,,,1,1,7.523364881,18683,8533,8214,319,1,318
17669,11319,9249,0,2,35627,,,,,,1,1,7.315702169,18509,8413,8121,292,3,289
17669,9471,10492,2,2,37013,,,,,,1,1,7.660234783,18860,8920,8607,313,1,312
17669,10279,10201,0,2,35706,,,,,,1,1,7.434401531,18629,8388,8087,301,8,293
17669,10553,11779,0,2,35378,,,,,,1,1,7.492921046,18435,8303,7966,337,9,328
17669,10200,10546,0,0,37643,,,,,,1,1,7.7269972,19281,9024,8710,314,1,313
17669,9493,10626,0,0,35135,,,,,,1,1,7.155837666,18361,8242,7952,290,3,287
17669,9900,10264,2,0,35868,,,,,,1,1,7.537158073,18335,8619,8324,295,0,295
17669,11060,10286,0,0,37036,,,,,,1,1,7.556565082,18711,9002,8681,321,0,321
17669,10622,9636,2,2,37626,,,,,,1,1,7.73214777,19319,8999,8690,309,5,304
17669,7620,11961,2,0,36523,,,,,,1,1,7.448575482,18893,8670,8380,290,4,286
17669,10713,10568,2,2,34622,,,,,,1,1,7.281163323,18105,8122,7849,273,8,265
17669,9796,11342,0,2,34587,,,,,,1,1,7.14536214,18475,7900,7588,312,3,309
17669,10550,9399,4,0,37752,,,,,,1,1,7.855903065,19257,9092,8781,311,6,305
17669,9268,8487,0,0,36874,,,,,,1,1,7.570912301,18998,8802,8530,272,3,269
17669,10825,8353,2,0,37932,,,,,,1,1,8.009968571,18966,9339,9051,288,6,282
17669,8639,9996,0,11,37226,,,,,,1,1,7.543114949,19096,8949,8717,232,3,229
17669,10608,12107,2,2,33460,,,,,,1,1,6.941683663,17472,7818,7466,352,14,338
17669,9145,9960,0,2,36635,,,,,,1,1,7.763544112,18899,8724,8436,288,5,283
17669,11469,8684,4,2,36127,,,,,,1,1,7.238062785,18578,8616,8299,317,6,311
17669,8865,10287,0,0,37023,,,,,,1,1,7.611314867,19136,8805,8528,277,2,275
17669,11883,11641,2,4,20063,,,,,,1,1,4.072355468,10029,4858,4540,318,3,315
17669,11172,9025,0,0,35508,,,,,,1,1,7.331125321,18591,8316,8031,285,4,281
17669,8957,10269,0,0,36471,,,,,,1,1,7.436475999,18870,8646,8337,309,2,307
17669,10808,9864,0,3,37022,,,,,,1,1,7.5978798990000005,19338,8674,8338,336,2,334
17669,10588,9348,4,2,38792,,,,,,1,1,7.892587155,19700,9391,9081,310,5,305
17669,11346,11027,0,0,34756,,,,,,1,1,7.034431079,18176,8126,7798,328,3,325
17669,11230,10017,0,0,35786,,,,,,1,1,7.332186037,18573,8452,8143,309,4,305
17669,9886,11871,0,4,35795,,,,,,1,1,7.328655055,18521,8472,8142,330,2,328
17669,8980,9920,4,1,36441,,,,,,1,1,7.515156856,18595,8793,8533,260,3,257
17669,10381,10398,0,0,36025,,,,,,1,1,7.416789284,18591,8549,8213,336,1,335
17669,11803,9660,2,0,34275,,,,,,1,1,6.96535535,18000,7994,7707,287,3,284
17669,9714,9893,0,2,36551,,,,,,1,1,7.437502422,18738,8762,8473,289,0,289
17669,9960,10091,4,2,36635,,,,,,1,1,7.558430706,18696,8822,8527,295,3,292
17669,10306,9920,0,0,35501,,,,,,1,1,7.219124284,18580,8309,8006,303,6,297
17669,11956,11501,0,0,8437,,,,,,1,1,1.738833804,4101,2044,1796,248,0,248
17669,10393,10172,5,0,37030,,,,,,1,1,7.459696262,18823,8944,8625,319,0,319
17669,10124,10589,2,2,36949,,,,,,1,1,7.505004733,18693,8970,8654,316,4,312
17669,10160,8955,2,0,36733,,,,,,1,1,7.4383527019999995,18738,8858,8579,279,3,276
17669,9436,9822,0,4,37522,,,,,,1,1,7.88235334,19291,8975,8694,281,4,277
17669,10575,9688,0,0,35546,,,,,,1,1,7.412824615,18440,8408,8118,290,2,288
17669,9253,10352,1,3,37790,,,,,,1,1,7.667366919,19020,9243,8959,284,0,284
17669,8617,10954,0,0,36539,,,,,,1,1,7.539916213,18852,8694,8395,299,0,299
17669,8504,9854,0,0,36476,,,,,,1,1,7.3302144590000005,18973,8614,8339,275,4,271
17669,10180,9897,0,2,37241,,,,,,1,1,7.622606345,18957,8977,8647,330,7,323
17669,10204,11516,0,0,34723,,,,,,1,1,7.042039392,17977,8209,7881,328,6,322
17669,10085,11308,3,4,33957,,,,,,1,1,6.912230203,17600,8028,7727,301,8,293
17669,10037,10265,2,2,35635,,,,,,1,1,7.332635972,18647,8342,8038,304,1,303
17669,10446,11174,0,0,35544,,,,,,1,1,7.359691048,18263,8458,8093,365,1,364
17669,9250,10740,0,2,37147,,,,,,1,1,7.598886963,18946,8951,8652,299,1,298
17669,9878,10271,0,0,36245,,,,,,1,1,7.421835642,18759,8594,8296,298,2,296
17669,9747,11460,0,3,36235,,,,,,1,1,7.419342525,18407,8761,8455,306,3,303
17669,10944,12054,2,0,32864,,,,,,1,1,6.949039309,17518,7508,7178,330,0,330
17669,11195,9372,0,2,34568,,,,,,1,1,7.078733923,18090,8083,7771,312,11,301
17669,11451,10750,2,3,35233,,,,,,1,1,7.195257917,17930,8480,8137,343,6,337
17669,10898,10531,4,2,36133,,,,,,1,1,7.399961179,18754,8542,8247,295,3,292
17669,12670,8726,4,0,37168,,,,,,1,1,7.577222798,18523,9156,8823,333,1,332
17669,9775,10021,0,0,34525,,,,,,1,1,7.041109395,18073,8084,7800,284,5,279
17669,10084,9240,0,4,38914,,,,,,1,1,7.984397471,19349,9624,9307,317,4,313
17669,9572,10119,2,0,34643,,,,,,1,1,7.106210426,18199,8086,7814,272,1,271
17669,9110,10144,0,0,38586,,,,,,1,1,7.836548874,19001,9637,9326,311,3,308
17669,9274,10514,0,2,36197,,,,,,1,1,7.368166303,18596,8669,8406,263,2,261
17669,8118,11337,0,3,39059,,,,,,1,1,7.924196542,19426,9664,9359,305,5,300
17669,10158,10632,2,0,37034,,,,,,1,1,7.726041588,19027,8846,8531,315,2,313
17669,11275,10503,2,0,38092,,,,,,1,1,7.799559101,19205,9272,8929,343,0,343
17669,11478,8803,2,0,35038,,,,,,1,1,7.100233686,18156,8295,8003,292,0,292
17669,11083,9956,0,2,35520,,,,,,1,1,7.4360461749999995,18534,8338,8028,310,0,310
17669,9813,9728,2,0,34171,,,,,,1,1,7.125626058,18054,7935,7688,247,3,244
17669,11305,10271,0,1,36432,,,,,,1,1,7.422087869,18900,8598,8262,336,0,336
17669,9756,11060,0,0,38883,,,,,,1,1,7.860964694,19431,9568,9252,316,0,316
17669,9352,10099,2,0,36165,,,,,,1,1,7.416304448,18736,8578,8305,273,5,268
17669,10716,10125,2,0,36280,,,,,,1,1,7.399883899,18850,8568,8274,294,2,292
17669,9539,9964,2,2,35502,,,,,,1,1,7.324347316,18482,8365,8075,290,4,286
17669,9056,12194,2,2,38820,,,,,,1,1,7.906070982,19143,9651,9276,375,10,365
17669,11025,11342,2,4,35944,,,,,,1,1,7.298192139,18519,8553,8234,319,1,318
17669,10073,10090,0,0,36974,,,,,,1,1,7.456551702,18864,8889,8557,332,0,332
17669,11877,11294,0,0,10099,,,,,,1,1,2.1667508030000002,4945,2433,2145,288,1,287
17669,10379,10856,0,0,36006,,,,,,1,1,7.567735921,18344,8685,8393,292,0,292
17669,10366,10640,0,0,36086,,,,,,1,1,7.413408889,18806,8477,8151,326,4,322
17669,9071,10515,2,0,35512,,,,,,1,1,7.245309786,18357,8437,8156,281,6,275
17669,10937,9791,0,0,35359,,,,,,1,1,7.259813965,18463,8302,8010,292,0,292
17669,10522,9286,0,0,37217,,,,,,1,1,7.629421906,19186,8875,8594,281,1,280
17669,9576,10267,2,0,36060,,,,,,1,1,7.323954057,18840,8457,8151,306,6,300
17669,11913,8473,0,0,35535,,,,,,1,1,7.437981255,18234,8499,8196,303,2,301
17669,10050,8167,2,0,36699,,,,,,1,1,7.542021428,18938,8763,8528,235,7,228
17669,10702,10720,4,1,36948,,,,,,1,1,7.620237498,18670,8971,8635,336,17,319
17669,9259,10218,0,0,37697,,,,,,1,1,7.730564972,19441,8973,8663,310,3,307
17669,10926,11310,0,4,37560,,,,,,1,1,7.563255381,19032,9082,8718,364,6,358
17669,11304,10889,0,4,33720,,,,,,1,1,6.978945648,17341,8028,7705,323,19,304
17669,10266,10843,4,0,36211,,,,,,1,1,7.420355248,18478,8713,8406,307,9,298
17669,11233,11942,0,0,2839,,,,,,1,1,0.621372264,1270,694,513,181,0,181
17669,10326,8851,2,0,37819,,,,,,1,1,7.78317939,19389,9052,8726,326,3,323
17669,9018,10203,4,0,38313,,,,,,1,1,7.735654398,19332,9345,9054,291,2,289
17669,11272,10900,2,1,34624,,,,,,1,1,7.151985848,18187,8059,7740,319,6,313
17669,10406,10687,2,3,35981,,,,,,1,1,7.332080115,18379,8654,8360,294,8,286
17669,11228,9217,3,0,35619,,,,,,1,1,7.226676888,18773,8278,7988,290,0,290
17669,10289,9441,0,0,35497,,,,,,1,1,7.228358671,18788,8207,7912,295,5,290
17669,9866,10448,2,2,38814,,,,,,1,1,7.878037408,19359,9567,9246,321,5,316
17669,10234,9841,2,0,37577,,,,,,1,1,7.835243313,19204,9021,8690,331,5,326
17669,10566,9857,2,0,35469,,,,,,1,1,7.240340035,18345,8411,8109,302,2,300
17669,11156,9635,0,2,35623,,,,,,1,1,7.296798018,18118,8600,8295,305,2,303
17669,11645,11221,2,0,34868,,,,,,1,1,7.456860305,17868,8332,7996,336,3,333
17669,10378,9698,0,0,36841,,,,,,1,1,7.586978618,19079,8732,8434,298,0,298
17669,10066,9591,4,0,36588,,,,,,1,1,7.364211603,18796,8752,8464,288,1,287
17669,10280,11542,0,4,36455,,,,,,1,1,7.43865981,18337,8901,8585,316,5,311
17669,9823,10518,0,0,33542,,,,,,1,1,6.926611518,17883,7701,7444,257,1,256
17669,10383,11610,0,0,33602,,,,,,1,1,7.065959824,17747,7772,7461,311,0,311
17669,10678,10921,5,2,35983,,,,,,1,1,7.341190149,18394,8627,8292,335,3,332
17669,9102,10464,0,2,37915,,,,,,1,1,7.783739432,19065,9267,8951,316,2,314
17669,10876,9332,0,0,35048,,,,,,1,1,7.263868734,18286,8234,7940,294,1,293
17669,11164,10203,2,0,35885,,,,,,1,1,7.503805376,18339,8609,8281,328,4,324
17669,10672,11191,0,6,34657,,,,,,1,1,7.094702866,18048,8148,7835,313,6,307
17669,9553,11011,2,0,35436,,,,,,1,1,7.371326355,18249,8431,8106,325,3,322
17669,10535,9986,0,2,37220,,,,,,1,1,7.543338921,19202,8863,8571,292,2,290
17669,10442,10597,2,0,34623,,,,,,1,1,7.064025694,18056,8121,7796,325,3,322
17669,9485,9459,2,0,37111,,,,,,1,1,7.559025408,18820,9011,8742,269,1,268
17669,11817,9592,0,2,35100,,,,,,1,1,7.186316587,18252,8270,7962,308,3,305
17669,10423,10768,0,0,36738,,,,,,1,1,7.440528428,18510,8959,8649,310,0,310
17669,9840,8900,0,2,36841,,,,,,1,1,7.589707434,19058,8753,8476,277,2,275
17669,10942,8966,2,0,37918,,,,,,1,1,7.643500143,19119,9249,8948,301,2,299
17669,10154,11544,0,2,38202,,,,,,1,1,7.739929175,19273,9284,8923,361,9,352
17669,9860,11233,0,2,35566,,,,,,1,1,7.2623547649999995,18404,8418,8092,326,3,323
17669,11049,11201,2,0,33933,,,,,,1,1,7.140863672,17892,7863,7548,315,2,313
17669,10385,9376,2,0,37823,,,,,,1,1,7.832909108,19339,9093,8795,298,1,297
17669,8651,9773,0,0,37474,,,,,,1,1,7.626910076,19368,8918,8648,270,0,270
17669,10407,9901,0,0,36583,,,,,,1,1,7.603636809,18883,8699,8397,302,1,301
17669,11006,10589,2,4,34178,,,,,,1,1,7.1123753690000004,18125,7875,7572,303,4,299
17669,10700,9860,4,2,38276,,,,,,1,1,7.741276456,19163,9392,9063,329,9,320
17669,9040,11463,0,0,35040,,,,,,1,1,7.445944403,18480,8129,7827,302,8,294
17669,10194,11753,0,0,36682,,,,,,1,1,7.433106023,18689,8825,8482,343,3,340
17669,11635,10319,0,0,33782,,,,,,1,1,6.882113339,17692,7883,7559,324,1,323
17669,9920,11774,2,0,34943,,,,,,1,1,7.09982947,18315,8146,7810,336,1,335
17669,9335,8955,0,0,36250,,,,,,1,1,7.329357615,18474,8766,8522,244,0,244
17669,11961,9656,3,0,34384,,,,,,1,1,7.033152345,17981,8048,7741,307,0,307
17669,10473,10888,0,2,35844,,,,,,1,1,7.507094142,18341,8591,8270,321,3,318
17669,9764,9431,0,2,35115,,,,,,1,1,7.184334097,18498,8180,7923,257,2,255
17669,10738,9025,4,0,34475,,,,,,1,1,7.003555367,18281,7957,7677,280,6,274
17669,10193,10555,0,0,34580,,,,,,1,1,7.108273205,18367,7971,7700,271,3,268
17669,9562,10626,0,3,35699,,,,,,1,1,7.356888015,18466,8483,8216,267,5,262
17669,10589,10751,0,2,36396,,,,,,1,1,7.6952753860000005,18618,8711,8355,356,0,356
17669,9588,12606,0,1,35394,,,,,,1,1,7.235654897,18237,8418,8097,321,4,317
17669,10486,8254,2,0,37172,,,,,,1,1,7.557841392,19024,8938,8666,272,10,262
17669,10542,9894,0,0,35110,,,,,,1,1,7.3175530460000004,18581,8109,7798,311,3,308
17669,10144,11447,2,0,35842,,,,,,1,1,7.227839376,18207,8652,8321,331,3,328
17669,10826,10937,1,0,35602,,,,,,1,1,7.282007821,18814,8230,7902,328,3,325
17669,9211,10362,2,0,37428,,,,,,1,1,7.590768907,18898,9108,8794,314,2,312
17669,10063,11333,1,0,37026,,,,,,1,1,7.638933987,18885,8894,8541,353,1,352
17669,10175,8937,3,2,34868,,,,,,1,1,7.345673804,18099,8243,7960,283,3,280
17669,10236,10833,0,2,36021,,,,,,1,1,7.497020377,18714,8498,8187,311,6,305
17669,12272,10171,2,0,33662,,,,,,1,1,6.867699245,17579,7883,7566,317,8,309
17669,12215,10297,1,0,35845,,,,,,1,1,7.402786684,18480,8520,8195,325,2,323
17669,10722,10084,0,0,35400,,,,,,1,1,7.471855845,18339,8375,8064,311,2,309
17669,10193,12028,2,4,36137,,,,,,1,1,7.469039226,18240,8773,8422,351,2,349
17669,10402,10012,0,4,36688,,,,,,1,1,7.610112379,19143,8619,8312,307,11,296
17669,10817,11974,0,4,35634,,,,,,1,1,7.303018982,18054,8621,8283,338,5,333
17669,10534,9451,6,0,36081,,,,,,1,1,7.358490373,18777,8517,8247,270,1,269
17669,10981,9751,2,0,35795,,,,,,1,1,7.381417902,18561,8458,8140,318,5,313
17669,12440,10888,5,0,18903,,,,,,1,1,3.851611286,9372,4605,4284,321,8,313
17669,11277,10224,2,2,35510,,,,,,1,1,7.394429387,18429,8375,8044,331,9,322
17669,10883,9671,0,0,36528,,,,,,1,1,7.682851579,18516,8842,8514,328,0,328
17669,9624,10810,1,2,35825,,,,,,1,1,7.430025459,18582,8475,8182,293,3,290
17669,10258,11395,2,0,36372,,,,,,1,1,7.431902712,18800,8619,8285,334,0,334
17669,9758,10627,0,2,35366,,,,,,1,1,7.221835997,18382,8344,8048,296,3,293
17669,10655,9181,2,2,36361,,,,,,1,1,7.314935552,18744,8674,8405,269,1,268
17669,10469,11156,0,2,37773,,,,,,1,1,7.79324273,19028,9212,8891,321,9,312
17669,12896,9970,6,0,37563,,,,,,1,1,7.687856013,18833,9184,8822,362,6,356
17669,11214,9860,4,2,35011,,,,,,1,1,7.154373857,18295,8190,7854,336,14,322
17669,10320,12406,0,0,36332,,,,,,1,1,7.693242296,18205,8898,8567,331,1,330
17669,8487,9844,0,3,38480,,,,,,1,1,7.786521613,19470,9359,9067,292,2,290
17669,9848,11027,0,0,36526,,,,,,1,1,7.416453611,18605,8804,8491,313,1,312
17669,11405,10917,0,2,35860,,,,,,1,1,7.512350415,18065,8732,8401,331,4,327
17669,11945,11567,0,2,26911,,,,,,1,1,5.478045241,13703,6434,6094,340,1,339
17669,10733,10136,3,0,36892,,,,,,1,1,7.6959009290000004,19007,8788,8479,309,4,305
17669,10374,10100,0,1,36976,,,,,,1,1,7.587968224,19001,8841,8548,293,2,291
17669,10241,10951,2,4,37808,,,,,,1,1,7.617898738,18897,9293,8968,325,4,321
17669,11035,9978,0,0,34534,,,,,,1,1,7.176673968,17916,8169,7889,280,0,280
17669,8714,10986,0,0,35946,,,,,,1,1,7.611976836,18351,8659,8382,277,2,275
17669,9894,10428,0,0,36919,,,,,,1,1,7.755642595,18496,9062,8763,299,3,296
17669,10918,11675,0,0,36982,,,,,,1,1,7.649288155,18638,8998,8650,348,1,347
17669,11205,10971,0,2,35585,,,,,,1,1,7.398392172,17786,8741,8424,317,6,311
17669,9045,11048,0,0,36307,,,,,,1,1,7.588574396,18816,8593,8288,305,4,301
17669,10107,10496,2,0,34553,,,,,,1,1,7.348705478,18047,8109,7821,288,9,279
17669,9591,11303,0,0,36556,,,,,,1,1,7.6050781,18512,8868,8560,308,1,307
17669,11522,10429,6,0,34739,,,,,,1,1,7.168592094,18168,8133,7828,305,9,296
17669,10444,9955,0,2,37889,,,,,,1,1,7.813862881,18971,9304,8994,310,5,305
17669,10034,10955,3,2,34205,,,,,,1,1,6.983457015,17764,8079,7796,283,9,274
17669,10529,10973,0,2,33834,,,,,,1,1,6.905413139,17670,7937,7647,290,3,287
17669,10162,8765,2,0,35322,,,,,,1,1,7.155227183,18270,8382,8094,288,3,285
17669,9328,10015,0,1,36220,,,,,,1,1,7.635028959,18797,8574,8299,275,1,274
17669,10913,10543,6,2,37368,,,,,,1,1,7.63734657,19025,8997,8648,349,0,349
17669,7844,10127,0,2,37744,,,,,,1,1,7.690254946,19272,9095,8813,282,1,281
17669,9157,10237,0,0,36819,,,,,,1,1,7.479652573,18941,8786,8480,306,3,303
17669,10708,9802,3,2,36095,,,,,,1,1,7.519229174,18237,8784,8494,290,3,287
17669,8578,9491,0,2,38300,,,,,,1,1,7.9597208120000005,19244,9387,9105,282,4,278
17669,10586,9600,0,0,35509,,,,,,1,1,7.346601881,18694,8250,7935,315,3,312
17669,10869,9571,0,0,35318,,,,,,1,1,7.240816878,18370,8318,8006,312,2,310
17669,10488,10576,4,0,36340,,,,,,1,1,7.363016578,18517,8743,8406,337,11,326
17669,11056,10325,5,0,33742,,,,,,1,1,6.900431211,18079,7676,7365,311,3,308
17669,11341,11944,0,0,4519,,,,,,1,1,0.970429729,2122,1099,900,199,2,197
17669,11314,10644,0,0,33750,,,,,,1,1,6.977890086,17712,7856,7530,326,1,325
17669,11168,10187,2,4,35520,,,,,,1,1,7.166824374,18039,8581,8262,319,5,314
17669,11256,11836,0,2,35139,,,,,,1,1,7.322703872,18161,8316,7970,346,1,345
17669,10600,9458,0,0,35661,,,,,,1,1,7.450558001,18719,8327,8039,288,2,286
17669,10431,9543,0,0,37586,,,,,,1,1,7.762302758,19326,8975,8665,310,2,308
17669,8137,10095,2,0,36562,,,,,,1,1,7.482230491,19153,8564,8283,281,6,275
17669,9961,11494,2,0,33520,,,,,,1,1,6.935671386,17309,7969,7696,273,1,272
17669,9322,8946,2,0,38072,,,,,,1,1,7.811448496,19078,9361,9089,272,5,267
17669,9433,10467,0,0,35665,,,,,,1,1,7.397071047,18308,8529,8230,299,2,297
17669,10372,12261,0,2,36359,,,,,,1,1,7.423621266,18439,8790,8450,340,4,336
17669,10807,9805,2,2,35216,,,,,,1,1,7.152313079,18257,8327,8022,305,5,300
17669,10893,10449,4,2,36109,,,,,,1,1,7.287871085,18448,8673,8358,315,3,312
17669,12003,10895,4,4,35471,,,,,,1,1,7.230480486,18244,8447,8114,333,1,332
17669,10291,10005,1,4,34628,,,,,,1,1,7.129250026,18327,8022,7765,257,3,254
17669,10780,8820,2,0,36303,,,,,,1,1,7.404701567,18997,8512,8230,282,1,281
17669,11022,11960,0,2,33016,,,,,,1,1,6.844763317,17222,7743,7435,308,0,308
17669,11353,10041,6,2,34405,,,,,,1,1,7.190249033,18238,7927,7614,313,21,292
17669,11215,8960,0,2,34556,,,,,,1,1,7.053414988,18174,8055,7783,272,1,271
17669,9739,10838,0,0,37032,,,,,,1,1,7.502422012,18669,9027,8718,309,3,306
17669,10242,10528,0,0,36477,,,,,,1,1,7.498429946,18805,8688,8392,296,0,296
17669,10792,9939,0,2,35636,,,,,,1,1,7.362542434,18907,8225,7946,279,0,279
17669,10548,10857,0,0,37857,,,,,,1,1,7.732949386,19319,9104,8774,330,1,329
17669,8942,8023,0,0,37892,,,,,,1,1,7.652269092,19561,9029,8756,273,4,269
17669,9544,11344,2,2,35876,,,,,,1,1,7.4415215,18716,8429,8127,302,1,301
17669,10392,11073,2,0,36758,,,,,,1,1,7.420216203,18633,8908,8599,309,1,308
17669,11037,10894,0,4,35389,,,,,,1,1,7.294147908,18167,8446,8116,330,1,329
17669,9154,10978,0,0,37653,,,,,,1,1,7.781385585,18995,9167,8843,324,2,322
17669,9881,10883,2,0,37277,,,,,,1,1,7.518495447,18836,9064,8751,313,4,309
17669,9781,10426,0,0,36417,,,,,,1,1,7.387316033,18594,8741,8400,341,0,341
17669,10744,9572,2,0,38751,,,,,,1,1,7.836108774,19144,9631,9286,345,7,338
17669,10743,9053,2,0,37898,,,,,,1,1,7.64531683,19017,9278,8953,325,2,323
17669,10867,11288,0,2,35052,,,,,,1,1,7.135677239,18292,8220,7900,320,3,317
17669,10751,10728,4,0,35823,,,,,,1,1,6.516068089,18240,8629,8304,325,8,317
17669,10416,10307,3,0,36206,,,,,,1,1,7.3577995640000005,18253,8814,8489,325,4,321
17669,9081,9745,0,2,36014,,,,,,1,1,6.975303782,18434,8664,8412,252,3,249
17669,11081,10379,0,2,34644,,,,,,1,1,7.030705363,17774,8283,7979,304,5,299
17669,10330,11368,0,0,36978,,,,,,1,1,6.2592190930000005,18916,8856,8506,350,1,349
17669,9421,10205,2,0,37013,,,,,,1,1,6.9838004,19119,8794,8488,306,3,303
17669,12168,11003,4,2,21704,,,,,,1,1,4.242775709,10856,5259,4929,330,11,319
17669,10430,9831,2,8,35874,,,,,,1,1,5.884022761,18512,8532,8234,298,12,286
17669,10039,10231,4,0,36627,,,,,,1,1,7.350315994,18898,8715,8416,299,0,299
17669,10916,9003,0,0,36659,,,,,,1,1,7.383061609,18837,8755,8443,312,2,310
17669,12096,10864,2,0,33705,,,,,,1,1,4.955542138,18039,7672,7350,322,1,321
17669,10137,11235,0,3,37553,,,,,,1,1,7.44725164,19117,9047,8705,342,2,340
17669,11770,9486,4,0,34076,,,,,,1,1,4.615612221,17982,7886,7564,322,4,318
17669,9681,10881,0,0,36879,,,,,,1,1,6.571586781,18834,8872,8571,301,0,301
17669,9506,10009,2,2,37942,,,,,,1,1,6.197367365,19296,9148,8798,350,12,338
17669,9668,10712,4,0,38533,,,,,,1,1,7.743187983,19152,9535,9224,311,10,301
17669,10293,9605,0,2,37762,,,,,,1,1,7.350863676,19315,9069,8760,309,12,297
17669,10224,10596,2,0,35775,,,,,,1,1,7.197120677,18757,8352,8038,314,3,311
17669,9333,11033,0,2,37230,,,,,,1,1,7.061757981,18959,8973,8648,325,3,322
