key_bits,recovered_zeros_x,recovered_zeros_y,wrong_zeros_x,wrong_zeros_y,queries,traces,calibration_traces,threshold,tpr,tnr,attack_tpr,attack_tnr,duration_seconds,test_outcomes_0_false,test_outcomes_0_true,test_outcomes_1_false,test_outcomes_1_true,test_outcomes_2_false,test_outcomes_2_true
17669,10206,11484,2,2,2009,,,,,,1,1,0.418429262,833,513,363,150,0,150
17669,11167,10510,2,2,6470,,,,,,1,1,1.318304942,3021,1621,1414,207,2,205
17669,11378,10348,2,0,7597,,,,,,1,1,1.531074729,3702,1835,1610,225,0,225
17669,11653,10016,0,2,10581,,,,,,1,1,2.149726342,5177,2579,2333,246,1,245
17669,11374,10298,0,0,12638,,,,,,1,1,2.586363061,6272,3065,2829,236,2,234
17669,10781,10945,4,0,2411,,,,,,1,1,0.48983673,1078,590,437,153,3,150
17669,9895,11774,0,0,14582,,,,,,1,1,3.132485362,7436,3444,3186,258,1,257
17669,11018,10652,0,1,14353,,,,,,1,1,2.889080869,7153,3462,3186,276,3,273
17669,10807,10862,0,0,25547,,,,,,1,1,5.439585464,12743,6237,5907,330,2,328
17669,11113,9767,3,0,34106,,,,,,1,1,7.014730436,18105,7866,7597,269,1,268
17669,10386,10814,0,0,34281,,,,,,1,1,7.134031203,17873,8050,7742,308,3,305
17669,9853,11346,2,2,34796,,,,,,1,1,7.175412695,18272,8088,7740,348,12,336
17669,10896,9351,1,1,35449,,,,,,1,1,7.209071182,18638,8267,7990,277,1,276
17669,10611,9278,2,0,35312,,,,,,1,1,7.229938086,18625,8203,7922,281,4,277
17669,11332,10269,2,0,35585,,,,,,1,1,7.279090902,18290,8460,8085,375,6,369
17669,10516,10759,2,0,35821,,,,,,1,1,7.327356404,18477,8526,8234,292,1,291
17669,10496,9551,2,0,35890,,,,,,1,1,7.406890045,18631,8473,8160,313,6,307
17669,10378,9698,0,0,36865,,,,,,1,1,7.455123386,19079,8740,8434,306,0,306
17669,9633,10520,2,2,36212,,,,,,1,1,7.515101874,18877,8518,8219,299,7,292
17669,9514,10878,2,0,36306,,,,,,1,1,7.572465461,18261,8867,8556,311,3,308
17669,10902,10424,4,0,36155,,,,,,1,1,7.582342629,18543,8647,8329,318,6,312
17669,8813,10486,0,4,36964,,,,,,1,1,7.662914847,18954,8859,8567,292,8,284
17669,10199,9012,2,0,37632,,,,,,1,1,7.693650478,19409,8967,8678,289,1,288
17669,10230,11263,0,1,37242,,,,,,1,1,7.856536432,18925,9005,8698,307,0,307
17669,8617,10954,0,0,36524,,,,,,1,1,7.499477641,18852,8689,8395,294,0,294
17669,10845,8230,2,0,39042,,,,,,1,1,7.973243247,19683,9528,9225,303,7,296
17669,10588,9348,4,2,38498,,,,,,1,1,8.101024768,19561,9323,9032,291,5,286
17669,8118,11337,0,3,39126,,,,,,1,1,8.183308134,19430,9694,9386,308,4,304
17669,10565,9329,4,0,35869,,,,,,1,1,7.39564908,18366,8606,8315,291,4,287
17669,10760,10967,0,2,11414,,,,,,1,1,2.366419452,5725,2716,2459,257,1,256
17669,10128,11590,0,0,13067,,,,,,1,1,2.735961776,6494,3151,2880,271,0,271
17669,10341,8234,0,0,36792,,,,,,1,1,7.45263595,18950,8789,8525,264,2,262
17669,10649,10812,0,2,36873,,,,,,1,1,7.568229598,18659,8947,8627,320,0,320
17669,11042,10630,0,2,16266,,,,,,1,1,3.381164843,8066,3966,3698,268,1,267
17669,10833,10837,0,0,19879,,,,,,1,1,4.132345997,9899,4845,4555,290,0,290
17669,10462,10129,4,2,37129,,,,,,1,1,7.769439491,18759,9025,8705,320,4,316
17669,11149,10744,0,0,11154,,,,,,1,1,2.258493125,5428,2738,2488,250,2,248
17669,10379,10400,2,0,32088,,,,,,1,1,6.719384592,16999,7415,7156,259,1,258
17669,9415,11981,0,6,33991,,,,,,1,1,6.929529956,17868,7929,7664,265,3,262
17669,10531,11299,0,4,30119,,,,,,1,1,6.167948698,15204,7288,6949,339,5,334
17669,10003,11079,0,0,35525,,,,,,1,1,7.203523189,18446,8378,8055,323,1,322
17669,10314,11362,0,0,967,,,,,,1,1,0.201962992,335,261,151,110,0,110
17669,10096,10070,0,2,36872,,,,,,1,1,7.436608996,18897,8841,8548,293,3,290
17669,10888,9079,0,0,37203,,,,,,1,1,7.736693199,18980,8953,8636,317,1,316
17669,10407,9901,0,0,36646,,,,,,1,1,7.487145825,18883,8720,8397,323,1,322
17669,7995,9070,4,2,36855,,,,,,1,1,7.586208322,18906,8858,8625,233,3,230
17669,10800,10463,0,0,37639,,,,,,1,1,7.709837548,19103,9095,8749,346,1,345
17669,11083,9956,0,2,35648,,,,,,1,1,7.229284585,18594,8370,8056,314,0,314
17669,10490,9100,0,0,36071,,,,,,1,1,7.476593817,18444,8675,8398,277,3,274
17669,10377,10543,0,0,36302,,,,,,1,1,7.6106171190000005,18750,8615,8293,322,4,318
17669,9666,11616,2,0,38144,,,,,,1,1,7.872612018,19164,9317,8971,346,5,341
17669,10889,10304,5,0,37220,,,,,,1,1,7.658177597,19138,8878,8552,326,1,325
17669,11019,10791,0,0,1920,,,,,,1,1,0.392324947,816,479,333,146,0,146
17669,9878,10271,0,0,36284,,,,,,1,1,7.44252286,18759,8607,8296,311,2,309
17669,9158,10676,0,0,36619,,,,,,1,1,7.770404094,19037,8637,8329,308,1,307
17669,10355,11316,0,0,10797,,,,,,1,1,2.244054363,5316,2619,2376,243,1,242
17669,9513,12157,0,0,5343,,,,,,1,1,1.233052854,2528,1308,1109,199,0,199
17669,11849,9853,0,0,4510,,,,,,1,1,0.947353207,2087,1124,949,175,0,175
17669,11997,9770,1,0,6327,,,,,,1,1,1.292096494,3076,1523,1318,205,0,205
17669,10632,11058,0,0,5200,,,,,,1,1,1.106075968,2452,1277,1083,194,0,194
17669,10412,9028,4,2,37476,,,,,,1,1,7.672693829,19186,8986,8668,318,2,316
17669,12027,9539,0,0,34179,,,,,,1,1,6.995214246,17968,7959,7666,293,1,292
17669,9068,10875,0,3,35369,,,,,,1,1,7.3530250200000005,18619,8231,7943,288,4,284
17669,10324,10933,1,2,36991,,,,,,1,1,7.701816509,18985,8832,8490,342,3,339
17669,9992,11027,0,4,36205,,,,,,1,1,7.410615534,18402,8728,8381,347,2,345
17669,10992,10861,2,0,16977,,,,,,1,1,3.42107486,8570,4061,3776,285,0,285
17669,10271,8485,0,0,38523,,,,,,1,1,8.020476831,19271,9476,9176,300,3,297
17669,11640,10039,2,0,7578,,,,,,1,1,1.5714728949999999,3632,1863,1643,220,4,216
17669,9667,11666,2,3,35074,,,,,,1,1,7.27219733,18424,8166,7848,318,10,308
17669,10953,10056,0,2,36098,,,,,,1,1,7.365435442,18701,8551,8256,295,1,294
17669,11746,9991,0,0,18517,,,,,,1,1,3.826353402,9469,4394,4134,260,1,259
17669,11327,10364,2,2,3475,,,,,,1,1,0.709930236,1651,837,687,150,0,150
17669,10592,9509,2,0,36418,,,,,,1,1,7.358677223,18728,8691,8383,308,6,302
17669,10130,10455,2,2,37241,,,,,,1,1,7.647925571,19258,8837,8528,309,2,307
17669,9485,9459,2,0,37144,,,,,,1,1,7.62564728,18856,9012,8748,264,1,263
17669,10364,9734,0,0,35260,,,,,,1,1,7.201042153,18372,8285,7967,318,3,315
17669,11495,9126,3,2,35420,,,,,,1,1,7.153153509,18257,8444,8169,275,1,274
17669,10454,9687,4,1,38554,,,,,,1,1,7.757984953,19751,9222,8863,359,22,337
17669,8807,10122,0,2,35179,,,,,,1,1,7.174689703,18386,8260,7987,273,6,267
17669,8550,9701,0,2,36465,,,,,,1,1,7.572784189,19213,8494,8230,264,15,249
17669,10020,9149,2,0,37784,,,,,,1,1,7.723235869,19172,9163,8877,286,3,283
17669,10801,10537,4,1,34753,,,,,,1,1,7.367185469,18259,8094,7788,306,7,299
17669,11168,9780,4,0,38542,,,,,,1,1,7.85773537,19358,9418,9070,348,13,335
17669,10905,10413,2,0,36152,,,,,,1,1,7.529762567,18463,8683,8360,323,2,321
17669,10609,10691,1,4,35979,,,,,,1,1,7.401666775,18604,8536,8233,303,2,301
17669,9894,10428,0,0,36820,,,,,,1,1,7.644456123,18496,9029,8763,266,3,263
17669,11278,10395,0,0,2039,,,,,,1,1,0.419472264,907,503,377,126,0,126
17669,10011,10511,0,0,37048,,,,,,1,1,7.615979407,18809,8958,8635,323,1,322
17669,9969,10162,4,5,37536,,,,,,1,1,7.903206433,19253,8979,8654,325,13,312
17669,9251,8511,3,0,38423,,,,,,1,1,7.926392969,19662,9257,9010,247,1,246
17669,11099,10570,0,0,31743,,,,,,1,1,6.469506249,16263,7583,7269,314,3,311
17669,9517,11718,0,0,37897,,,,,,1,1,7.874611603,18895,9332,8994,338,2,336
17669,10566,9857,2,0,35346,,,,,,1,1,7.25201646,18311,8379,8102,277,2,275
17669,10869,10321,0,0,35254,,,,,,1,1,7.186107557,18391,8287,7998,289,5,284
17669,10530,11208,0,4,10839,,,,,,1,1,2.252388533,5282,2658,2417,241,2,239
17669,11215,8866,2,0,36478,,,,,,1,1,7.60472472,18614,8796,8524,272,4,268
17669,9589,11362,0,4,35558,,,,,,1,1,7.416783188,18197,8519,8196,323,6,317
17669,10857,11137,0,0,10147,,,,,,1,1,2.064493026,5109,2405,2177,228,1,227
17669,10974,9646,2,2,38350,,,,,,1,1,7.774935605,19589,9226,8917,309,2,307
17669,11328,10345,0,0,13334,,,,,,1,1,2.69471492,6392,3322,3024,298,0,298
17669,10569,10610,0,0,37035,,,,,,1,1,7.510053428,18982,8876,8575,301,2,299
17669,11803,10223,2,2,5391,,,,,,1,1,1.102827482,2584,1305,1108,197,2,195
17669,10738,9025,4,0,34990,,,,,,1,1,7.310882612,18517,8087,7788,299,12,287
17669,11160,9551,3,0,35252,,,,,,1,1,7.103199857,18570,8199,7915,284,5,279
17669,10514,10369,0,2,38107,,,,,,1,1,7.750880317,19377,9207,8891,316,1,315
17669,7964,10771,0,0,37170,,,,,,1,1,7.513883313,19094,8893,8603,290,3,287
17669,9628,12173,2,0,2661,,,,,,1,1,0.542632079,1192,658,505,153,0,153
17669,8927,8964,0,0,38759,,,,,,1,1,7.866037006,19877,9312,9054,258,1,257
17669,10739,10933,0,0,3013,,,,,,1,1,0.63846096,1367,741,577,164,0,164
17669,9925,11312,0,1,36140,,,,,,1,1,7.304535607,18452,8672,8328,344,1,343
17669,9727,11423,0,2,35077,,,,,,1,1,7.20048913,18019,8366,8040,326,7,319
17669,10341,10864,4,0,38492,,,,,,1,1,7.91986638,19548,9301,8959,342,2,340
17669,10832,10742,0,2,36823,,,,,,1,1,7.528704145,18548,8966,8623,343,6,337
17669,10342,9789,3,0,36961,,,,,,1,1,7.50039415,18919,8859,8535,324,4,320
17669,9633,10889,2,0,34628,,,,,,1,1,7.071031608,18119,8107,7812,295,3,292
17669,8567,10821,2,0,38860,,,,,,1,1,7.999563162,19232,9660,9352,308,4,304
17669,9961,11595,3,2,35839,,,,,,1,1,7.311368895,18414,8555,8240,315,1,314
17669,9747,12116,4,2,4593,,,,,,1,1,0.966846123,2218,1092,901,191,7,184
17669,10733,10136,3,0,36972,,,,,,1,1,7.654225659,19019,8813,8486,327,6,321
17669,10680,9779,2,0,36530,,,,,,1,1,7.597929642,18566,8822,8502,320,2,318
17669,11399,10610,0,0,2867,,,,,,1,1,0.588418501,1302,703,544,159,0,159
17669,10412,11305,0,4,19820,,,,,,1,1,3.998631113,9893,4812,4509,303,1,302
17669,10379,10159,4,0,37843,,,,,,1,1,7.706072559,19321,9088,8742,346,0,346
17669,10531,11138,2,0,12196,,,,,,1,1,2.576399045,6064,2939,2685,254,0,254
17669,11525,10460,2,4,30667,,,,,,1,1,6.452409272,15500,7437,7144,293,2,291
17669,10001,10400,2,0,37441,,,,,,1,1,7.751732435,18935,9096,8782,314,0,314
17669,10205,11107,2,4,35051,,,,,,1,1,7.368109375,17890,8426,8117,309,6,303
17669,10945,10724,0,0,7213,,,,,,1,1,1.454797549,3480,1749,1514,235,0,235
17669,10970,10699,0,0,25720,,,,,,1,1,5.405139792,12868,6269,5955,314,5,309
17669,10034,11744,0,4,2848,,,,,,1,1,0.576551534,1248,719,557,162,2,160
17669,10063,11333,1,0,36890,,,,,,1,1,7.475620801,18854,8856,8532,324,1,323
17669,10390,11385,0,0,29270,,,,,,1,1,5.963372729,15404,6786,6492,294,1,293
17669,10581,10804,2,2,35655,,,,,,1,1,7.286005715,18516,8411,8094,317,18,299
17669,9453,9795,0,0,36350,,,,,,1,1,7.58193537,18925,8561,8258,303,4,299
17669,10961,10711,0,0,3709,,,,,,1,1,0.788844218,1643,934,736,198,0,198
17669,10258,11395,2,0,36366,,,,,,1,1,7.442008557,18800,8617,8285,332,0,332
17669,9572,10906,0,2,37332,,,,,,1,1,7.679840953,18986,9016,8702,314,3,311
17669,8946,9186,0,0,36774,,,,,,1,1,7.425432262,19040,8743,8495,248,2,246
17669,11466,10495,2,2,5722,,,,,,1,1,1.158757699,2752,1378,1164,214,1,213
17669,9723,10928,2,0,34620,,,,,,1,1,7.130230631,18054,8143,7863,280,3,277
17669,8963,10282,0,2,34547,,,,,,1,1,7.211634782,18555,7879,7645,234,0,234
17669,10446,9804,2,0,37302,,,,,,1,1,7.675870549,19091,8948,8633,315,7,308
17669,9429,9791,5,0,35155,,,,,,1,1,7.313017954,18150,8380,8135,245,2,243
17669,10666,10952,0,6,37184,,,,,,1,1,7.592273833,18633,9109,8776,333,3,330
17669,9856,11465,0,1,34690,,,,,,1,1,7.125325836,18198,8084,7760,324,1,323
17669,11071,8738,0,0,36999,,,,,,1,1,7.579917038,18760,8956,8629,327,3,324
17669,8980,9279,2,2,38416,,,,,,1,1,7.81131431,19058,9525,9217,308,5,303
17669,10586,9600,0,0,35563,,,,,,1,1,7.297699026,18694,8268,7935,333,3,330
17669,10788,10881,1,0,17915,,,,,,1,1,3.619229255,9284,4171,3882,289,2,287
17669,9868,11805,0,0,10320,,,,,,1,1,2.077295456,4991,2552,2327,225,1,224
17669,10732,10966,0,2,5032,,,,,,1,1,1.034389668,2333,1245,1036,209,0,209
17669,9070,9613,1,0,36202,,,,,,1,1,7.395266162,18931,8489,8196,293,3,290
17669,11098,10572,0,2,17800,,,,,,1,1,3.683938841,8976,4279,4013,266,4,262
17669,10924,10749,0,0,10734,,,,,,1,1,2.181457311,5432,2540,2318,222,0,222
17669,10730,10700,4,4,34651,,,,,,1,1,7.140081569,18028,8164,7869,295,4,291
17669,11339,10331,2,0,14424,,,,,,1,1,2.931543692,7405,3379,3118,261,0,261
17669,9104,9819,0,2,37172,,,,,,1,1,7.509562417,18891,8995,8704,291,1,290
17669,7951,9949,0,0,38928,,,,,,1,1,8.024679611,19806,9411,9111,300,1,299
17669,9258,11466,0,2,36245,,,,,,1,1,7.36610501,18432,8750,8437,313,6,307
17669,11631,10039,0,0,6552,,,,,,1,1,1.379302657,3019,1656,1435,221,0,221
17669,10636,10744,1,4,37080,,,,,,1,1,7.566904556,18626,9059,8723,336,16,320
17669,11090,10446,0,2,36683,,,,,,1,1,7.446114469,18816,8762,8419,343,4,339
17669,10496,11173,0,0,32322,,,,,,1,1,6.572071611,16426,7798,7498,300,3,297
17669,10258,10613,0,0,37603,,,,,,1,1,7.657272245,19061,9114,8800,314,1,313
17669,11064,10669,6,0,18558,,,,,,1,1,3.834349444,9702,4297,4035,262,11,251
17669,10826,9781,2,0,37718,,,,,,1,1,7.744013153,19091,9149,8820,329,2,327
17669,10034,10955,3,2,34616,,,,,,1,1,7.051544812,17956,8181,7883,298,8,290
17669,9869,10891,0,0,35512,,,,,,1,1,7.182623666,18299,8450,8137,313,5,308
17669,8807,10608,0,0,35572,,,,,,1,1,7.22668634,18542,8377,8101,276,4,272
17669,9716,11967,0,0,2597,,,,,,1,1,0.584086899,1167,641,493,148,0,148
17669,9387,11315,0,0,34609,,,,,,1,1,7.101603878,17775,8265,7961,304,2,302
17669,10788,10935,0,0,1381,,,,,,1,1,0.283948341,512,375,256,119,0,119
17669,10923,9583,0,0,36902,,,,,,1,1,7.564090267,18890,8861,8571,290,0,290
17669,10162,8765,2,0,35234,,,,,,1,1,7.234809733,18268,8353,8093,260,2,258
17669,11330,10503,0,0,3641,,,,,,1,1,0.753789862,1643,916,750,166,1,165
17669,10716,9284,0,0,35875,,,,,,1,1,7.565147008,18643,8468,8172,296,3,293
17669,10030,11147,0,2,39072,,,,,,1,1,8.209590846,19462,9621,9253,368,7,361
17669,10085,11023,2,2,34533,,,,,,1,1,7.067500356,18153,8033,7719,314,3,311
17669,8487,9844,0,3,38405,,,,,,1,1,7.807936718,19446,9340,9061,279,8,271
17669,10673,10996,0,0,4504,,,,,,1,1,0.919435827,2112,1095,893,202,1,201
17669,10826,9259,0,4,36737,,,,,,1,1,7.651591675,18641,8899,8601,298,3,295
17669,11429,8548,3,0,36923,,,,,,1,1,7.57941736,18930,8846,8545,301,2,299
17669,9850,11819,2,0,5168,,,,,,1,1,1.052970856,2327,1309,1086,223,4,219
17669,10141,9952,3,0,36056,,,,,,1,1,7.422986373,18467,8629,8298,331,2,329
17669,8873,9408,1,2,37389,,,,,,1,1,7.719519436,19284,8927,8676,251,1,250
17669,10571,10997,0,3,35497,,,,,,1,1,7.213191784,18391,8384,8046,338,12,326
17669,8891,12273,0,0,36145,,,,,,1,1,7.374213998,18447,8684,8354,330,2,328
17669,9854,11820,0,0,7185,,,,,,1,1,1.471173533,3374,1789,1556,233,0,233
17669,11073,10945,0,0,29861,,,,,,1,1,6.101404694,15419,7066,6756,310,2,308
17669,10298,9615,2,0,35596,,,,,,1,1,7.368222443,18351,8473,8174,299,2,297
17669,10078,9989,0,0,35150,,,,,,1,1,7.147801202,18451,8205,7916,289,1,288
17669,8957,10269,0,0,36432,,,,,,1,1,7.483440595,18870,8633,8337,296,2,294
17669,9706,10698,2,0,36615,,,,,,1,1,7.54963747,18695,8801,8483,318,9,309
17669,9137,10221,3,0,36359,,,,,,1,1,7.446144403,18672,8696,8401,295,4,291
17669,10807,9805,2,2,35177,,,,,,1,1,7.271982873,18234,8318,8011,307,6,301
17669,9507,10574,0,2,38626,,,,,,1,1,8.006506655,19559,9388,9097,291,7,284
17669,10164,10874,3,1,38362,,,,,,1,1,8.188228874,19477,9288,8979,309,13,296
17669,10361,10260,2,2,35308,,,,,,1,1,7.254379635,17997,8519,8246,273,11,262
17669,9961,11494,2,0,33608,,,,,,1,1,7.04272914,17306,7998,7692,306,1,305
17669,11103,10602,0,0,6075,,,,,,1,1,1.259437752,2824,1521,1312,209,1,208
17669,10423,10075,0,0,35552,,,,,,1,1,7.409746899,18040,8599,8285,314,0,314
17669,11101,10583,2,2,6096,,,,,,1,1,1.235949621,2882,1509,1313,196,7,189
17669,10542,10384,0,0,35704,,,,,,1,1,7.468377577,18486,8463,8171,292,1,291
17669,10422,10467,3,0,36987,,,,,,1,1,7.872842218,18810,8944,8655,289,1,288
17669,10682,11011,0,0,1883,,,,,,1,1,0.494535055,761,490,348,142,0,142
17669,10181,11488,0,0,20000,,,,,,1,1,4.330463964,10150,4776,4478,298,6,292
17669,10775,11258,0,0,3261,,,,,,1,1,0.703558732,1502,798,635,163,0,163
17669,10229,9893,2,0,35935,,,,,,1,1,7.847373027,18652,8482,8163,319,2,317
17669,11156,9635,0,2,35626,,,,,,1,1,7.520554408,18118,8601,8295,306,2,304
17669,10628,10177,0,0,34773,,,,,,1,1,7.448132068,18196,8133,7822,311,0,311
17669,9721,9170,2,0,36885,,,,,,1,1,8.328089381,19086,8756,8469,287,14,273
17669,10955,10942,0,0,5427,,,,,,1,1,1.387993428,2615,1306,1106,200,0,200
17669,9877,10511,0,0,36317,,,,,,1,1,7.9719082310000005,18866,8595,8334,261,1,260
17669,9177,10075,2,0,35382,,,,,,1,1,7.995722086,18372,8368,8094,274,5,269
17669,9504,10335,0,0,35975,,,,,,1,1,7.4657816839999995,18896,8387,8082,305,1,304
17669,9906,9229,0,4,36178,,,,,,1,1,7.972885827,18871,8515,8238,277,4,273
17669,9136,9123,2,1,38512,,,,,,1,1,8.14268936,19606,9306,9012,294,4,290
17669,10370,11299,2,0,14615,,,,,,1,1,3.318795923,7244,3550,3279,271,1,270
17669,10650,11026,0,0,7499,,,,,,1,1,1.69393623,3698,1786,1557,229,1,228
17669,11580,9778,0,2,36723,,,,,,1,1,8.181890618,18363,9002,8646,356,18,338
17669,11013,10656,0,0,5706,,,,,,1,1,1.257797607,2695,1407,1210,197,0,197
17669,11913,8473,0,0,35571,,,,,,1,1,7.389361408,18234,8511,8196,315,2,313
17669,10689,8501,2,0,35834,,,,,,1,1,7.417317986,18732,8415,8143,272,2,270
17669,10405,9700,0,0,35960,,,,,,1,1,8.017445612,18329,8674,8391,283,3,280
17669,10797,10597,0,4,36044,,,,,,1,1,8.116991469,18208,8743,8393,350,7,343
17669,10851,10943,2,2,19861,,,,,,1,1,4.205297874,10305,4622,4310,312,3,309
17669,10197,11472,0,0,5915,,,,,,1,1,1.326808387,2851,1432,1232,200,0,200
17669,10160,11510,4,0,27122,,,,,,1,1,5.531642928,13765,6534,6245,289,6,283
17669,8993,10510,0,3,38621,,,,,,1,1,7.947195648,19428,9450,9157,293,1,292
17669,7844,10127,0,2,37768,,,,,,1,1,8.175144576,19272,9103,8813,290,1,289
17669,10797,9107,2,0,36057,,,,,,1,1,7.494341328,18644,8562,8273,289,2,287
17669,10102,11578,0,0,5091,,,,,,1,1,1.040633126,2458,1229,1054,175,0,175
17669,11447,10225,0,0,7487,,,,,,1,1,1.517371069,3595,1825,1583,242,0,242
17669,9838,9070,2,2,35712,,,,,,1,1,7.4890400249999995,18671,8381,8102,279,12,267
17669,11604,8925,3,0,36458,,,,,,1,1,7.874909579,18368,8896,8598,298,0,298
17669,11305,10271,0,1,36369,,,,,,1,1,7.857227711,18900,8577,8262,315,0,315
17669,10013,10479,0,2,35677,,,,,,1,1,7.846456056,18428,8485,8206,279,4,275
17669,8651,9773,0,0,37441,,,,,,1,1,7.811429122,19368,8907,8648,259,0,259
17669,10919,10754,0,0,2913,,,,,,1,1,0.613869195,1285,728,556,172,0,172
17669,10617,10554,2,0,34739,,,,,,1,1,7.183879493,18206,8120,7827,293,5,288
17669,10726,10778,0,2,34912,,,,,,1,1,7.348844522,18172,8215,7905,310,3,307
17669,10521,10477,1,0,34977,,,,,,1,1,7.163054788,18441,8133,7863,270,1,269
17669,10943,10734,0,0,25318,,,,,,1,1,5.220601708,12963,6040,5765,275,4,271
17669,10549,9811,0,2,35264,,,,,,1,1,7.264635925,18490,8246,7964,282,4,278
17669,10598,9873,2,0,34432,,,,,,1,1,7.201320642,17965,8085,7788,297,2,295
17669,11215,10549,2,0,15767,,,,,,1,1,3.313720311,7939,3785,3527,258,0,258
17669,10653,9786,2,0,37776,,,,,,1,1,7.791979908,18982,9244,8938,306,5,301
17669,9697,11280,2,2,35266,,,,,,1,1,7.496554368,18312,8292,7922,370,4,366
17669,10017,10096,0,4,38493,,,,,,1,1,8.028389716,19690,9246,8935,311,0,311
17669,10173,9825,1,0,36693,,,,,,1,1,7.593636763,18656,8879,8600,279,3,276
17669,10199,11472,2,0,3249,,,,,,1,1,0.69251325,1451,814,644,170,1,169
17669,9319,10977,0,4,36515,,,,,,1,1,7.637564884,19012,8594,8279,315,3,312
17669,10746,10684,0,2,34566,,,,,,1,1,7.185798575,17913,8178,7881,297,2,295
17669,11252,10465,0,0,5404,,,,,,1,1,1.101770249,2544,1332,1136,196,0,196
17669,10371,11318,2,0,1278,,,,,,1,1,0.271942639,461,355,248,107,0,107
17669,10422,10382,2,0,35905,,,,,,1,1,7.421751649,18600,8506,8213,293,2,291
17669,11125,10237,2,2,38408,,,,,,1,1,7.869461278,19171,9458,9137,321,3,318
17669,9335,8955,0,0,36277,,,,,,1,1,7.473527567,18474,8775,8522,253,0,253
17669,9008,8830,0,0,38030,,,,,,1,1,7.804025484,19322,9201,8895,306,2,304
17669,9507,11301,3,2,35812,,,,,,1,1,7.270984694,18580,8477,8199,278,2,276
17669,11154,10521,0,0,7269,,,,,,1,1,1.4790418060000001,3520,1771,1564,207,0,207
17669,11511,9656,0,4,33693,,,,,,1,1,6.95259178,17688,7862,7581,281,4,277
17669,10548,10857,0,0,37893,,,,,,1,1,7.702921131,19319,9116,8774,342,1,341
17669,10738,10938,0,0,7148,,,,,,1,1,1.444803879,3424,1746,1514,232,1,231
17669,9887,10698,0,0,36471,,,,,,1,1,7.402438116,18519,8809,8475,334,5,329
17669,11840,9843,0,2,7031,,,,,,1,1,1.394891791,3311,1748,1524,224,8,216
17669,10406,10687,2,3,36003,,,,,,1,1,7.33878746,18361,8669,8365,304,5,299
17669,11895,9776,0,0,6729,,,,,,1,1,1.394750234,3196,1649,1414,235,0,235
17669,10236,10833,0,2,36020,,,,,,1,1,7.421631218,18715,8497,8186,311,6,305
17669,10819,10415,0,1,32956,,,,,,1,1,6.902625935,17616,7528,7244,284,3,281
17669,10436,10417,0,0,36662,,,,,,1,1,7.55204138,18516,8916,8602,314,1,313
17669,9543,9257,0,0,36593,,,,,,1,1,7.553869816,18765,8771,8485,286,2,284
17669,11095,10449,4,0,37007,,,,,,1,1,7.517608784,19061,8818,8508,310,3,307
17669,9878,9736,7,2,35441,,,,,,1,1,7.189322442,18512,8330,8061,269,4,265
17669,10613,10037,0,0,35635,,,,,,1,1,7.37848817,18417,8452,8138,314,1,313
17669,11022,9888,0,0,33320,,,,,,1,1,6.934507893,17897,7557,7248,309,2,307
17669,10175,11850,0,0,6838,,,,,,1,1,1.373867718,3204,1713,1505,208,0,208
17669,10008,10918,0,2,35545,,,,,,1,1,7.341024665,18636,8312,8027,285,1,284
17669,11498,9826,2,0,35912,,,,,,1,1,7.374003723,18311,8652,8355,297,3,294
17669,9989,11685,2,2,5010,,,,,,1,1,1.016772724,2274,1269,1071,198,0,198
17669,10463,10971,0,2,36267,,,,,,1,1,7.410337348,18546,8699,8376,323,7,316
17669,8881,10197,0,0,39472,,,,,,1,1,7.951353942,19972,9600,9300,300,0,300
17669,10656,11013,0,0,3048,,,,,,1,1,0.652245936,1337,771,602,169,1,168
17669,10063,10085,2,2,37424,,,,,,1,1,7.678471409,19169,8976,8673,303,6,297
17669,10708,9109,6,4,35083,,,,,,1,1,7.291913654,18000,8405,8132,273,6,267
17669,11192,9441,0,2,35715,,,,,,1,1,7.271308771,18416,8491,8174,317,2,315
17669,9548,10312,0,0,35468,,,,,,1,1,7.234129579,18558,8308,8014,294,3,291
17669,10981,9751,2,0,35714,,,,,,1,1,7.288754567,18538,8433,8123,310,5,305
17669,10280,11315,4,0,37124,,,,,,1,1,7.591822056,18959,8908,8559,349,8,341
17669,9803,8757,0,0,38830,,,,,,1,1,7.872940604,19362,9582,9278,304,1,303
17669,9781,10426,0,0,36384,,,,,,1,1,7.373788567,18594,8730,8400,330,0,330
17669,11197,10184,0,6,35415,,,,,,1,1,7.25555005,18083,8499,8165,334,5,329
17669,9823,10518,0,0,33638,,,,,,1,1,6.92621136,17883,7733,7444,289,1,288
17669,9466,9714,0,0,37727,,,,,,1,1,7.69031995,19164,9140,8857,283,0,283
17669,10726,10317,2,2,35163,,,,,,1,1,7.185592922,18176,8343,8042,301,6,295
17669,10374,10100,0,1,37110,,,,,,1,1,7.674142305,19009,8884,8551,333,2,331
17669,10803,9932,0,4,35740,,,,,,1,1,7.284660804,18769,8353,8088,265,2,263
17669,9619,9271,2,2,35492,,,,,,1,1,7.281517884,18565,8319,8030,289,16,273
17669,10082,9496,2,1,34729,,,,,,1,1,7.067509136,18222,8124,7865,259,12,247
17669,10328,9710,0,0,37737,,,,,,1,1,7.60288859,19095,9157,8829,328,5,323
17669,10361,8125,0,0,37597,,,,,,1,1,7.688496982,19179,9062,8768,294,2,292
17669,9380,9052,0,0,38885,,,,,,1,1,7.81122528,19572,9503,9196,307,1,306
17669,11094,10822,2,0,2562,,,,,,1,1,0.526496656,1124,647,503,144,2,142
17669,10166,10800,0,4,37549,,,,,,1,1,7.670343382,18987,9118,8792,326,16,310
17669,11075,9741,0,2,34759,,,,,,1,1,7.044885107,18238,8104,7791,313,4,309
17669,9334,9937,2,2,36995,,,,,,1,1,7.6393005370000004,18974,8881,8622,259,1,258
17669,10871,10801,0,2,2203,,,,,,1,1,0.454884292,923,566,418,148,0,148
17669,8555,10889,0,0,37437,,,,,,1,1,7.870320469,19068,9016,8679,337,10,327
17669,10970,10100,4,2,36409,,,,,,1,1,7.523661722,18420,8835,8516,319,3,316
17669,9667,9498,0,4,36452,,,,,,1,1,7.442578124,18988,8595,8321,274,0,274
17669,9471,10492,2,2,36967,,,,,,1,1,7.521885337,18815,8917,8599,318,1,317
17669,10281,10371,4,2,35785,,,,,,1,1,7.308734959,18650,8416,8113,303,5,298
17669,9852,10981,2,8,38186,,,,,,1,1,7.905701434,19349,9261,8946,315,8,307
17669,10607,11065,2,0,3077,,,,,,1,1,0.627346034,1348,782,617,165,3,162
17669,10535,9986,0,2,36864,,,,,,1,1,7.6185100949999995,19014,8779,8487,292,1,291
17669,11257,10415,2,2,5006,,,,,,1,1,1.039199086,2349,1229,1030,199,1,198
17669,12277,9380,0,0,35721,,,,,,1,1,7.254785305,18646,8373,8044,329,3,326
17669,10664,11151,0,0,10085,,,,,,1,1,2.026801786,4868,2490,2253,237,0,237
17669,10290,8099,0,0,36627,,,,,,1,1,7.695885733,18740,8809,8540,269,0,269
17669,10440,11240,6,0,20529,,,,,,1,1,4.260461114,10309,4954,4642,312,3,309
17669,9433,10467,0,0,35650,,,,,,1,1,7.293029945,18308,8524,8230,294,2,292
17669,10187,11746,0,0,32475,,,,,,1,1,6.632686262,16513,7819,7495,324,3,321
17669,10834,10843,0,2,6604,,,,,,1,1,1.336842074,3179,1606,1393,213,1,212
17669,9148,11160,0,0,36089,,,,,,1,1,7.339364104,18683,8540,8214,326,1,325
17669,10878,10426,2,2,34314,,,,,,1,1,7.008740132,17758,8119,7801,318,20,298
17669,9758,10627,0,2,35348,,,,,,1,1,7.166071318,18382,8338,8048,290,3,287
17669,10496,10439,1,1,35703,,,,,,1,1,7.305587216,18636,8386,8091,295,4,291
17669,9660,10907,0,0,35763,,,,,,1,1,7.271560488,18450,8499,8184,315,0,315
17669,10152,10133,0,2,36073,,,,,,1,1,7.34449093,18674,8552,8257,295,3,292
17669,10680,10195,0,0,35091,,,,,,1,1,7.177403428,18438,8182,7893,289,0,289
17669,11026,10104,2,3,34565,,,,,,1,1,7.158717023,18093,8093,7807,286,3,283
17669,11001,10670,2,0,6793,,,,,,1,1,1.388432405,3304,1647,1452,195,0,195
17669,9622,11246,2,3,34729,,,,,,1,1,7.211439007,18119,8153,7849,304,4,300
17669,10848,10514,0,0,36701,,,,,,1,1,7.440154396,19000,8690,8369,321,2,319
17669,11128,9233,1,0,35558,,,,,,1,1,7.27977231,18559,8351,8054,297,6,291
17669,10796,9748,0,2,37250,,,,,,1,1,7.494606539,18762,9077,8743,334,2,332
17669,10169,10384,0,1,36294,,,,,,1,1,7.435004833,18746,8611,8285,326,0,326
17669,11230,10017,0,0,35843,,,,,,1,1,7.243550407,18573,8471,8143,328,4,324
17669,9228,10249,0,1,36019,,,,,,1,1,7.338151987,18732,8509,8240,269,0,269
17669,10788,9304,4,2,36037,,,,,,1,1,7.267865309,18605,8566,8266,300,8,292
17669,9983,11687,0,0,2606,,,,,,1,1,0.537895446,1188,630,472,158,0,158
17669,9562,10626,0,3,35756,,,,,,1,1,7.220888204,18470,8500,8214,286,2,284
17669,9830,10828,2,0,33869,,,,,,1,1,7.005828733,18238,7671,7382,289,4,285
17669,10204,10221,0,0,35322,,,,,,1,1,7.348407533,18365,8327,8024,303,4,299
17669,12319,9352,2,0,4773,,,,,,1,1,0.964351555,2138,1222,1031,191,0,191
17669,10297,10871,0,3,35365,,,,,,1,1,7.325823095,18424,8315,8004,311,1,310
17669,9860,11233,0,2,35533,,,,,,1,1,7.252959847,18407,8407,8095,312,3,309
17669,10416,10307,3,0,35855,,,,,,1,1,7.35980527,18066,8745,8446,299,4,295
17669,10334,11309,0,2,35336,,,,,,1,1,7.411655378,18304,8356,8036,320,5,315
17669,9379,9695,2,2,36786,,,,,,1,1,7.554610885,19012,8747,8467,280,5,275
17669,8287,11605,0,2,36784,,,,,,1,1,7.534154557,18768,8854,8546,308,5,303
17669,9510,11635,0,2,36409,,,,,,1,1,7.466472575,18889,8611,8313,298,3,295
17669,9609,11629,2,0,32629,,,,,,1,1,6.692108066,17518,7416,7137,279,2,277
17669,10973,10955,4,0,8121,,,,,,1,1,1.68184154,3917,1987,1757,230,6,224
17669,9328,10015,0,1,36282,,,,,,1,1,7.3473749,18795,8596,8301,295,5,290
17669,11032,10880,0,2,27444,,,,,,1,1,5.687683074,14118,6512,6210,302,3,299
17669,11186,10163,0,0,37919,,,,,,1,1,7.656863641,19407,9086,8746,340,2,338
17669,11003,8909,2,0,37262,,,,,,1,1,7.703372894,18990,8984,8680,304,2,302
17669,11404,10347,2,0,5084,,,,,,1,1,1.0419474420000001,2322,1270,1048,222,2,220
17669,9690,10568,4,0,35408,,,,,,1,1,7.319495085,18366,8381,8101,280,1,279
17669,10182,9946,2,2,35823,,,,,,1,1,7.399662425,18417,8562,8280,282,8,274
17669,10999,9018,3,0,36276,,,,,,1,1,7.506018179,19088,8448,8156,292,2,290
17669,10937,9791,0,0,35374,,,,,,1,1,7.3408440200000005,18463,8307,8010,297,0,297
17669,9998,9898,0,0,35979,,,,,,1,1,7.476958934,18724,8483,8194,289,4,285
17669,10413,10261,2,0,36106,,,,,,1,1,7.458136867,18561,8631,8348,283,1,282
17669,11770,10104,3,0,22511,,,,,,1,1,4.576704022,10977,5614,5308,306,2,304
17669,10820,10855,0,0,2980,,,,,,1,1,0.626011068,1316,748,580,168,1,167
17669,10090,10447,0,0,37729,,,,,,1,1,7.807134421,18918,9234,8891,343,4,339
17669,11747,9324,2,0,35251,,,,,,1,1,7.421635345,18297,8316,7994,322,2,320
17669,9973,9138,4,0,35541,,,,,,1,1,7.286357446,18348,8467,8208,259,2,257
17669,10701,10785,0,2,34898,,,,,,1,1,7.236815089,18382,8109,7811,298,1,297
17669,10196,10619,0,2,34147,,,,,,1,1,7.160306317,17988,7931,7634,297,3,294
17669,10913,10543,6,2,37240,,,,,,1,1,7.964393512,19007,8957,8638,319,1,318
17669,10299,11444,2,0,13456,,,,,,1,1,2.997762152,6809,3182,2899,283,0,283
17669,9333,11033,0,2,37200,,,,,,1,1,7.961299148,18962,8962,8648,314,5,309
17669,9211,10362,2,0,37486,,,,,,1,1,8.053538758,18945,9117,8810,307,2,305
17669,10556,10273,2,0,36577,,,,,,1,1,8.248899501,18642,8810,8495,315,1,314
17669,8962,10956,0,0,38131,,,,,,1,1,8.140358757,18913,9451,9135,316,1,315
17669,9989,10379,0,0,35991,,,,,,1,1,7.884906438,18647,8511,8189,322,2,320
17669,11722,9955,0,0,5016,,,,,,1,1,1.152466862,2246,1283,1079,204,0,204
17669,10167,11585,0,0,3932,,,,,,1,1,0.846569007,1785,976,781,195,0,195
17669,10927,9017,1,0,36252,,,,,,1,1,7.676575419,18526,8708,8398,310,2,308
17669,10382,10026,0,0,37226,,,,,,1,1,7.931699291,18866,9017,8691,326,2,324
17669,10107,10496,2,0,34579,,,,,,1,1,7.257917367,18054,8118,7829,289,8,281
17669,9943,11656,0,1,36204,,,,,,1,1,7.507602543,18432,8724,8400,324,1,323
17669,9913,11662,0,1,37643,,,,,,1,1,7.824582521,18880,9221,8900,321,2,319
17669,11337,8526,2,1,37455,,,,,,1,1,7.845877431,18936,9110,8811,299,2,297
17669,10838,9737,0,2,35758,,,,,,1,1,7.587218279,18532,8454,8136,318,4,314
17669,10951,9302,1,0,35830,,,,,,1,1,7.912638331,18221,8652,8347,305,2,303
17669,9572,9736,0,0,38882,,,,,,1,1,8.215208766,19413,9572,9247,325,4,321
17669,10736,9657,2,2,35802,,,,,,1,1,7.5837236820000005,18600,8456,8166,290,4,286
17669,10358,10907,0,3,34641,,,,,,1,1,7.646493572,18190,8067,7750,317,1,316
17669,9102,10464,0,2,37852,,,,,,1,1,8.517686839,19065,9246,8951,295,2,293
17669,10098,9364,0,2,36583,,,,,,1,1,7.843094361,19006,8645,8358,287,2,285
17669,10708,10961,2,0,10696,,,,,,1,1,2.58122547,5398,2536,2310,226,0,226
17669,9411,11974,0,0,35056,,,,,,1,1,7.632836742,18296,8220,7900,320,3,317
17669,9173,8282,0,0,36631,,,,,,1,1,7.908860477,19004,8692,8449,243,0,243
17669,10459,9714,0,0,35286,,,,,,1,1,7.437273323,18142,8421,8119,302,1,301
17669,11028,10821,0,0,5276,,,,,,1,1,1.06824999,2477,1297,1092,205,0,205
17669,9743,11494,2,0,35956,,,,,,1,1,7.862669975,18488,8570,8242,328,2,326
17669,11487,10189,0,0,6551,,,,,,1,1,1.664462013,3205,1572,1370,202,0,202
17669,10123,11546,0,0,18094,,,,,,1,1,3.75989807,8805,4486,4169,317,0,317
17669,10605,11064,0,2,24103,,,,,,1,1,5.216084459,12356,5721,5416,305,0,305
17669,10326,8851,2,0,37869,,,,,,1,1,7.946628021,19401,9067,8733,334,3,331
17669,11770,9486,4,0,34377,,,,,,1,1,7.207568024,18115,7976,7666,310,3,307
17669,10448,9439,0,0,35505,,,,,,1,1,7.679177943,18427,8403,8131,272,0,272
17669,10268,11401,0,2,6364,,,,,,1,1,1.435074758,3062,1544,1330,214,2,212
17669,11002,10369,2,0,34569,,,,,,1,1,7.206303612,18037,8114,7810,304,3,301
17669,10940,10750,0,2,3845,,,,,,1,1,0.780311633,1726,970,791,179,0,179
17669,10683,9508,0,2,35721,,,,,,1,1,7.419817997,18687,8369,8073,296,0,296
17669,10754,10608,4,0,33479,,,,,,1,1,7.069905608,17091,8051,7765,286,2,284
17669,11208,10464,0,0,10403,,,,,,1,1,2.265504477,5047,2549,2291,258,2,256
17669,10214,9978,0,0,37209,,,,,,1,1,8.091214708,19245,8834,8538,296,2,294
17669,11084,10895,1,3,30970,,,,,,1,1,6.746931334,15649,7503,7188,315,1,314
17669,10306,9920,0,0,35525,,,,,,1,1,7.7278773229999995,18580,8317,8006,311,6,305
17669,10826,10280,0,3,36072,,,,,,1,1,7.785717403,18545,8617,8324,293,2,291
17669,10092,9487,3,0,36298,,,,,,1,1,8.156572752,18805,8605,8322,283,1,282
17669,10788,9178,0,3,36192,,,,,,1,1,7.98039936,18591,8643,8328,315,6,309
17669,10224,11254,3,0,35729,,,,,,1,1,7.773322216,18352,8529,8210,319,12,307
17669,11559,10266,0,0,13586,,,,,,1,1,2.989559988,6721,3304,3047,257,0,257
17669,9377,11126,0,0,36476,,,,,,1,1,8.180709634,18628,8768,8456,312,2,310
17669,11172,9025,0,0,35487,,,,,,1,1,7.211912386,18591,8309,8031,278,4,274
17669,9312,9402,0,4,36630,,,,,,1,1,7.754450987,19362,8496,8220,276,2,274
17669,10200,10546,0,0,37634,,,,,,1,1,7.907376025,19281,9021,8710,311,1,310
17669,9845,11129,0,2,35817,,,,,,1,1,8.171136675,18469,8524,8224,300,4,296
17669,10737,10401,0,0,37430,,,,,,1,1,7.901346503,18723,9193,8872,321,0,321
17669,10338,10408,1,1,36269,,,,,,1,1,7.460417885,18487,8728,8402,326,3,323
17669,9737,9330,0,0,37919,,,,,,1,1,8.224502251,19277,9166,8856,310,1,309
17669,10127,10818,0,4,36360,,,,,,1,1,7.748262056,19018,8522,8224,298,2,296
17669,9840,8900,0,2,36923,,,,,,1,1,7.983517549,19097,8770,8484,286,2,284
17669,9888,11664,0,4,36121,,,,,,1,1,7.566117685,18537,8623,8285,338,22,316
17669,10629,10716,7,0,36013,,,,,,1,1,7.61151202,18517,8583,8253,330,6,324
17669,11909,9861,0,0,8214,,,,,,1,1,1.8044254629999998,3964,2002,1756,246,1,245
17669,10249,10018,0,4,36490,,,,,,1,1,7.416388565,18574,8816,8532,284,2,282
17669,8137,10095,2,0,36520,,,,,,1,1,8.040020218,19153,8550,8283,267,6,261
17669,11941,9733,0,0,8426,,,,,,1,1,1.693221913,4078,2058,1826,232,0,232
17669,8085,10256,0,0,36599,,,,,,1,1,7.941617408,18876,8725,8452,273,0,273
17669,9866,11843,0,4,21476,,,,,,1,1,4.478428512,10828,5170,4862,308,2,306
17669,9207,10964,0,2,35289,,,,,,1,1,8.430633582,18291,8350,8052,298,3,295
17669,11476,9800,0,4,37726,,,,,,1,1,8.436968976,19128,9110,8732,378,7,371
17669,10663,10483,2,0,37941,,,,,,1,1,7.923157055,19305,9150,8814,336,4,332
17669,9775,10021,0,0,34534,,,,,,1,1,7.538802972,18073,8087,7800,287,5,282
17669,11454,10216,3,0,3768,,,,,,1,1,0.775760165,1813,886,703,183,0,183
17669,11507,10173,0,0,11363,,,,,,1,1,2.429190266,5611,2747,2489,258,0,258
17669,10708,10761,2,2,34711,,,,,,1,1,7.091498309,17918,8245,7942,303,2,301
17669,9924,11877,2,2,31398,,,,,,1,1,6.696494901,15707,7690,7379,311,0,311
17669,11469,10215,0,0,2801,,,,,,1,1,0.572571075,1254,691,526,165,0,165
17669,11008,10070,0,2,38950,,,,,,1,1,8.30736234,19326,9624,9248,376,4,372
17669,10355,10827,2,4,35434,,,,,,1,1,7.678824198,18413,8347,8020,327,2,325
17669,10333,10046,2,0,34831,,,,,,1,1,7.481480554,18249,8141,7841,300,8,292
17669,10446,11174,0,0,35463,,,,,,1,1,7.370771701,18263,8431,8093,338,1,337
17669,10515,11188,0,0,6077,,,,,,1,1,1.259889391,2836,1498,1253,245,0,245
17669,9126,12103,0,5,35288,,,,,,1,1,7.582404422,18506,8222,7884,338,9,329
17669,9771,8009,0,0,38535,,,,,,1,1,8.275168474,19640,9304,9017,287,3,284
17669,10365,10221,0,2,36385,,,,,,1,1,8.099980462,18556,8769,8478,291,10,281
17669,9329,10272,2,0,36902,,,,,,1,1,7.84779521,19176,8722,8440,282,1,281
17669,12239,9648,4,0,32658,,,,,,1,1,6.786760296,16365,7984,7659,325,3,322
17669,10507,8899,0,2,37595,,,,,,1,1,7.812852428,19288,9001,8696,305,4,301
17669,10863,10920,1,0,9875,,,,,,1,1,2.035061751,4730,2454,2217,237,1,236
17669,10962,10716,0,2,6353,,,,,,1,1,1.3311986789999999,2988,1572,1351,221,3,218
17669,10542,9894,0,0,35116,,,,,,1,1,7.336404937,18581,8111,7798,313,3,310
17669,10154,10162,0,0,35052,,,,,,1,1,7.320101032,18075,8340,8043,297,1,296
17669,10475,11145,0,2,35892,,,,,,1,1,7.456705854,18596,8482,8150,332,3,329
17669,10030,11768,0,0,3861,,,,,,1,1,0.891344555,1745,968,788,180,0,180
17669,11195,9372,0,2,34503,,,,,,1,1,7.040591485,18089,8061,7769,292,10,282
17669,10970,10154,2,2,35756,,,,,,1,1,7.557776907,18233,8590,8247,343,13,330
17669,10780,8820,2,0,36351,,,,,,1,1,7.954263368,18997,8528,8230,298,1,297
17669,9734,10847,2,2,36311,,,,,,1,1,7.672327677,18670,8669,8366,303,4,299
17669,10826,10883,0,2,3759,,,,,,1,1,0.780284905,1632,973,792,181,0,181
17669,10733,10585,0,2,36435,,,,,,1,1,7.598074061,18658,8720,8383,337,6,331
17669,9576,10267,2,0,36045,,,,,,1,1,7.470085577,18836,8453,8150,303,9,294
17669,9587,8730,0,0,37265,,,,,,1,1,8.041347358,19015,8989,8717,272,3,269
17669,9642,9345,0,0,36617,,,,,,1,1,7.655411974,19026,8670,8419,251,3,248
17669,10348,11332,0,0,5385,,,,,,1,1,1.092969042,2547,1327,1143,184,0,184
17669,9294,9708,0,3,37229,,,,,,1,1,7.610511753,19223,8855,8559,296,5,291
17669,10570,9536,2,2,37860,,,,,,1,1,7.680968752,19139,9211,8912,299,2,297
17669,9851,10557,2,0,35300,,,,,,1,1,7.581626842,18354,8334,8056,278,0,278
17669,10716,10125,2,0,36217,,,,,,1,1,7.447476571,18850,8547,8274,273,2,271
17669,10016,10626,5,2,35623,,,,,,1,1,7.4667358010000004,18680,8334,8059,275,9,266
17669,8674,11416,0,2,37585,,,,,,1,1,7.714907881,19043,9127,8839,288,4,284
17669,9940,9956,0,0,36800,,,,,,1,1,7.578470994,18698,8904,8610,294,2,292
17669,10183,10549,2,0,36511,,,,,,1,1,7.902121396,18886,8660,8355,305,4,301
17669,11172,10500,2,2,5328,,,,,,1,1,1.081191663,2527,1298,1093,205,1,204
17669,9218,10993,2,4,34685,,,,,,1,1,7.186345671,18349,8014,7706,308,5,303
17669,11091,10580,0,0,9860,,,,,,1,1,2.028209837,5074,2271,2027,244,0,244
17669,10113,11558,0,2,12796,,,,,,1,1,2.751918588,6363,3098,2861,237,1,236
17669,9489,11382,0,0,34124,,,,,,1,1,7.546695378,17940,7937,7627,310,2,308
17669,10561,10036,0,0,35876,,,,,,1,1,7.37759437,18305,8626,8307,319,2,317
17669,10809,10973,5,0,12180,,,,,,1,1,2.588559019,6052,2943,2701,242,1,241
17669,12460,9260,3,0,5374,,,,,,1,1,1.0854863240000001,2515,1332,1137,195,0,195
17669,10464,9024,2,0,35594,,,,,,1,1,7.628646772,18776,8265,7977,288,1,287
17669,11246,10427,1,0,9353,,,,,,1,1,1.901701805,4459,2330,2096,234,0,234
17669,10259,10149,3,2,34973,,,,,,1,1,7.183240713,18241,8235,7973,262,2,260
17669,9712,7907,0,0,38659,,,,,,1,1,7.836251336,19756,9321,9060,261,0,261
17669,9843,9819,7,0,35725,,,,,,1,1,7.847204863,18195,8624,8342,282,7,275
17669,10338,11333,0,0,3683,,,,,,1,1,0.746167601,1679,917,747,170,0,170
17669,10104,11572,0,0,1544,,,,,,1,1,0.317911066,631,388,251,137,0,137
17669,9045,11048,0,0,36277,,,,,,1,1,7.742313126,18816,8583,8288,295,4,291
17669,10366,10640,0,0,36083,,,,,,1,1,7.70655981,18806,8476,8151,325,4,321
17669,10039,10231,4,0,36573,,,,,,1,1,7.779466462,18898,8697,8416,281,0,281
17669,11481,10189,0,2,12191,,,,,,1,1,2.474398552,5896,3015,2750,265,7,258
17669,10102,10412,0,0,36761,,,,,,1,1,7.771225415,19076,8687,8376,311,1,310
17669,10678,10921,5,2,35824,,,,,,1,1,7.38709715,18292,8603,8277,326,3,323
17669,10280,9746,0,2,36690,,,,,,1,1,7.82272195,18743,8814,8495,319,2,317
17669,10869,9571,0,0,35336,,,,,,1,1,7.781393398,18370,8324,8006,318,2,316
17669,8175,11577,2,5,36467,,,,,,1,1,7.515726651,18774,8701,8410,291,5,286
17669,9393,7828,0,0,38355,,,,,,1,1,7.890307576,19363,9358,9082,276,3,273
17669,10023,10985,0,0,36652,,,,,,1,1,7.374314653,18215,9062,8749,313,0,313
17669,11051,10122,0,0,36198,,,,,,1,1,7.549391088,18397,8731,8392,339,5,334
17669,10269,11731,1,0,8010,,,,,,1,1,1.650635874,3834,1958,1698,260,0,260
17669,11321,10514,0,0,2023,,,,,,1,1,0.415654875,847,520,384,136,0,136
17669,9071,10515,2,0,35670,,,,,,1,1,7.269385294,18425,8476,8183,293,7,286
17669,10357,10320,5,0,37891,,,,,,1,1,7.688074152,18958,9313,9006,307,5,302
17669,11486,9853,0,0,34645,,,,,,1,1,7.396943414,18013,8160,7848,312,1,311
17669,10166,11508,0,0,17704,,,,,,1,1,3.625526485,9081,4183,3926,257,3,254
17669,11332,10244,0,0,34071,,,,,,1,1,7.116343641,18118,7818,7501,317,6,311
17669,10766,10629,1,4,37001,,,,,,1,1,7.649682856,18866,8906,8583,323,5,318
17669,10347,8033,0,0,38146,,,,,,1,1,7.685883997,19554,9157,8879,278,5,273
17669,10339,11330,0,0,10678,,,,,,1,1,2.19236303,5222,2603,2353,250,0,250
17669,10828,10044,2,0,36523,,,,,,1,1,7.403666708,18655,8770,8442,328,3,325
17669,8455,9585,2,0,36615,,,,,,1,1,7.486933621,18656,8849,8588,261,2,259
17669,7595,9782,0,1,39053,,,,,,1,1,8.090209452,19842,9475,9214,261,2,259
17669,10332,10332,4,4,37347,,,,,,1,1,7.621951873,19172,8943,8654,289,1,288
17669,10444,11225,2,2,8177,,,,,,1,1,1.763441603,4173,1897,1687,210,7,203
17669,11056,10325,5,0,33721,,,,,,1,1,6.865133196,18079,7669,7365,304,3,301
17669,10720,10966,0,0,2695,,,,,,1,1,0.594171801,1173,682,524,158,0,158
17669,10013,10124,0,2,37060,,,,,,1,1,7.7639222839999995,18913,8904,8565,339,2,337
17669,11153,10852,0,0,5852,,,,,,1,1,1.194204711,2886,1383,1183,200,0,200
17669,8779,9262,0,3,38930,,,,,,1,1,7.872893001,19581,9544,9283,261,1,260
17669,10104,11567,0,2,5174,,,,,,1,1,1.051614694,2471,1255,1062,193,2,191
17669,9352,10099,2,0,36232,,,,,,1,1,7.340140871,18766,8596,8322,274,5,269
17669,9916,11765,2,0,28696,,,,,,1,1,6.598912298,14993,6690,6367,323,1,322
17669,8578,9491,0,2,38400,,,,,,1,1,7.960193698,19283,9415,9128,287,4,283
17669,10382,10766,2,2,35682,,,,,,1,1,7.6625473589999995,18190,8588,8272,316,3,313
17669,9853,11481,0,0,35115,,,,,,1,1,7.12103968,18346,8225,7906,319,3,316
17669,10242,10528,0,0,36510,,,,,,1,1,7.749164264,18805,8699,8392,307,0,307
17669,11145,10607,2,2,17745,,,,,,1,1,3.7901246520000003,8897,4267,3953,314,7,307
17669,10786,10884,0,0,31551,,,,,,1,1,6.860286125,16085,7558,7208,350,2,348
17669,11667,10005,0,0,3374,,,,,,1,1,0.733026108,1485,850,661,189,1,188
17669,10606,11434,0,4,10221,,,,,,1,1,2.11901933,5066,2454,2207,247,4,243
17669,9560,9700,0,2,37102,,,,,,1,1,7.531200332,18982,8902,8586,316,6,310
17669,10024,8202,2,0,37937,,,,,,1,1,8.157361086,19354,9152,8873,279,5,274
17669,10066,9591,4,0,36633,,,,,,1,1,7.598599284,18810,8769,8484,285,1,284
17669,10374,9215,2,0,38194,,,,,,1,1,7.704015978,19550,9160,8836,324,2,322
17669,9938,10639,0,0,35604,,,,,,1,1,7.301957707,18511,8401,8110,291,3,288
17669,10687,9102,0,0,36382,,,,,,1,1,7.860963331,18543,8774,8483,291,3,288
17669,10951,10414,0,1,35747,,,,,,1,1,7.5396643260000005,18577,8427,8111,316,2,314
17669,10967,8778,0,0,36825,,,,,,1,1,7.673398402,18986,8771,8474,297,1,296
17669,11475,10050,0,0,37248,,,,,,1,1,8.16575618,18980,8961,8615,346,1,345
17669,9774,11116,0,3,36460,,,,,,1,1,7.545653956,18640,8751,8433,318,5,313
17669,9727,12068,0,2,2039,,,,,,1,1,0.427195398,831,534,394,140,0,140
17669,11471,10134,5,0,36780,,,,,,1,1,7.476168118,18444,9011,8697,314,7,307
17669,10926,9892,0,0,34818,,,,,,1,1,7.069471014,18153,8170,7845,325,2,323
17669,11099,8953,2,0,36314,,,,,,1,1,7.625525846,18864,8578,8284,294,1,293
17669,10134,10446,0,0,36232,,,,,,1,1,7.732018007,18693,8620,8321,299,0,299
17669,11375,10497,0,4,11148,,,,,,1,1,2.303909582,5386,2763,2527,236,0,236
17669,9501,11105,1,2,38548,,,,,,1,1,7.915129972,19499,9353,9010,343,1,342
17669,10534,9451,6,0,36436,,,,,,1,1,7.560735713,19035,8568,8303,265,1,264
17669,10234,9841,2,0,37582,,,,,,1,1,7.733148367,19212,9021,8693,328,5,323
17669,10476,10432,0,0,37558,,,,,,1,1,8.128580729,19051,9094,8775,319,4,315
17669,11130,10539,0,0,12574,,,,,,1,1,2.6721337910000003,6323,2995,2734,261,0,261
17669,11551,10146,0,2,3476,,,,,,1,1,0.701312844,1602,851,679,172,0,172
17669,9739,10838,0,0,37107,,,,,,1,1,7.826721815,18669,9052,8718,334,3,331
17669,10285,10316,4,0,35669,,,,,,1,1,7.369296967,18636,8375,8092,283,5,278
17669,10567,9137,5,0,37860,,,,,,1,1,7.749428955,19250,9150,8840,310,18,292
17669,11629,9182,2,0,35938,,,,,,1,1,7.607316994,18572,8526,8212,314,7,307
17669,9324,11229,4,0,33516,,,,,,1,1,7.122944715,17721,7767,7506,261,5,256
17669,10554,9409,2,2,38444,,,,,,1,1,8.275527653,19355,9376,9039,337,12,325
17669,9047,10326,0,0,35826,,,,,,1,1,7.530937315,18396,8571,8283,288,0,288
17669,10442,10597,2,0,34626,,,,,,1,1,7.389313793,18066,8121,7803,318,3,315
17669,10699,10976,0,0,5086,,,,,,1,1,1.0365736779999999,2417,1240,1051,189,0,189
17669,9976,10953,0,2,36296,,,,,,1,1,7.541409461,18716,8633,8319,314,13,301
17669,11716,9612,0,2,37314,,,,,,1,1,7.995605417,18359,9299,8942,357,3,354
17669,9404,11104,0,0,35790,,,,,,1,1,7.515017906,18576,8445,8121,324,1,323
17669,10544,8425,0,0,35826,,,,,,1,1,7.219384498,18326,8622,8366,256,8,248
17669,8687,10486,0,2,37944,,,,,,1,1,7.906724259,18998,9331,9047,284,4,280
17669,10210,9359,3,2,36964,,,,,,1,1,7.472963337,18783,8948,8663,285,3,282
17669,9717,9993,0,2,35331,,,,,,1,1,7.440129979,18373,8340,8062,278,2,276
17669,10311,11358,0,0,23485,,,,,,1,1,4.962277133,11878,5656,5361,295,1,294
17669,10808,9864,0,3,37028,,,,,,1,1,7.599693873,19338,8676,8338,338,2,336
17669,10703,9337,0,2,37113,,,,,,1,1,7.605187001,18907,8950,8644,306,7,299
17669,9694,10179,0,0,37716,,,,,,1,1,7.979407261,19294,9075,8803,272,2,270
17669,11206,10466,2,2,24516,,,,,,1,1,5.120931713,12906,5663,5379,284,4,280
17669,9120,9852,0,2,35592,,,,,,1,1,7.336665879,18666,8330,8064,266,1,265
17669,9510,10899,0,0,37147,,,,,,1,1,7.509026312,18874,8985,8682,303,2,301
17669,9501,10378,1,0,39751,,,,,,1,1,8.040574533,19741,9835,9495,340,1,339
17669,9953,10013,0,5,37960,,,,,,1,1,7.928826033,19482,9092,8798,294,5,289
17669,10488,10576,4,0,36344,,,,,,1,1,7.7330837,18508,8746,8402,344,9,335
17669,8569,10498,0,1,38453,,,,,,1,1,8.004547764,19514,9315,9006,309,8,301
17669,9991,11099,2,0,36910,,,,,,1,1,7.927689101,18629,8970,8629,341,2,339
17669,10943,10728,2,2,28510,,,,,,1,1,6.068491374,14322,6928,6596,332,5,327
17669,11127,10920,2,5,28797,,,,,,1,1,6.112383931,14385,7045,6723,322,7,315
17669,10938,10694,0,2,34185,,,,,,1,1,7.44238321,17823,8038,7752,286,5,281
17669,11035,9978,0,0,34585,,,,,,1,1,7.611424401,17916,8186,7889,297,0,297
17669,9628,9453,0,2,36941,,,,,,1,1,7.739862905,19069,8799,8525,274,2,272
17669,10459,9882,0,3,36252,,,,,,1,1,7.761477255,18721,8608,8293,315,5,310
17669,8738,10186,0,1,37968,,,,,,1,1,8.057382855,19390,9154,8884,270,3,267
17669,10306,10725,4,0,35673,,,,,,1,1,7.567392686,18495,8420,8082,338,8,330
17669,9900,10264,2,0,35850,,,,,,1,1,7.839849141,18335,8613,8324,289,0,289
17669,11217,10566,0,0,7328,,,,,,1,1,1.626157537,3598,1749,1517,232,0,232
17669,11050,9175,1,0,35004,,,,,,1,1,7.419552761,18327,8198,7917,281,3,278
17669,10927,10069,0,0,36179,,,,,,1,1,7.755280089,18590,8656,8379,277,2,275
17669,10199,11667,0,2,4900,,,,,,1,1,1.13685967,2300,1206,1018,188,4,184
17669,9748,9048,0,4,35795,,,,,,1,1,8.063340984,18928,8297,8024,273,10,263
17669,10085,11308,3,4,33864,,,,,,1,1,7.559001438,17571,7994,7689,305,8,297
17669,11125,8668,2,2,36258,,,,,,1,1,7.893133331,18860,8554,8264,290,2,288
17669,10137,11235,0,3,37485,,,,,,1,1,8.585408172,19093,9029,8695,334,2,332
17669,9274,10514,0,2,36106,,,,,,1,1,7.576053645,18530,8649,8371,278,2,276
17669,9687,11220,0,0,38899,,,,,,1,1,8.239803798,19443,9535,9149,386,0,386
17669,10394,10337,0,0,37789,,,,,,1,1,7.912607126,19184,9142,8821,321,2,319
17669,10081,11605,2,0,2332,,,,,,1,1,0.487501419,969,603,446,157,1,156
17669,10382,9607,2,0,35833,,,,,,1,1,8.228793161,18701,8408,8092,316,2,314
17669,10622,9636,2,2,37671,,,,,,1,1,8.273762963,19363,9008,8716,292,8,284
17669,10223,8637,0,0,38036,,,,,,1,1,8.448190491,19448,9160,8892,268,1,267
17669,9745,11230,2,2,36993,,,,,,1,1,7.852596933,18724,8975,8656,319,8,311
17669,9947,9229,0,0,38496,,,,,,1,1,8.355356849,19207,9496,9199,297,2,295
17669,9570,11076,2,0,34750,,,,,,1,1,7.243559574,18197,8128,7831,297,0,297
17669,9946,9676,2,2,37632,,,,,,1,1,7.909480556,19252,9036,8728,308,9,299
17669,10686,9868,0,0,36747,,,,,,1,1,7.683859087,18952,8751,8458,293,3,290
17669,8555,9775,0,0,36618,,,,,,1,1,7.791825437,18859,8746,8479,267,1,266
17669,10201,11468,2,4,32988,,,,,,1,1,7.215787725,16906,7875,7543,332,3,329
17669,11249,10454,0,2,20425,,,,,,1,1,4.211882875,10599,4779,4511,268,0,268
17669,9658,10186,2,3,37582,,,,,,1,1,8.045837729,18994,9148,8856,292,1,291
17669,10792,9939,0,2,35684,,,,,,1,1,7.410534114,18907,8241,7946,295,0,295
17669,10763,11257,6,0,10298,,,,,,1,1,2.204497636,5111,2475,2238,237,5,232
17669,10791,10197,0,0,37496,,,,,,1,1,8.122223258,18961,9106,8783,323,1,322
17669,9960,10091,4,2,36690,,,,,,1,1,7.898628695,18722,8834,8534,300,3,297
17669,10152,9606,2,1,37019,,,,,,1,1,7.555085657,18871,8912,8588,324,2,322
17669,10994,10330,0,0,33606,,,,,,1,1,7.384221573,17534,7884,7580,304,2,302
17669,10517,11152,2,0,2531,,,,,,1,1,0.541554291,1033,660,482,178,1,177
17669,10751,10728,4,0,35748,,,,,,1,1,7.897611059,18225,8602,8283,319,8,311
17669,9280,10307,0,4,38435,,,,,,1,1,8.149153992,19244,9443,9138,305,3,302
17669,9813,9728,2,0,34159,,,,,,1,1,7.561606075,18054,7931,7688,243,3,240
17669,11353,10041,6,2,34636,,,,,,1,1,7.394480852,18302,8005,7681,324,19,305
17669,10365,11304,2,2,10576,,,,,,1,1,2.310838081,5268,2540,2312,228,2,226
17669,9259,10218,0,0,37661,,,,,,1,1,7.995533924,19441,8961,8663,298,3,295
17669,9780,10578,1,0,36625,,,,,,1,1,7.432174986,18869,8722,8410,312,2,310
17669,10772,10447,0,0,34271,,,,,,1,1,7.364654445,17838,8065,7762,303,4,299
17669,11242,10429,0,4,10110,,,,,,1,1,2.088637091,5016,2439,2223,216,3,213
17669,9785,11138,0,2,36438,,,,,,1,1,7.7935953730000005,18720,8694,8364,330,1,329
17669,11803,9660,2,0,34077,,,,,,1,1,7.393205512,17833,7961,7639,322,3,319
17669,8604,10786,0,0,35197,,,,,,1,1,7.476147016,18299,8292,7978,314,2,312
17669,10662,10487,2,0,37123,,,,,,1,1,8.100327558,18395,9181,8815,366,4,362
17669,11135,10681,2,0,9028,,,,,,1,1,2.041401318,4446,2179,1955,224,3,221
17669,10818,11217,0,2,12097,,,,,,1,1,2.606445494,6152,2864,2647,217,2,215
17669,8455,9958,2,2,36532,,,,,,1,1,7.626510205,18904,8679,8409,270,2,268
17669,10880,10394,0,0,37455,,,,,,1,1,8.065381083,19202,8966,8645,321,0,321
17669,10493,10426,0,0,34120,,,,,,1,1,7.53788609,17925,7930,7595,335,1,334
17669,10368,11595,0,2,5019,,,,,,1,1,1.123663958,2326,1243,1036,207,1,206
17669,9081,9745,0,2,36000,,,,,,1,1,7.793244122,18433,8660,8413,247,2,245
17669,8577,10229,2,2,37695,,,,,,1,1,7.958143226,19268,9074,8795,279,10,269
17669,10219,9006,2,0,34649,,,,,,1,1,7.441265506,18270,8059,7798,261,5,256
17669,11892,8858,5,0,34532,,,,,,1,1,7.615733523,18252,8000,7720,280,1,279
17669,10638,11152,0,6,19922,,,,,,1,1,4.375191782,10277,4688,4419,269,9,260
17669,10293,9605,0,2,37730,,,,,,1,1,7.897543181,19314,9059,8761,298,13,285
17669,10813,10969,2,2,8076,,,,,,1,1,1.706348471,3984,1942,1734,208,2,206
17669,9456,10514,0,0,37694,,,,,,1,1,7.811492129,19189,9103,8804,299,4,295
17669,9768,10619,0,0,37729,,,,,,1,1,7.8087046650000005,19168,9121,8802,319,3,316
17669,10598,9623,0,0,34859,,,,,,1,1,7.51649459,18411,8083,7801,282,2,280
17669,11319,9249,0,2,35612,,,,,,1,1,7.437786296,18509,8408,8121,287,3,284
17669,11292,10377,0,0,14586,,,,,,1,1,3.131347809,7397,3452,3167,285,2,283
17669,10084,9240,0,4,38922,,,,,,1,1,8.323962501,19353,9627,9312,315,4,311
17669,11573,8990,0,1,37102,,,,,,1,1,7.6804116,18811,8991,8682,309,2,307
17669,11183,10866,0,0,7038,,,,,,1,1,1.509291808,3421,1685,1438,247,3,244
17669,10932,10701,3,2,33927,,,,,,1,1,7.098276471,17875,7877,7579,298,3,295
17669,10533,10043,3,2,36761,,,,,,1,1,7.51582959,18706,8881,8588,293,3,290
17669,9995,10545,2,2,35864,,,,,,1,1,7.468232578,18575,8487,8172,315,5,310
17669,12670,8726,4,0,37162,,,,,,1,1,7.684027528,18523,9154,8823,331,1,330
17669,11397,9582,0,2,37540,,,,,,1,1,7.814355078,18927,9146,8825,321,2,319
17669,8840,10701,0,0,37095,,,,,,1,1,7.8699722869999995,19105,8848,8554,294,1,293
17669,11103,10580,2,0,4770,,,,,,1,1,0.964672308,2201,1175,956,219,1,218
17669,10623,10684,2,1,37530,,,,,,1,1,7.77285673,19063,9072,8749,323,7,316
17669,10575,9688,0,0,35534,,,,,,1,1,7.223634656,18440,8404,8118,286,2,284
17669,10904,11004,2,0,22864,,,,,,1,1,4.735820907,11762,5405,5113,292,0,292
17669,10744,9572,2,0,38697,,,,,,1,1,7.925643706,19141,9613,9283,330,3,327
17669,10578,9485,4,2,36896,,,,,,1,1,7.625577477,18998,8810,8532,278,4,274
17669,10381,10398,0,0,35992,,,,,,1,1,7.424938421,18591,8538,8213,325,1,324
17669,9421,10205,2,0,36530,,,,,,1,1,7.551157831,18856,8684,8378,306,3,303
17669,11142,10261,2,0,36741,,,,,,1,1,7.53352066,18969,8724,8400,324,1,323
17669,8994,11409,0,2,35092,,,,,,1,1,7.206048914,18621,8088,7793,295,1,294
17669,9040,11463,0,0,35076,,,,,,1,1,7.264578327,18480,8141,7827,314,8,306
17669,11272,10398,0,0,9447,,,,,,1,1,1.973833664,4680,2265,2028,237,1,236
17669,10507,9415,2,2,35610,,,,,,1,1,7.209692849,18354,8500,8244,256,10,246
17669,9494,10974,2,1,34353,,,,,,1,1,7.02938613,17927,8067,7775,292,6,286
17669,10639,9940,0,2,36357,,,,,,1,1,7.431095495,18822,8614,8307,307,2,305
17669,12079,8918,3,2,34212,,,,,,1,1,6.989924363,17708,8099,7793,306,1,305
17669,9842,11839,0,0,2517,,,,,,1,1,0.575100949,1113,624,468,156,0,156
17669,11859,9603,2,0,35343,,,,,,1,1,7.315002251,17994,8520,8211,309,2,307
17669,9276,11403,0,0,37312,,,,,,1,1,7.638832308,18990,9002,8684,318,2,316
17669,10549,9468,2,4,36467,,,,,,1,1,7.446958172,18949,8608,8306,302,3,299
17669,11253,10485,0,0,2914,,,,,,1,1,0.669481613,1338,707,545,162,1,161
17669,10159,11753,2,4,16495,,,,,,1,1,3.432327655,8371,3927,3657,270,0,270
17669,11001,10668,0,4,3597,,,,,,1,1,0.736566978,1712,854,677,177,1,176
17669,9747,11460,0,3,36221,,,,,,1,1,7.53123861,18363,8764,8434,330,3,327
17669,10927,10416,0,4,36887,,,,,,1,1,7.643241791,18832,8873,8564,309,5,304
17669,10808,10916,0,0,3406,,,,,,1,1,0.739149846,1494,870,698,172,0,172
17669,9549,11648,2,0,35388,,,,,,1,1,7.147271644,18358,8359,8047,312,6,306
17669,10869,9971,0,0,31953,,,,,,1,1,6.629118028,16998,7343,7074,269,1,268
17669,11179,10490,0,0,29139,,,,,,1,1,6.081200771,14565,7121,6789,332,0,332
17669,9493,10626,0,0,35162,,,,,,1,1,7.407607886,18361,8251,7952,299,3,296
17669,10898,10531,4,2,36091,,,,,,1,1,7.417933694,18713,8533,8221,312,2,310
17669,10224,10596,2,0,35744,,,,,,1,1,7.612985682,18747,8343,8032,311,3,308
17669,11548,10220,4,6,32818,,,,,,1,1,6.932700107,16763,7859,7522,337,7,330
17669,10122,11157,0,0,35495,,,,,,1,1,7.276509829,18113,8526,8196,330,1,329
17669,8865,10287,0,0,37023,,,,,,1,1,7.7333647,19136,8805,8528,277,2,275
17669,10485,11156,0,0,35223,,,,,,1,1,7.262041773,18286,8327,8044,283,1,282
17669,10550,9399,4,0,37731,,,,,,1,1,8.030924672,19273,9087,8803,284,9,275
17669,10279,10201,0,2,35766,,,,,,1,1,7.549341436,18630,8409,8091,318,8,310
17669,11081,9198,4,0,36234,,,,,,1,1,7.849795347,18738,8582,8250,332,2,330
17669,10158,10632,2,0,37070,,,,,,1,1,7.793850207,19027,8858,8531,327,2,325
17669,11016,9995,1,0,34623,,,,,,1,1,7.332331734,18084,8122,7827,295,3,292
17669,8934,9722,0,0,38470,,,,,,1,1,8.094296859,19554,9302,8990,312,1,311
17669,9817,9269,2,2,36153,,,,,,1,1,7.589647866,18729,8561,8259,302,7,295
17669,9968,8507,2,0,35451,,,,,,1,1,7.502788666,18228,8477,8208,269,4,265
17669,11324,9101,3,0,36960,,,,,,1,1,8.000967006,18994,8838,8548,290,0,290
17669,10784,10907,0,0,4207,,,,,,1,1,0.871039379,1962,1027,836,191,0,191
17669,9812,10591,0,0,35690,,,,,,1,1,7.827708042,18791,8303,8010,293,2,291
17669,11353,10431,1,0,2828,,,,,,1,1,0.635041539,1250,709,549,160,1,159
17669,11017,9763,1,2,36026,,,,,,1,1,7.720803476,18538,8566,8210,356,7,349
17669,10073,10090,0,0,36926,,,,,,1,1,7.518900376,18864,8873,8557,316,0,316
17669,11692,10272,0,0,2308,,,,,,1,1,0.485567232,989,584,433,151,0,151
17669,11393,10448,0,0,3945,,,,,,1,1,0.871868349,1785,988,804,184,0,184
17669,10171,11498,0,0,12513,,,,,,1,1,2.6412270429999998,6190,3022,2743,279,0,279
17669,10266,10843,4,0,36164,,,,,,1,1,7.530216906,18469,8698,8399,299,6,293
17669,10553,10568,0,0,37614,,,,,,1,1,7.947250058,19388,8945,8609,336,3,333
17669,10575,10823,3,2,37896,,,,,,1,1,7.697674422,19400,9067,8705,362,2,360
17669,9106,11016,0,0,36960,,,,,,1,1,7.641355809,18977,8824,8489,335,1,334
17669,10050,8167,2,0,36725,,,,,,1,1,7.591407345,18938,8771,8526,245,9,236
17669,11683,10104,0,0,3249,,,,,,1,1,0.734930932,1509,777,591,186,0,186
17669,10441,11249,2,0,2887,,,,,,1,1,0.584843308,1222,749,582,167,0,167
17669,9714,9893,0,2,36542,,,,,,1,1,7.655441735,18738,8759,8473,286,0,286
17669,9829,10805,0,0,34321,,,,,,1,1,7.25270699,18118,7962,7683,279,0,279
17669,10111,11560,0,2,2456,,,,,,1,1,0.507454104,1056,622,466,156,1,155
17669,10522,9286,0,0,37229,,,,,,1,1,7.853774415,19186,8879,8594,285,1,284
17669,10789,10899,0,2,5627,,,,,,1,1,1.13875268,2597,1421,1233,188,2,186
17669,10393,10172,5,0,36938,,,,,,1,1,7.866807983,18796,8919,8615,304,0,304
17669,9250,10740,0,2,37162,,,,,,1,1,7.726317478,18946,8956,8652,304,1,303
17669,7981,8355,0,0,39507,,,,,,1,1,8.043812661,19977,9628,9354,274,2,272
17669,11286,8778,4,0,38280,,,,,,1,1,7.90473697,19377,9302,9003,299,5,294
17669,9436,9822,0,4,37491,,,,,,1,1,7.645139403,19274,8964,8675,289,4,285
17669,11091,10710,3,2,4633,,,,,,1,1,0.9355369,2176,1126,921,205,1,204
17669,8980,9920,4,1,36427,,,,,,1,1,7.709095813,18603,8788,8540,248,3,245
17669,10591,10064,0,2,36121,,,,,,1,1,7.381104683,18680,8563,8248,315,1,314
17669,10713,10568,2,2,34659,,,,,,1,1,7.148982832,18099,8134,7842,292,6,286
17669,9463,11441,0,2,35845,,,,,,1,1,7.581510347,18445,8556,8268,288,4,284
17669,10281,9578,0,0,35972,,,,,,1,1,7.810221542,18813,8434,8143,291,3,288
17669,10521,9685,0,0,36445,,,,,,1,1,7.453765977,18476,8828,8515,313,4,309
17669,9596,12131,0,4,31294,,,,,,1,1,6.524467726,16180,7391,7059,332,1,331
17669,9476,11230,0,2,34940,,,,,,1,1,7.545905736,18239,8190,7869,321,4,317
17669,10777,9572,0,0,35283,,,,,,1,1,7.414726676,18427,8298,8038,260,4,256
17669,10825,8353,2,0,37968,,,,,,1,1,7.689254115,18966,9351,9051,300,6,294
17669,10012,10814,6,2,35635,,,,,,1,1,7.680200474,18259,8525,8199,326,17,309
17669,10634,9222,2,0,39632,,,,,,1,1,8.175242529,19899,9698,9361,337,0,337
17669,11164,10203,2,0,35879,,,,,,1,1,7.292198786,18339,8607,8281,326,3,323
17669,10010,10326,0,0,37551,,,,,,1,1,7.892516005,18725,9244,8906,338,0,338
17669,11388,10192,0,0,37870,,,,,,1,1,7.641353811,18971,9282,8947,335,1,334
17669,10744,9793,0,0,36289,,,,,,1,1,7.433046986,18706,8643,8346,297,0,297
17669,10379,10856,0,0,35973,,,,,,1,1,7.299151039,18344,8674,8393,281,0,281
17669,10099,11896,0,4,18839,,,,,,1,1,3.97718359,9259,4642,4346,296,7,289
17669,9541,11380,0,2,36881,,,,,,1,1,7.587842484,18869,8857,8559,298,1,297
17669,9572,10119,2,0,34837,,,,,,1,1,7.16816509,18279,8137,7853,284,1,283
17669,10875,10663,0,0,35369,,,,,,1,1,7.422467163,18360,8362,8077,285,2,283
17669,9539,9964,2,2,35568,,,,,,1,1,7.364691764,18482,8387,8075,312,4,308
17669,11850,9901,2,0,2231,,,,,,1,1,0.459814745,922,575,416,159,2,157
17669,11062,10691,0,0,5603,,,,,,1,1,1.276913538,2578,1411,1208,203,0,203
17669,9339,10759,0,0,35209,,,,,,1,1,7.150855596,18386,8259,7954,305,2,303
17669,10773,10762,0,0,36193,,,,,,1,1,7.374765705,18469,8690,8346,344,0,344
17669,9282,10863,1,0,36870,,,,,,1,1,7.690503044,18956,8816,8534,282,1,281
17669,10697,11073,0,2,3187,,,,,,1,1,0.661156603,1387,805,615,190,0,190
17669,10941,10178,0,3,35128,,,,,,1,1,7.154702418,17954,8439,8143,296,0,296
17669,11060,10286,0,0,37105,,,,,,1,1,7.905416229,18711,9025,8681,344,0,344
17669,10887,10116,1,0,37365,,,,,,1,1,7.732518218,18970,9027,8686,341,3,338
17669,10976,10702,0,2,3128,,,,,,1,1,0.65458686,1330,801,605,196,3,193
17669,7665,10535,0,0,37122,,,,,,1,1,7.528445165,19416,8713,8433,280,3,277
17669,9519,11657,0,4,34641,,,,,,1,1,7.150370927,17661,8336,8028,308,9,299
17669,9258,9858,0,2,35782,,,,,,1,1,7.556129777,18171,8668,8393,275,0,275
17669,9712,10758,1,2,36860,,,,,,1,1,7.53959287,18973,8804,8525,279,4,275
17669,10124,10589,2,2,36902,,,,,,1,1,7.445428995,18669,8958,8641,317,7,310
17669,8269,10987,0,2,36936,,,,,,1,1,7.897016522,19015,8835,8584,251,2,249
17669,11809,9792,0,2,37115,,,,,,1,1,7.7342843519999995,19075,8836,8468,368,7,361
17669,9898,9902,2,0,37599,,,,,,1,1,7.716252089,18880,9211,8914,297,1,296
17669,10481,10230,0,0,38559,,,,,,1,1,8.085797347,19191,9527,9213,314,1,313
17669,9772,9768,2,0,35794,,,,,,1,1,7.567709243,18811,8362,8103,259,2,257
17669,8825,9915,2,4,38490,,,,,,1,1,7.958922641,19534,9332,9040,292,8,284
17669,10294,11128,0,2,33967,,,,,,1,1,7.032297361,17765,7944,7630,314,7,307
17669,10485,10214,1,2,37984,,,,,,1,1,7.945916488,19171,9243,8916,327,0,327
17669,10423,11005,0,0,35094,,,,,,1,1,7.292292391,18145,8321,8014,307,2,305
17669,9812,9487,0,2,36546,,,,,,1,1,7.651796313,18646,8804,8512,292,2,290
17669,10446,11223,2,2,4852,,,,,,1,1,1.007623378,2240,1201,991,210,2,208
17669,10289,9441,0,0,35518,,,,,,1,1,7.599000613,18788,8214,7912,302,5,297
17669,10061,10387,0,3,37750,,,,,,1,1,7.735219203,19158,9138,8822,316,3,313
17669,10094,10775,4,0,35662,,,,,,1,1,7.236132643,18652,8360,8070,290,2,288
17669,9444,10991,5,0,34710,,,,,,1,1,7.179805584,18522,7948,7656,292,2,290
17669,9916,11753,2,3,27007,,,,,,1,1,5.635061304,13522,6595,6300,295,1,294
17669,10999,9651,4,0,35900,,,,,,1,1,7.430096192,18183,8709,8410,299,15,284
17669,8639,9996,0,11,37519,,,,,,1,1,7.850393637,19206,9027,8768,259,4,255
17669,9344,8593,0,0,37007,,,,,,1,1,7.536909058,19219,8766,8510,256,3,253
17669,8640,10402,0,2,36996,,,,,,1,1,7.71403626,18990,8875,8619,256,3,253
17669,11254,8956,2,3,37835,,,,,,1,1,7.920669171,19379,9071,8757,314,6,308
17669,11065,9689,6,2,37300,,,,,,1,1,7.748668704,19000,8998,8694,304,1,303
17669,10755,11038,0,2,29046,,,,,,1,1,5.999766004,14599,7073,6772,301,1,300
17669,9328,10888,0,4,35789,,,,,,1,1,7.348986794,18476,8509,8214,295,0,295
17669,10122,10552,2,0,35274,,,,,,1,1,7.216671502,18026,8473,8171,302,0,302
17669,10632,9032,4,0,35790,,,,,,1,1,7.790697799,18589,8462,8185,277,6,271
17669,10687,10995,0,0,2375,,,,,,1,1,0.488293011,981,617,457,160,0,160
17669,8799,10213,0,0,37961,,,,,,1,1,8.142714437,19188,9258,9001,257,0,257
17669,10530,9592,0,6,34455,,,,,,1,1,7.242857895,18315,7942,7686,256,3,253
17669,10369,10482,0,4,36061,,,,,,1,1,7.399007967,18786,8474,8147,327,1,326
17669,10837,10838,0,0,7923,,,,,,1,1,1.608194956,3875,1915,1697,218,1,217
17669,10588,9139,0,2,35999,,,,,,1,1,7.331503354,18320,8691,8394,297,6,291
17669,11691,9550,0,0,34230,,,,,,1,1,7.264746564,17867,8023,7706,317,4,313
17669,10588,11081,0,0,1988,,,,,,1,1,0.40958656,842,499,351,148,0,148
17669,10779,9900,3,0,35699,,,,,,1,1,7.238339985,18482,8446,8121,325,1,324
17669,9183,11118,2,0,37121,,,,,,1,1,7.657774481,19113,8850,8542,308,5,303
17669,10475,10664,0,0,36654,,,,,,1,1,7.873651307,18709,8815,8500,315,2,313
17669,11228,9217,3,0,35598,,,,,,1,1,7.439147644,18773,8271,7988,283,0,283
17669,10572,10050,0,2,35565,,,,,,1,1,7.496178083,18503,8382,8084,298,3,295
17669,8607,9613,1,2,37781,,,,,,1,1,7.972297664,19478,9017,8748,269,3,266
17669,9571,10612,2,0,37048,,,,,,1,1,7.488955347,18744,8991,8669,322,5,317
17669,9770,9921,2,0,37739,,,,,,1,1,7.828504359,19044,9190,8875,315,6,309
17669,10053,11440,2,0,33587,,,,,,1,1,6.896330755,17208,8039,7738,301,1,300
17669,8481,10554,0,0,37473,,,,,,1,1,7.5444037999999995,18914,9142,8867,275,2,273
17669,10885,9478,0,0,38026,,,,,,1,1,7.716998725,18902,9402,9082,320,3,317
17669,9253,10352,1,3,37793,,,,,,1,1,7.872654087,19020,9244,8959,285,0,285
17669,11478,8803,2,0,35189,,,,,,1,1,7.248209818,18189,8346,8038,308,0,308
17669,9633,12039,0,2,8630,,,,,,1,1,1.833980359,4327,2034,1799,235,4,231
17669,9362,11702,4,0,35386,,,,,,1,1,7.147954101,17947,8566,8259,307,11,296
17669,9479,9623,0,0,38718,,,,,,1,1,8.053759642,19023,9717,9456,261,3,258
17669,10601,10893,0,0,37195,,,,,,1,1,7.696899826,19029,8919,8591,328,2,326
17669,12012,9667,2,0,5388,,,,,,1,1,1.133346663,2531,1334,1145,189,2,187
17669,9765,10766,2,1,37588,,,,,,1,1,7.6818829520000005,19062,9104,8786,318,6,312
17669,9110,10144,0,0,38502,,,,,,1,1,7.902041521,19001,9609,9326,283,3,280
17669,9918,9533,0,0,34330,,,,,,1,1,6.9804587080000005,18172,7943,7671,272,2,270
17669,11031,8703,0,0,34008,,,,,,1,1,7.057376687,17905,7918,7651,267,1,266
17669,10425,9983,2,2,37452,,,,,,1,1,7.760223664,19308,8910,8586,324,2,322
17669,10008,10977,0,2,36463,,,,,,1,1,7.509354558,18399,8884,8588,296,1,295
17669,8810,10726,0,3,37755,,,,,,1,1,7.770017148,19290,9072,8751,321,7,314
17669,9268,8487,0,0,36796,,,,,,1,1,7.508819715,18998,8776,8530,246,3,243
17669,10715,9479,0,2,36576,,,,,,1,1,7.572041784,19092,8592,8292,300,6,294
17669,10812,9583,2,0,36663,,,,,,1,1,7.423628246,18646,8859,8560,299,5,294
17669,10713,9239,0,0,35854,,,,,,1,1,7.43714183,18710,8432,8152,280,4,276
17669,11862,10126,2,0,8220,,,,,,1,1,1.664103952,4083,1949,1710,239,3,236
17669,11215,10825,0,0,4597,,,,,,1,1,0.988279138,2146,1134,951,183,0,183
17669,10139,9310,0,0,36181,,,,,,1,1,7.331608814,18713,8579,8269,310,4,306
17669,10942,8966,2,0,38005,,,,,,1,1,7.750906,19119,9278,8948,330,2,328
17669,10486,10477,0,0,37160,,,,,,1,1,7.660049381,18638,9090,8748,342,1,341
17669,9201,8844,2,0,36851,,,,,,1,1,7.550908407,19134,8736,8491,245,4,241
17669,10576,9802,1,0,35106,,,,,,1,1,7.102239095,18402,8207,7917,290,0,290
17669,10144,11527,2,2,5256,,,,,,1,1,1.079062074,2411,1318,1109,209,8,201
17669,10798,10644,2,0,35946,,,,,,1,1,7.34095898,18446,8590,8270,320,5,315
17669,10301,10924,1,2,34507,,,,,,1,1,7.275726125,18294,7966,7685,281,2,279
17669,9756,11060,0,0,39018,,,,,,1,1,7.948579701,19431,9613,9252,361,0,361
17669,9018,10203,4,0,38304,,,,,,1,1,7.961132959,19366,9335,9067,268,2,266
17669,10160,8955,2,0,36760,,,,,,1,1,7.695913302,18738,8867,8579,288,3,285
17669,9873,10546,1,2,34213,,,,,,1,1,7.004195608,17997,7972,7700,272,1,271
17669,11151,10704,4,2,14406,,,,,,1,1,2.936949117,7646,3259,3017,242,3,239
17669,9145,9960,0,2,36737,,,,,,1,1,7.51560502,18964,8742,8453,289,5,284
17669,10241,10951,2,4,37569,,,,,,1,1,7.757015968,18761,9241,8915,326,3,323
17669,9533,12035,0,0,34857,,,,,,1,1,7.221425228,18119,8211,7895,316,2,314
17669,10702,10720,4,1,36983,,,,,,1,1,7.5209631219999995,18672,8983,8638,345,19,326
17669,9277,10223,2,2,37519,,,,,,1,1,7.64279511,19043,9083,8773,310,2,308
17669,9848,11027,0,0,36415,,,,,,1,1,7.579224882,18605,8767,8491,276,1,275
17669,10654,10291,0,2,37955,,,,,,1,1,7.80886021,19382,9123,8796,327,11,316
17669,10084,10381,4,2,35837,,,,,,1,1,7.442928396,18490,8534,8255,279,2,277
17669,10852,9485,4,0,36043,,,,,,1,1,7.389611595,18614,8565,8266,299,3,296
17669,10463,9184,0,2,37028,,,,,,1,1,7.441290059,18887,8936,8667,269,0,269
17669,10903,9988,2,2,34115,,,,,,1,1,6.909141791,17730,8041,7738,303,6,297
17669,10234,10314,0,0,35714,,,,,,1,1,7.316917104,18505,8450,8141,309,7,302
17669,10144,11447,2,0,35711,,,,,,1,1,7.249109141,18122,8624,8283,341,3,338
17669,10937,9611,2,0,34068,,,,,,1,1,7.038721626,18060,7856,7560,296,0,296
17669,10899,8981,0,2,37264,,,,,,1,1,7.528340056,18853,9068,8793,275,1,274
17669,11322,10347,2,0,20150,,,,,,1,1,4.104319912,10242,4818,4546,272,2,270
17669,10037,10265,2,2,35548,,,,,,1,1,7.203061993,18593,8322,8011,311,1,310
17669,11172,8575,3,0,36515,,,,,,1,1,7.395229183,18889,8676,8402,274,5,269
17669,10500,10598,0,2,37219,,,,,,1,1,7.6776213779999996,18558,9146,8777,369,3,366
17669,10213,11456,0,4,11170,,,,,,1,1,2.259846254,5416,2757,2517,240,1,239
17669,10239,11430,2,2,17592,,,,,,1,1,3.603241628,8959,4178,3901,277,0,277
17669,8791,9914,0,2,37361,,,,,,1,1,7.959850809,19117,8986,8714,272,2,270
17669,10821,10848,2,1,11660,,,,,,1,1,2.372198579,5796,2807,2557,250,2,248
17669,9866,10448,2,2,38853,,,,,,1,1,7.951654581,19378,9574,9247,327,5,322
17669,10423,10768,0,0,36684,,,,,,1,1,7.487814118,18510,8941,8649,292,0,292
17669,11214,9860,4,2,34706,,,,,,1,1,7.208936714,18117,8135,7816,319,12,307
17669,10808,11135,4,4,18338,,,,,,1,1,3.7609460710000002,9540,4268,4006,262,5,257
17669,10149,10297,0,0,37613,,,,,,1,1,7.599878811,19116,9095,8788,307,5,302
17669,11002,10783,2,0,17625,,,,,,1,1,3.654372281,9028,4169,3910,259,3,256
17669,10693,10985,0,0,1530,,,,,,1,1,0.315128525,601,399,268,131,0,131
17669,9500,12169,0,0,6574,,,,,,1,1,1.333322374,3090,1637,1427,210,3,207
17669,10180,9897,0,2,37299,,,,,,1,1,7.703040072,19029,8981,8673,308,7,301
17669,9320,9425,2,0,34753,,,,,,1,1,7.178403332,18377,8056,7792,264,5,259
17669,10431,9543,0,0,37595,,,,,,1,1,7.717653684,19326,8978,8665,313,2,311
17669,10876,9332,0,0,35030,,,,,,1,1,7.158327141,18286,8228,7940,288,1,287
17669,11224,10483,3,3,32849,,,,,,1,1,6.739494964,16682,7914,7575,339,2,337
17669,10708,9802,3,2,36167,,,,,,1,1,7.736769329,18276,8806,8527,279,3,276
17669,10316,11241,2,11,35065,,,,,,1,1,7.349674271,18079,8336,8022,314,6,308
17669,11069,10802,0,0,1901,,,,,,1,1,0.389560119,818,481,360,121,0,121
17669,9944,8774,0,0,36624,,,,,,1,1,7.54864422,18875,8736,8459,277,5,272
17669,11528,10141,2,2,8740,,,,,,1,1,1.822172425,4264,2113,1863,250,0,250
17669,10239,7962,0,0,36468,,,,,,1,1,7.519816623,19165,8534,8299,235,4,231
17669,9557,10624,3,1,36613,,,,,,1,1,7.369791774,18771,8770,8468,302,12,290
17669,9953,9421,0,0,36185,,,,,,1,1,7.508288662,18809,8542,8250,292,2,290
17669,11334,9706,0,0,36239,,,,,,1,1,7.695604741,18640,8628,8285,343,2,341
17669,10046,10958,0,0,34991,,,,,,1,1,7.182476071,18333,8175,7867,308,2,306
17669,7620,11961,2,0,36510,,,,,,1,1,7.653360437,18882,8664,8364,300,4,296
17669,11006,10589,2,4,34252,,,,,,1,1,7.289342648,18135,7898,7577,321,4,317
17669,10300,9739,0,0,37044,,,,,,1,1,7.565359624,19004,8860,8540,320,1,319
17669,10358,8884,0,2,37092,,,,,,1,1,7.556278354,18908,8950,8666,284,2,282
17669,10031,11639,0,2,5597,,,,,,1,1,1.140460863,2727,1339,1147,192,0,192
17669,11127,10543,0,0,3462,,,,,,1,1,0.706039247,1560,865,693,172,0,172
17669,10476,11207,0,0,2092,,,,,,1,1,0.429321027,930,513,377,136,0,136
17669,11817,9592,0,2,35086,,,,,,1,1,7.227971426,18239,8267,7954,313,3,310
17669,9553,11011,2,0,35345,,,,,,1,1,7.402263481,18238,8402,8099,303,3,300
17669,12088,9642,6,0,30334,,,,,,1,1,6.163813993,15001,7508,7191,317,9,308
17669,9916,10729,0,2,35758,,,,,,1,1,7.260850367,18593,8437,8146,291,3,288
17669,10125,10902,0,5,35039,,,,,,1,1,7.333308133,18351,8183,7861,322,7,315
17669,9916,10097,0,2,35661,,,,,,1,1,7.418039551,18532,8420,8131,289,1,288
17669,10294,10424,2,0,34426,,,,,,1,1,6.983254378,17916,8124,7862,262,0,262
17669,10394,11286,2,2,18231,,,,,,1,1,3.684392232,9010,4470,4189,281,6,275
17669,10655,9181,2,2,36306,,,,,,1,1,7.46766413,18715,8654,8371,283,1,282
17669,10646,11028,0,0,3567,,,,,,1,1,0.728184037,1626,881,702,179,0,179
17669,10291,10005,1,4,34674,,,,,,1,1,7.252534224,18328,8041,7777,264,2,262
17669,8646,9486,0,0,37979,,,,,,1,1,7.7185431829999995,19463,9118,8838,280,2,278
17669,11961,9656,3,0,34403,,,,,,1,1,7.010670529,18006,8050,7753,297,0,297
17669,9544,11344,2,2,36122,,,,,,1,1,7.310815344,18868,8487,8207,280,1,279
17669,8398,10527,0,0,36776,,,,,,1,1,7.663684202,19125,8678,8383,295,2,293
17669,10786,10599,0,2,35705,,,,,,1,1,7.46299448,18569,8399,8061,338,2,336
17669,11429,10261,2,0,1316,,,,,,1,1,0.271828841,510,340,214,126,1,125
17669,10239,11528,0,0,3772,,,,,,1,1,0.768368038,1679,959,784,175,0,175
17669,10137,9631,0,0,35152,,,,,,1,1,7.189248487,18262,8304,8022,282,0,282
17669,8942,8023,0,0,37889,,,,,,1,1,7.775526662,19561,9028,8756,272,4,268
17669,10589,10685,0,2,36426,,,,,,1,1,7.345599461,18773,8655,8312,343,1,342
17669,10618,9900,2,4,36518,,,,,,1,1,7.393807857,18603,8811,8518,293,13,280
17669,11031,10642,0,2,2576,,,,,,1,1,0.53121615,1135,638,473,165,2,163
17669,10722,10084,0,0,35352,,,,,,1,1,7.148098349,18339,8359,8064,295,2,293
17669,9501,8826,2,0,35161,,,,,,1,1,7.261568226,18734,8091,7846,245,1,244
17669,9796,11342,0,2,34506,,,,,,1,1,7.131033577,18474,7873,7587,286,3,283
17669,11215,10678,0,0,5408,,,,,,1,1,1.097827715,2587,1307,1100,207,1,206
17669,10418,10233,2,2,36323,,,,,,1,1,7.52397355,18430,8802,8513,289,1,288
17669,8734,11909,0,2,35863,,,,,,1,1,7.272108094,18509,8525,8221,304,1,303
17669,10486,8254,2,0,37255,,,,,,1,1,7.551723739,19032,8966,8675,291,16,275
17669,10434,10684,0,4,35197,,,,,,1,1,7.238380104,17993,8434,8098,336,24,312
17669,11238,10433,4,2,18545,,,,,,1,1,3.836320844,9126,4558,4255,303,1,302
17669,10589,10751,0,2,36161,,,,,,1,1,7.702255276,18575,8642,8340,302,0,302
17669,10707,9147,0,0,35533,,,,,,1,1,7.205921433,18449,8405,8131,274,1,273
17669,8504,9854,0,0,36428,,,,,,1,1,7.5450865,18973,8598,8339,259,4,255
17669,9406,10325,0,0,34556,,,,,,1,1,7.063222286,18084,8110,7858,252,1,251
17669,10529,10973,0,2,33974,,,,,,1,1,7.008983339,17716,7976,7670,306,3,303
17669,11469,8684,4,2,36413,,,,,,1,1,7.423579726,18727,8698,8408,290,9,281
17669,10141,11531,2,2,11583,,,,,,1,1,2.431424852,5656,2832,2569,263,1,262
17669,11277,10224,2,2,35449,,,,,,1,1,7.208341903,18430,8354,8043,311,5,306
17669,10080,10268,0,0,36486,,,,,,1,1,7.527584693,18973,8593,8266,327,2,325
17669,10821,10854,0,0,3875,,,,,,1,1,0.784604513,1810,943,764,179,0,179
17669,9624,10810,1,2,35819,,,,,,1,1,7.47811166,18582,8473,8182,291,3,288
17669,9701,10289,1,0,38455,,,,,,1,1,7.790661771,19255,9432,9096,336,9,327
17669,10285,11403,0,0,5465,,,,,,1,1,1.259602987,2439,1409,1201,208,0,208
17669,10532,11496,0,2,19523,,,,,,1,1,3.923253092,9741,4747,4459,288,4,284
17669,11400,10348,6,0,9497,,,,,,1,1,1.924207072,4649,2302,2058,244,8,236
17669,9738,11032,1,4,34766,,,,,,1,1,7.22809562,18291,8087,7786,301,4,297
17669,10193,10555,0,0,34658,,,,,,1,1,7.31037571,18367,7997,7700,297,3,294
17669,9157,10237,0,0,36801,,,,,,1,1,7.645490776,18941,8780,8480,300,3,297
17669,10814,10015,0,2,36153,,,,,,1,1,7.58767475,18421,8708,8392,316,2,314
17669,10139,11530,0,2,25274,,,,,,1,1,5.289866959,12611,6175,5862,313,7,306
17669,8714,10986,0,0,35982,,,,,,1,1,7.652954723,18351,8671,8382,289,2,287
17669,10717,10114,2,0,34130,,,,,,1,1,6.991504035,17986,7934,7658,276,2,274
17669,10963,9312,0,0,36822,,,,,,1,1,7.89760226,18802,8842,8506,336,1,335
17669,10920,8913,0,0,36767,,,,,,1,1,7.783634306,18877,8792,8486,306,5,301
17669,11376,10312,4,2,4295,,,,,,1,1,0.883472726,1962,1069,874,195,4,191
17669,11037,9563,0,0,37291,,,,,,1,1,8.034443683,19085,8957,8665,292,0,292
17669,10439,9704,0,0,35207,,,,,,1,1,7.537512179,18292,8306,8003,303,2,301
17669,10402,10012,0,4,36544,,,,,,1,1,7.699527696,19064,8585,8275,310,8,302
17669,10893,10449,4,2,35582,,,,,,1,1,7.552123453,18250,8513,8207,306,3,303
17669,11556,10292,0,0,5723,,,,,,1,1,1.228475729,2903,1313,1119,194,0,194
17669,10385,9376,2,0,37330,,,,,,1,1,8.041983542,19138,8964,8700,264,1,263
17669,8940,10684,2,2,37675,,,,,,1,1,8.314889289,19419,8979,8681,298,8,290
17669,9056,12194,2,2,38741,,,,,,1,1,8.138952317,19128,9625,9262,363,15,348
17669,10175,8937,3,2,34689,,,,,,1,1,7.198670769,18011,8202,7928,274,2,272
17669,10916,9003,0,0,36692,,,,,,1,1,7.569492871,18837,8766,8443,323,2,321
17669,11066,10720,0,2,4012,,,,,,1,1,0.840723994,1764,1031,845,186,1,185
17669,9591,11303,0,0,36550,,,,,,1,1,7.6089887990000005,18512,8866,8560,306,1,305
17669,10444,9955,0,2,37900,,,,,,1,1,7.869113699,18967,9307,8988,319,4,315
17669,9322,8946,2,0,38171,,,,,,1,1,8.060246722,19078,9394,9089,305,5,300
17669,11168,10187,2,4,35625,,,,,,1,1,7.285114581,18040,8618,8269,349,6,343
17669,10469,11156,0,2,37969,,,,,,1,1,7.850707337,19069,9271,8913,358,8,350
17669,11215,8960,0,2,34680,,,,,,1,1,6.342554535,18234,8087,7815,272,1,271
17669,10700,9860,4,2,38438,,,,,,1,1,7.693849647,19208,9437,9081,356,8,348
17669,9154,10978,0,0,37623,,,,,,1,1,7.988467037,18995,9157,8843,314,2,312
17669,11021,10890,0,4,26411,,,,,,1,1,4.765954509,13446,6334,6037,297,1,296
17669,9668,10712,4,0,38575,,,,,,1,1,7.581071498,19150,9549,9222,327,11,316
17669,10473,10888,0,2,35875,,,,,,1,1,7.302813554,18337,8603,8271,332,3,329
17669,10883,9671,0,0,36471,,,,,,1,1,5.8724786810000005,18516,8823,8514,309,0,309
17669,9764,9431,0,2,34892,,,,,,1,1,6.79733041,18407,8122,7881,241,2,239
17669,9109,10993,2,4,35726,,,,,,1,1,7.216028458,18498,8473,8191,282,1,281
17669,10392,11073,2,0,36409,,,,,,1,1,6.022044667,18475,8806,8484,322,1,321
17669,9908,11025,0,2,36684,,,,,,1,1,7.506345307,18543,8913,8598,315,0,315
17669,11081,10379,0,2,34596,,,,,,1,1,6.226332231,17772,8266,7974,292,6,286
17669,9506,10009,2,2,37809,,,,,,1,1,5.161682926,19287,9104,8790,314,7,307
17669,10600,9458,0,0,35679,,,,,,1,1,6.883028608,18719,8333,8039,294,2,292
17669,9881,10883,2,0,37301,,,,,,1,1,5.829586417,18836,9072,8751,321,4,317
17669,10430,9831,2,8,35532,,,,,,1,1,6.861965308,18281,8472,8165,307,13,294
17669,9681,10881,0,0,36954,,,,,,1,1,6.321769809,18834,8897,8571,326,0,326
17669,10743,9053,2,0,37748,,,,,,1,1,6.784207649,18942,9245,8929,316,1,315
