key_bits,recovered_zeros_x,recovered_zeros_y,wrong_zeros_x,wrong_zeros_y,queries,traces,calibration_traces,threshold,tpr,tnr,attack_tpr,attack_tnr,duration_seconds,test_outcomes_0_false,test_outcomes_0_true,test_outcomes_1_false,test_outcomes_1_true,test_outcomes_2_false,test_outcomes_2_true
17669,10314,10612,0,0,1035,,,,,,1,1,0.223583218,374,277,170,107,0,107
17669,10878,10043,2,0,3139,,,,,,1,1,0.674476797,1379,794,622,172,2,170
17669,10777,10151,0,0,3563,,,,,,1,1,0.741522644,1649,870,696,174,1,173
17669,11225,9695,0,0,3494,,,,,,1,1,0.743917603,1570,889,743,146,0,146
17669,11150,10067,0,0,3751,,,,,,1,1,0.781654946,1707,927,737,190,0,190
17669,10953,10319,2,2,4184,,,,,,1,1,0.866702489,1862,1074,900,174,2,172
17669,9315,11618,0,0,4221,,,,,,1,1,0.899812086,1891,1067,871,196,0,196
17669,9613,11309,0,0,4015,,,,,,1,1,0.907872943,1724,1052,865,187,1,186
17669,9726,11407,0,0,4756,,,,,,1,1,0.999487094,2203,1189,1014,175,0,175
17669,9980,10957,0,0,1378,,,,,,1,1,0.291719407,606,331,221,110,1,109
17669,10015,10920,4,0,5487,,,,,,1,1,1.133330063,2572,1362,1171,191,0,191
17669,11523,9556,0,2,5378,,,,,,1,1,1.143371394,2506,1347,1169,178,0,178
17669,10993,10149,0,0,5815,,,,,,1,1,1.196790467,2768,1425,1228,197,0,197
17669,10589,10337,2,0,6636,,,,,,1,1,1.374425192,3183,1625,1422,203,1,202
17669,10232,10938,0,2,3384,,,,,,1,1,0.703394915,1585,818,655,163,2,161
17669,9784,11135,0,0,2592,,,,,,1,1,0.565829342,1067,684,527,157,0,157
17669,9737,11183,2,2,7331,,,,,,1,1,1.604473138,3548,1769,1524,245,5,240
17669,10673,10252,0,1,2584,,,,,,1,1,0.529205463,1148,641,487,154,1,153
17669,9950,10972,0,0,5369,,,,,,1,1,1.130025964,2490,1349,1168,181,1,180
17669,10129,10792,0,0,9207,,,,,,1,1,1.927887506,4535,2227,2009,218,0,218
17669,10405,10609,0,0,3929,,,,,,1,1,0.803852194,1749,1002,826,176,0,176
17669,10780,10148,0,0,3038,,,,,,1,1,0.630834965,1382,753,603,150,0,150
17669,10491,10555,0,2,6158,,,,,,1,1,1.259597243,2898,1525,1315,210,4,206
17669,11666,9257,0,0,3197,,,,,,1,1,0.679201446,1432,810,665,145,0,145
17669,10481,10445,0,0,3508,,,,,,1,1,0.72275707,1678,837,681,156,0,156
17669,10424,10508,2,1,5728,,,,,,1,1,1.173296357,2664,1424,1208,216,0,216
17669,11418,9759,2,0,4580,,,,,,1,1,0.965078873,2164,1110,914,196,0,196
17669,9946,10985,0,0,10123,,,,,,1,1,2.09584851,5118,2384,2147,237,0,237
17669,10624,10452,2,0,19773,,,,,,1,1,4.095969435,9944,4759,4448,311,2,309
17669,10570,10352,0,2,6283,,,,,,1,1,1.3079986909999999,3033,1532,1346,186,2,184
17669,10166,10759,0,0,2694,,,,,,1,1,0.562815839,1168,685,529,156,0,156
17669,10119,10800,0,4,26796,,,,,,1,1,5.536733004,13856,6318,6014,304,1,303
17669,11113,9767,3,0,33961,,,,,,1,1,7.111780529,18074,7817,7564,253,1,252
17669,10896,9351,1,1,35436,,,,,,1,1,7.325764983,18632,8264,7988,276,1,275
17669,10930,10025,0,2,20617,,,,,,1,1,4.272850581,10490,4935,4678,257,0,257
17669,10680,10195,0,0,35175,,,,,,1,1,7.340144126,18438,8210,7893,317,0,317
17669,10797,9107,2,0,36069,,,,,,1,1,7.448063314,18644,8566,8273,293,2,291
17669,11228,9217,3,0,35523,,,,,,1,1,7.48840962,18773,8246,7988,258,0,258
17669,9514,10878,2,0,36270,,,,,,1,1,7.533118958,18260,8856,8558,298,2,296
17669,9619,9271,2,2,35742,,,,,,1,1,7.641928106,18717,8378,8109,269,12,257
17669,10682,10293,3,0,27641,,,,,,1,1,5.791997239,14186,6579,6282,297,1,296
17669,10820,10204,0,2,2048,,,,,,1,1,0.426131886,907,508,383,125,1,124
17669,10199,9012,2,0,37709,,,,,,1,1,7.799984008,19449,8984,8692,292,1,291
17669,10082,9496,2,1,34694,,,,,,1,1,7.163148846,18221,8112,7863,249,10,239
17669,10683,9508,0,2,35939,,,,,,1,1,7.428184923,18793,8426,8132,294,0,294
17669,10565,9329,4,0,35750,,,,,,1,1,7.32892937,18273,8590,8293,297,4,293
17669,9110,10144,0,0,38598,,,,,,1,1,8.123869887,19001,9641,9326,315,3,312
17669,10341,8234,0,0,36738,,,,,,1,1,7.580941552,18950,8771,8525,246,2,244
17669,11017,9763,1,2,35658,,,,,,1,1,7.392215885,18365,8489,8174,315,8,307
17669,10379,10400,2,0,32116,,,,,,1,1,6.705267308,16990,7426,7152,274,1,273
17669,9580,11342,0,4,25695,,,,,,1,1,5.290545647,12994,6214,5941,273,5,268
17669,10376,10543,0,0,35840,,,,,,1,1,7.412026785,18466,8512,8162,350,3,347
17669,11744,9175,0,0,9627,,,,,,1,1,1.980149554,4488,2432,2157,275,1,274
17669,11551,9416,2,0,1827,,,,,,1,1,0.385875723,809,441,305,136,0,136
17669,9482,11471,0,0,7772,,,,,,1,1,1.60326447,3725,1916,1701,215,0,215
17669,10462,10129,4,2,37129,,,,,,1,1,7.723658378,18773,9026,8722,304,4,300
17669,10547,10424,0,0,3301,,,,,,1,1,0.687403181,1465,837,675,162,0,162
17669,10521,10568,4,1,6198,,,,,,1,1,1.281711183,2856,1560,1338,222,2,220
17669,10176,10750,0,0,5762,,,,,,1,1,1.1850636589999999,2724,1426,1240,186,1,185
17669,8865,10287,0,0,37104,,,,,,1,1,7.633064474,19136,8832,8528,304,2,302
17669,10709,10210,2,0,6247,,,,,,1,1,1.287244002,2993,1527,1327,200,0,200
17669,10130,10455,2,2,37343,,,,,,1,1,7.828788015,19337,8852,8550,302,2,300
17669,9463,11486,0,2,10624,,,,,,1,1,2.180744114,5363,2514,2281,233,2,231
17669,10263,10884,1,2,16944,,,,,,1,1,3.471122883,8526,4076,3810,266,0,266
17669,10781,10180,0,0,25320,,,,,,1,1,5.19900951,12713,6157,5864,293,1,292
17669,9395,11549,0,0,7223,,,,,,1,1,1.480546882,3284,1867,1662,205,1,204
17669,11153,9767,4,0,28919,,,,,,1,1,5.957709671,14316,7136,6805,331,10,321
17669,10000,10934,2,0,2464,,,,,,1,1,0.51005695,1063,621,462,159,1,158
17669,9393,7828,0,0,38337,,,,,,1,1,7.87781405,19363,9352,9082,270,3,267
17669,10746,10177,0,0,3764,,,,,,1,1,0.780823061,1710,933,745,188,0,188
17669,9972,10957,0,0,2704,,,,,,1,1,0.560189235,1125,711,554,157,0,157
17669,10888,9079,0,0,37128,,,,,,1,1,7.709488896,18980,8928,8636,292,1,291
17669,9507,11301,3,2,35902,,,,,,1,1,7.399070801,18580,8507,8199,308,2,306
17669,10096,10070,0,2,37108,,,,,,1,1,7.600440745,19012,8891,8577,314,3,311
17669,9610,11311,0,2,6615,,,,,,1,1,1.375228628,3249,1582,1380,202,1,201
17669,9660,10907,0,0,35685,,,,,,1,1,7.528797796,18450,8473,8184,289,0,289
17669,10423,10536,2,2,4729,,,,,,1,1,0.97335296,2195,1178,1000,178,2,176
17669,11003,8909,2,0,37346,,,,,,1,1,7.858277131,18990,9012,8680,332,2,330
17669,10490,9100,0,0,36119,,,,,,1,1,7.537016597,18444,8691,8398,293,3,290
17669,10942,8966,2,0,37954,,,,,,1,1,7.893678748,19119,9261,8948,313,2,311
17669,9207,10964,0,2,35232,,,,,,1,1,7.286016498,18264,8335,8037,298,3,295
17669,10974,9646,2,2,38378,,,,,,1,1,7.833553017,19598,9235,8925,310,5,305
17669,9360,11887,0,0,3800,,,,,,1,1,0.793739218,1782,925,757,168,0,168
17669,9476,11230,0,2,34847,,,,,,1,1,7.1737781,18241,8159,7871,288,8,280
17669,10412,9028,4,2,37547,,,,,,1,1,7.698031369,19211,9005,8679,326,3,323
17669,10908,10084,0,0,2540,,,,,,1,1,0.533911459,1103,644,495,149,0,149
17669,10295,10895,0,0,6705,,,,,,1,1,1.377358896,3212,1639,1424,215,0,215
17669,9218,10993,2,4,34621,,,,,,1,1,7.149133059,18361,7987,7701,286,3,283
17669,9453,11469,0,0,5728,,,,,,1,1,1.255835663,2847,1351,1172,179,0,179
17669,8550,9701,0,2,36506,,,,,,1,1,7.503647529,19213,8510,8237,273,11,262
17669,11478,9494,0,0,2012,,,,,,1,1,0.41767122,828,517,367,150,1,149
17669,9572,10906,0,2,37211,,,,,,1,1,7.787879403,18924,8980,8653,327,3,324
17669,10876,9332,0,0,35003,,,,,,1,1,7.30655732,18286,8219,7940,279,1,278
17669,10011,10511,0,0,37021,,,,,,1,1,7.656029677,18809,8949,8635,314,1,313
17669,10525,10395,2,1,8719,,,,,,1,1,1.7966348669999999,4337,2084,1870,214,3,211
17669,10056,10963,2,0,10472,,,,,,1,1,2.148478073,5087,2575,2340,235,0,235
17669,11558,9364,3,0,3215,,,,,,1,1,0.66172768,1422,819,664,155,0,155
17669,11399,9806,0,0,10655,,,,,,1,1,2.222322786,5285,2564,2322,242,1,241
17669,9250,10740,0,2,37141,,,,,,1,1,7.72053686,18946,8949,8652,297,1,296
17669,10342,9789,3,0,36916,,,,,,1,1,7.597117146,18919,8844,8535,309,4,305
17669,10002,11075,0,0,9605,,,,,,1,1,1.974676134,4650,2361,2128,233,2,231
17669,10798,10125,0,2,7132,,,,,,1,1,1.459739343,3448,1738,1530,208,2,206
17669,9951,11057,2,2,2989,,,,,,1,1,0.626517947,1417,713,567,146,4,142
17669,10679,10614,0,2,8970,,,,,,1,1,1.828504006,4323,2213,1992,221,10,211
17669,11215,8866,2,0,36409,,,,,,1,1,7.712872075,18607,8775,8523,252,5,247
17669,10625,10294,0,0,2762,,,,,,1,1,0.572049241,1215,696,541,155,1,154
17669,10514,10369,0,2,38176,,,,,,1,1,8.028053662,19368,9233,8891,342,1,341
17669,10006,10924,0,0,4366,,,,,,1,1,0.89984117,1978,1091,885,206,0,206
17669,10784,10167,2,0,3056,,,,,,1,1,0.638424521,1338,776,610,166,1,165
17669,10942,10025,0,1,27221,,,,,,1,1,5.724818301,14123,6410,6132,278,1,277
17669,10847,10074,0,0,5376,,,,,,1,1,1.098709267,2496,1342,1146,196,0,196
17669,10598,9623,0,0,34853,,,,,,1,1,7.182309055,18411,8081,7801,280,2,278
17669,11188,9838,4,2,17310,,,,,,1,1,3.588256418,8845,4092,3811,281,10,271
17669,10589,10333,0,0,9846,,,,,,1,1,2.040848549,4786,2412,2176,236,0,236
17669,9892,11028,0,4,10326,,,,,,1,1,2.13727291,5034,2533,2307,226,1,225
17669,10901,10199,0,2,5234,,,,,,1,1,1.059155732,2513,1265,1074,191,3,188
17669,9723,10928,2,0,34576,,,,,,1,1,7.210080253,18059,8124,7855,269,3,266
17669,11495,9126,3,2,35338,,,,,,1,1,7.258055174,18190,8431,8145,286,3,283
17669,10454,9687,4,1,38560,,,,,,1,1,7.899293197,19789,9214,8871,343,25,318
17669,11324,9101,3,0,36990,,,,,,1,1,7.65367735,18994,8848,8548,300,0,300
17669,10826,9781,2,0,37645,,,,,,1,1,7.886744738,19030,9137,8796,341,2,339
17669,9453,9795,0,0,36254,,,,,,1,1,7.632839663,18925,8529,8258,271,4,267
17669,10923,10321,0,0,1863,,,,,,1,1,0.396046653,813,461,333,128,0,128
17669,9712,10758,1,2,36947,,,,,,1,1,7.646972284,18973,8833,8525,308,4,304
17669,9642,9345,0,0,36668,,,,,,1,1,7.54921673,19026,8687,8419,268,3,265
17669,11044,9998,0,0,1639,,,,,,1,1,0.342536638,662,427,304,123,0,123
17669,10727,10478,0,0,1958,,,,,,1,1,0.403629915,794,515,381,134,0,134
17669,9969,10162,4,5,37484,,,,,,1,1,7.752446637,19244,8963,8649,314,13,301
17669,10544,8425,0,0,35850,,,,,,1,1,7.346479452,18326,8630,8366,264,8,256
17669,10382,10026,0,0,37127,,,,,,1,1,7.730252676,18866,8984,8691,293,2,291
17669,10527,10412,2,2,3067,,,,,,1,1,0.630853114,1423,747,597,150,1,149
17669,10020,9149,2,0,37793,,,,,,1,1,7.758485518,19166,9168,8877,291,4,287
17669,9633,10889,2,0,34559,,,,,,1,1,7.274198957,18117,8085,7813,272,5,267
17669,10587,10710,1,4,15674,,,,,,1,1,3.2392723390000002,7723,3845,3584,261,9,252
17669,9961,11081,0,0,5645,,,,,,1,1,1.165831212,2620,1412,1211,201,1,200
17669,9535,11386,0,0,2193,,,,,,1,1,0.4546547,918,568,429,139,0,139
17669,9539,9964,2,2,35571,,,,,,1,1,7.365278488,18482,8388,8075,313,4,309
17669,9802,11120,0,0,7575,,,,,,1,1,1.594202868,3642,1859,1644,215,0,215
17669,10259,10973,2,0,9838,,,,,,1,1,2.030491357,4890,2355,2117,238,0,238
17669,9591,11303,0,0,36598,,,,,,1,1,7.508802254,18512,8882,8560,322,1,321
17669,10244,10679,4,0,14101,,,,,,1,1,2.921908745,7103,3368,3106,262,8,254
17669,10405,9700,0,0,35930,,,,,,1,1,7.491513339,18329,8664,8391,273,3,270
17669,10285,10316,4,0,35552,,,,,,1,1,7.408519511,18574,8350,8072,278,5,273
17669,9104,9819,0,2,37133,,,,,,1,1,7.681682344,18889,8980,8696,284,1,283
17669,9120,9852,0,2,35660,,,,,,1,1,7.339062328,18686,8351,8079,272,1,271
17669,10303,10618,0,2,3572,,,,,,1,1,0.744880152,1659,867,688,179,1,178
17669,10951,10317,4,0,7614,,,,,,1,1,1.5770393660000002,3762,1822,1614,208,12,196
17669,9387,11315,0,0,34570,,,,,,1,1,7.142844133,17775,8252,7961,291,2,289
17669,9276,11403,0,0,37369,,,,,,1,1,7.645054116,18990,9021,8684,337,2,335
17669,10158,10780,0,0,1039,,,,,,1,1,0.218928549,371,281,175,106,0,106
17669,9848,11027,0,0,36463,,,,,,1,1,7.582567694,18605,8783,8491,292,1,291
17669,9960,11048,2,0,3905,,,,,,1,1,0.805403493,1732,979,764,215,0,215
17669,10663,10594,0,4,20970,,,,,,1,1,4.3581760769999995,10574,5061,4787,274,3,271
17669,10078,9989,0,0,35198,,,,,,1,1,7.407902984,18451,8221,7916,305,1,304
17669,8807,10608,0,0,35617,,,,,,1,1,7.359482076,18542,8392,8101,291,4,287
17669,9899,11024,0,0,4222,,,,,,1,1,0.871259078,1819,1101,900,201,0,201
17669,9934,11029,2,0,13324,,,,,,1,1,2.75554834,6486,3286,3020,266,1,265
17669,11160,9551,3,0,35309,,,,,,1,1,7.277239339,18570,8218,7915,303,5,298
17669,10643,10280,0,2,4860,,,,,,1,1,0.999331703,2185,1237,1036,201,0,201
17669,7964,10771,0,0,37179,,,,,,1,1,7.81967537,19094,8896,8603,293,3,290
17669,9555,11398,2,0,1948,,,,,,1,1,0.409718272,855,481,350,131,0,131
17669,10860,10211,0,0,1155,,,,,,1,1,0.256871378,449,302,200,102,0,102
17669,8813,10486,0,4,36955,,,,,,1,1,7.705602689,18954,8856,8567,289,8,281
17669,9328,10888,0,4,35826,,,,,,1,1,7.565925317,18544,8505,8233,272,0,272
17669,10777,9572,0,0,35400,,,,,,1,1,7.45905247,18427,8337,8038,299,4,295
17669,10172,10750,0,0,3195,,,,,,1,1,0.660177694,1499,767,605,162,1,161
17669,9809,11111,4,2,2722,,,,,,1,1,0.562366954,1242,669,527,142,3,139
17669,10680,9779,2,0,36541,,,,,,1,1,7.617030927,18592,8822,8517,305,2,303
17669,10479,10457,0,0,1884,,,,,,1,1,0.401881058,825,465,336,129,0,129
17669,10553,10593,0,0,28175,,,,,,1,1,5.789386009,14398,6747,6464,283,1,282
17669,10890,10031,0,0,5700,,,,,,1,1,1.224272939,2658,1411,1191,220,0,220
17669,11034,10224,0,2,25613,,,,,,1,1,5.221657278,12677,6315,6009,306,1,305
17669,9706,10698,2,0,36655,,,,,,1,1,7.52034996,18703,8812,8484,328,8,320
17669,10826,9259,0,4,36736,,,,,,1,1,7.6557858450000005,18644,8898,8602,296,3,293
17669,8980,9279,2,2,38312,,,,,,1,1,8.006158449,19026,9496,9202,294,5,289
17669,9728,11201,0,0,6044,,,,,,1,1,1.2898870310000001,3010,1419,1223,196,0,196
17669,10213,10708,0,2,5370,,,,,,1,1,1.102890415,2470,1347,1141,206,0,206
17669,10507,10684,0,4,3479,,,,,,1,1,0.723824443,1553,886,732,154,0,154
17669,10637,10297,0,0,4921,,,,,,1,1,1.012753659,2323,1202,1008,194,0,194
17669,11131,10146,2,4,15830,,,,,,1,1,3.378986051,7888,3848,3602,246,4,242
17669,10289,9441,0,0,35461,,,,,,1,1,7.354428391,18788,8195,7912,283,5,278
17669,10474,10448,4,0,3512,,,,,,1,1,0.73842358,1581,881,712,169,5,164
17669,9312,9402,0,4,36524,,,,,,1,1,7.642552291,19328,8468,8208,260,2,258
17669,10845,8230,2,0,39019,,,,,,1,1,7.9805780760000005,19688,9520,9229,291,10,281
17669,9963,11058,0,2,13458,,,,,,1,1,2.894238955,6471,3363,3102,261,7,254
17669,10394,10337,0,0,37798,,,,,,1,1,7.961073287,19184,9145,8821,324,2,322
17669,10335,10756,0,0,12038,,,,,,1,1,2.5770436070000002,5893,2941,2678,263,1,262
17669,9906,9229,0,4,36183,,,,,,1,1,7.617563879,18874,8515,8236,279,4,275
17669,9689,11250,2,0,2169,,,,,,1,1,0.453646185,900,558,405,153,1,152
17669,10549,9811,0,2,35270,,,,,,1,1,7.288247408,18490,8248,7964,284,4,280
17669,10423,10075,0,0,35558,,,,,,1,1,7.3289683310000004,18040,8601,8285,316,0,316
17669,10708,9802,3,2,36366,,,,,,1,1,7.511320651,18366,8846,8538,308,4,304
17669,10509,10578,0,0,4587,,,,,,1,1,0.96199284,2084,1159,974,185,0,185
17669,10940,10272,0,0,1203,,,,,,1,1,0.25357038,496,301,196,105,0,105
17669,9938,10639,0,0,35652,,,,,,1,1,7.560851663,18511,8417,8110,307,3,304
17669,10191,10732,2,0,3635,,,,,,1,1,0.750193535,1653,909,745,164,3,161
17669,10361,10260,2,2,35452,,,,,,1,1,7.338626947,18047,8559,8272,287,4,283
17669,9685,11389,0,0,7174,,,,,,1,1,1.47805866,3388,1788,1578,210,3,207
17669,10422,10382,2,0,36056,,,,,,1,1,7.42218448,18668,8539,8229,310,2,308
17669,9946,9676,2,2,37626,,,,,,1,1,7.835763141,19249,9036,8731,305,8,297
17669,10512,10471,2,2,3670,,,,,,1,1,0.760290557,1675,917,756,161,4,157
17669,10143,10846,3,1,22224,,,,,,1,1,4.574929427,11191,5374,5089,285,6,279
17669,10488,10432,1,0,12832,,,,,,1,1,2.686723821,6642,2981,2753,228,0,228
17669,10916,9003,0,0,36572,,,,,,1,1,7.499298081,18837,8726,8443,283,2,281
17669,8481,10554,0,0,37440,,,,,,1,1,7.845277816,18914,9131,8867,264,2,262
17669,9990,11020,0,4,33185,,,,,,1,1,6.872928077,16914,7973,7648,325,3,322
17669,9115,12094,0,5,24026,,,,,,1,1,5.12593377,12635,5556,5277,279,8,271
17669,11224,9708,0,0,2057,,,,,,1,1,0.429454015,957,478,334,144,0,144
17669,10258,10613,0,0,37648,,,,,,1,1,7.82302478,19061,9129,8800,329,1,328
17669,9070,9613,1,0,36307,,,,,,1,1,7.544915047,18973,8515,8211,304,2,302
17669,10402,10519,0,2,12885,,,,,,1,1,2.633760665,6385,3122,2866,256,5,251
17669,11059,9863,0,3,3342,,,,,,1,1,0.691353757,1506,841,687,154,1,153
17669,10689,8501,2,0,35913,,,,,,1,1,7.428256594,18800,8424,8159,265,2,263
17669,10697,10226,0,0,5778,,,,,,1,1,1.225591808,2887,1347,1150,197,2,195
17669,10716,9284,0,0,35902,,,,,,1,1,7.403401316,18643,8477,8172,305,3,302
17669,10397,10543,0,0,2134,,,,,,1,1,0.443217051,866,561,415,146,0,146
17669,10500,10426,0,2,3657,,,,,,1,1,0.7585816,1696,892,715,177,1,176
17669,10067,10855,0,0,1516,,,,,,1,1,0.317937189,627,386,269,117,1,116
17669,9228,10249,0,1,36120,,,,,,1,1,7.445007637,18775,8532,8251,281,0,281
17669,9514,11410,0,0,2694,,,,,,1,1,0.556961936,1178,677,515,162,0,162
17669,9154,10978,0,0,37638,,,,,,1,1,7.840862467,18995,9162,8843,319,2,317
17669,9803,8757,0,0,38815,,,,,,1,1,7.909463155,19362,9577,9278,299,1,298
17669,10772,10211,0,0,8256,,,,,,1,1,1.7053754030000001,3982,2028,1810,218,0,218
17669,10793,10214,0,0,4093,,,,,,1,1,0.843611857,1911,1004,830,174,2,172
17669,10038,10917,2,2,13748,,,,,,1,1,2.8557907350000002,7054,3219,2963,256,1,255
17669,9158,10676,0,0,36586,,,,,,1,1,7.60123616,19037,8626,8329,297,1,296
17669,9662,11471,2,0,2742,,,,,,1,1,0.569273035,1181,700,539,161,2,159
17669,10229,9893,2,0,36034,,,,,,1,1,7.363058328,18687,8510,8183,327,2,325
17669,11020,10016,0,2,8366,,,,,,1,1,1.726207888,4084,2037,1829,208,0,208
17669,9784,11135,0,2,35316,,,,,,1,1,7.276682139,18127,8436,8119,317,1,316
17669,9544,11344,2,2,36223,,,,,,1,1,7.441160383,18912,8500,8189,311,1,310
17669,9404,11104,0,0,35757,,,,,,1,1,7.366724985,18576,8434,8121,313,1,312
17669,10437,10638,0,0,5015,,,,,,1,1,1.077264473,2280,1275,1090,185,0,185
17669,11246,9928,2,0,4869,,,,,,1,1,1.014824969,2141,1258,1046,212,1,211
17669,10271,8485,0,0,38472,,,,,,1,1,7.957502669,19271,9459,9176,283,3,280
17669,10493,10426,0,0,32280,,,,,,1,1,6.673993126,17046,7477,7197,280,1,279
17669,10989,9934,0,0,17597,,,,,,1,1,3.6424918059999998,8913,4199,3913,286,0,286
17669,10010,11279,0,2,2834,,,,,,1,1,0.627997307,1193,739,576,163,1,162
17669,9548,10312,0,0,35474,,,,,,1,1,7.290098257,18558,8310,8014,296,3,293
17669,10638,10382,0,0,3071,,,,,,1,1,0.638978008,1345,777,605,172,0,172
17669,10053,10978,0,2,3096,,,,,,1,1,0.642910137,1348,801,655,146,2,144
17669,10720,10302,2,2,25896,,,,,,1,1,5.420567359,13247,6184,5903,281,3,278
17669,10806,10116,0,0,1921,,,,,,1,1,0.400057633,838,481,360,121,0,121
17669,10281,10371,4,2,35718,,,,,,1,1,7.381838248,18639,8393,8100,293,3,290
17669,9873,11310,0,0,16846,,,,,,1,1,3.513560471,8348,4120,3862,258,0,258
17669,9008,8830,0,0,38042,,,,,,1,1,7.866871394,19322,9205,8895,310,2,308
17669,11026,9896,0,0,1956,,,,,,1,1,0.40960036,843,487,348,139,1,138
17669,10686,10255,0,0,3032,,,,,,1,1,0.625894502,1342,767,611,156,0,156
17669,10306,9920,0,0,35492,,,,,,1,1,7.486541609,18580,8306,8006,300,6,294
17669,10509,10416,4,0,4225,,,,,,1,1,0.891048646,1979,1035,859,176,2,174
17669,10576,9802,1,0,35240,,,,,,1,1,7.409072177,18482,8232,7938,294,1,293
17669,10183,10549,2,0,36550,,,,,,1,1,7.596309822,18886,8673,8355,318,4,314
17669,9137,10221,3,0,36356,,,,,,1,1,7.576050267,18672,8695,8401,294,4,290
17669,10251,10668,0,0,9795,,,,,,1,1,2.007147862,4863,2356,2136,220,0,220
17669,9790,11164,2,0,7691,,,,,,1,1,1.579873409,3675,1908,1708,200,2,198
17669,9668,10712,4,0,38509,,,,,,1,1,7.977095003,19148,9526,9217,309,10,299
17669,9334,9937,2,2,37051,,,,,,1,1,7.754187432,18997,8896,8634,262,1,261
17669,10663,10608,0,0,2845,,,,,,1,1,0.585868429,1244,727,580,147,0,147
17669,10982,9950,4,0,2233,,,,,,1,1,0.466133523,953,563,409,154,0,154
17669,10640,10288,2,0,3564,,,,,,1,1,0.749213573,1635,882,717,165,0,165
17669,11120,9979,0,2,3077,,,,,,1,1,0.635992316,1358,783,630,153,3,150
17669,11192,9441,0,2,35769,,,,,,1,1,7.353607365,18446,8507,8198,309,2,307
17669,9819,11106,0,0,1894,,,,,,1,1,0.394548578,848,462,340,122,0,122
17669,11692,9228,0,0,6269,,,,,,1,1,1.296052733,2981,1537,1323,214,0,214
17669,9504,10335,0,0,35900,,,,,,1,1,7.382279633,18896,8362,8082,280,1,279
17669,10290,8099,0,0,36591,,,,,,1,1,7.514276611,18740,8797,8540,257,0,257
17669,8807,10122,0,2,35125,,,,,,1,1,7.299401387,18385,8243,7989,254,7,247
17669,9877,10511,0,0,36416,,,,,,1,1,7.5798543689999995,18866,8628,8334,294,1,293
17669,10013,10479,0,2,35495,,,,,,1,1,7.540483334,18329,8428,8118,310,4,306
17669,10801,10191,0,0,1531,,,,,,1,1,0.319171139,639,385,263,122,0,122
17669,10178,10742,0,3,11380,,,,,,1,1,2.338012361,5687,2719,2464,255,7,248
17669,9900,10264,2,0,35811,,,,,,1,1,7.491314052,18335,8600,8324,276,0,276
17669,10476,10432,0,0,37549,,,,,,1,1,7.687135348,19051,9091,8775,316,4,312
17669,10508,10422,2,0,6861,,,,,,1,1,1.432220404,3306,1678,1479,199,0,199
17669,10098,9364,0,2,36591,,,,,,1,1,7.56709216,19004,8648,8357,291,3,288
17669,10511,10429,0,0,1531,,,,,,1,1,0.33664664,629,390,268,122,0,122
17669,10494,10438,1,1,33763,,,,,,1,1,7.058689101,17597,7937,7645,292,4,288
17669,10413,10261,2,0,36076,,,,,,1,1,7.423894034,18561,8621,8348,273,1,272
17669,10792,9939,0,2,35687,,,,,,1,1,7.434972512,18907,8242,7946,296,0,296
17669,10379,10159,4,0,37616,,,,,,1,1,7.697220322,19288,9011,8705,306,0,306
17669,11629,9182,2,0,35842,,,,,,1,1,7.411786674,18576,8493,8213,280,6,274
17669,10508,10596,2,0,4318,,,,,,1,1,0.90473088,1997,1069,886,183,0,183
17669,9775,10021,0,0,34492,,,,,,1,1,7.179452979,18073,8073,7800,273,5,268
17669,10838,9737,0,2,35640,,,,,,1,1,7.376854054,18523,8415,8128,287,4,283
17669,9081,9745,0,2,36073,,,,,,1,1,7.411359134,18432,8685,8414,271,2,269
17669,10397,10724,0,0,2758,,,,,,1,1,0.572989019,1266,669,515,154,0,154
17669,10521,9685,0,0,36421,,,,,,1,1,7.486717097,18476,8820,8515,305,4,301
17669,11128,9233,1,0,35764,,,,,,1,1,7.404057706,18668,8392,8080,312,6,306
17669,8993,10510,0,3,38726,,,,,,1,1,7.96043447,19467,9478,9175,303,1,302
17669,9381,11545,0,4,5837,,,,,,1,1,1.210903504,2736,1449,1246,203,12,191
17669,9068,10875,0,3,35458,,,,,,1,1,7.33532786,18651,8256,7961,295,12,283
17669,9721,9170,2,0,36901,,,,,,1,1,7.60585865,19082,8763,8470,293,16,277
17669,10639,10552,4,2,11214,,,,,,1,1,2.318625839,5688,2650,2424,226,1,225
17669,10316,10847,4,0,26156,,,,,,1,1,5.404684999,13159,6333,6002,331,0,331
17669,9830,10828,2,0,33647,,,,,,1,1,7.019187062,18137,7619,7347,272,4,268
17669,11337,9669,0,0,4605,,,,,,1,1,0.943936166,2127,1151,975,176,0,176
17669,10687,9102,0,0,36352,,,,,,1,1,7.439585977,18543,8764,8483,281,3,278
17669,9471,10492,2,2,36851,,,,,,1,1,7.724442892,18835,8871,8597,274,1,273
17669,10901,10123,0,0,3980,,,,,,1,1,0.826129302,1850,987,831,156,0,156
17669,10653,9786,2,0,37801,,,,,,1,1,7.806276442,18985,9251,8937,314,2,312
17669,11101,9828,0,0,6388,,,,,,1,1,1.3285312,3080,1554,1354,200,2,198
17669,9756,11167,2,0,1993,,,,,,1,1,0.419214301,886,472,309,163,0,163
17669,10436,10417,0,0,36686,,,,,,1,1,7.685578156,18516,8924,8602,322,1,321
17669,11573,8990,0,1,37105,,,,,,1,1,7.715813125,18799,8995,8679,316,2,314
17669,11133,9789,0,0,14537,,,,,,1,1,2.992837126,7209,3540,3292,248,0,248
17669,9813,11108,2,0,3343,,,,,,1,1,0.690717887,1511,827,649,178,3,175
17669,9543,9257,0,0,36590,,,,,,1,1,7.478096996,18765,8770,8485,285,2,283
17669,9960,10091,4,2,36589,,,,,,1,1,7.647640856,18662,8814,8515,299,3,296
17669,9510,10899,0,0,37141,,,,,,1,1,7.785138731,18874,8983,8682,301,2,299
17669,10404,10730,0,2,2270,,,,,,1,1,0.475798467,939,597,460,137,0,137
17669,10736,9657,2,2,35503,,,,,,1,1,7.346995094,18377,8410,8104,306,3,303
17669,9737,9330,0,0,37874,,,,,,1,1,7.874589327,19277,9151,8856,295,1,294
17669,10293,9605,0,2,37761,,,,,,1,1,7.7406981120000005,19317,9069,8763,306,18,288
17669,9576,10267,2,0,36039,,,,,,1,1,7.489348316,18837,8450,8148,302,5,297
17669,10092,9487,3,0,36355,,,,,,1,1,7.548660384,18820,8617,8316,301,1,300
17669,9830,11096,2,0,5907,,,,,,1,1,1.221642473,2835,1435,1233,202,2,200
17669,10999,9018,3,0,36594,,,,,,1,1,7.684632218,19242,8519,8205,314,2,312
17669,9421,10205,2,0,36769,,,,,,1,1,7.623271219,18947,8751,8431,320,3,317
17669,8738,10186,0,1,37908,,,,,,1,1,7.851850297,19390,9134,8884,250,3,247
17669,9998,9898,0,0,36051,,,,,,1,1,7.471596864,18724,8507,8194,313,4,309
17669,8963,10282,0,2,34445,,,,,,1,1,7.135783826,18487,7859,7619,240,1,239
17669,11511,9656,0,4,32957,,,,,,1,1,6.918920894,17328,7682,7417,265,4,261
17669,11065,9689,6,2,37287,,,,,,1,1,7.627564836,18978,9001,8694,307,1,306
17669,10141,9952,3,0,36007,,,,,,1,1,7.482881066,18468,8613,8300,313,1,312
17669,10352,10567,0,0,9310,,,,,,1,1,1.9696399279999999,4537,2273,2046,227,2,225
17669,10337,10610,2,0,10071,,,,,,1,1,2.09953819,4854,2486,2241,245,2,243
17669,10481,10440,0,0,3746,,,,,,1,1,0.771003053,1663,949,764,185,0,185
17669,11261,9678,0,2,7082,,,,,,1,1,1.4557177590000001,3235,1812,1589,223,3,220
17669,9251,8511,3,0,38414,,,,,,1,1,7.889553358,19662,9254,9010,244,1,243
17669,8287,11605,0,2,36763,,,,,,1,1,7.637206996,18767,8847,8545,302,6,296
17669,11076,9856,0,4,2695,,,,,,1,1,0.616549063,1123,711,561,150,5,145
17669,11093,10186,0,0,3921,,,,,,1,1,0.910371129,1828,958,781,177,0,177
17669,9535,11402,2,0,3442,,,,,,1,1,0.711193068,1581,843,668,175,0,175
17669,9319,10977,0,4,36552,,,,,,1,1,7.51471009,19012,8606,8278,328,3,325
17669,8687,10486,0,2,38027,,,,,,1,1,7.812848695,18998,9360,9051,309,2,307
17669,9993,10936,0,2,6284,,,,,,1,1,1.292053721,2899,1583,1364,219,1,218
17669,10838,10081,2,2,22971,,,,,,1,1,4.750229172,11561,5566,5288,278,3,275
17669,10952,10001,2,0,6111,,,,,,1,1,1.248253361,2779,1562,1354,208,0,208
17669,9973,9138,4,0,35565,,,,,,1,1,7.373545466,18348,8475,8208,267,2,265
17669,10569,10535,0,0,5515,,,,,,1,1,1.142269929,2572,1375,1182,193,0,193
17669,10643,10276,0,2,26172,,,,,,1,1,5.379790099,13273,6297,5992,305,15,290
17669,9199,11720,0,0,5225,,,,,,1,1,1.094686574,2505,1263,1069,194,0,194
17669,10549,9468,2,4,36503,,,,,,1,1,7.508758014,19000,8612,8333,279,7,272
17669,9253,11667,2,0,18948,,,,,,1,1,3.9297441539999998,9394,4641,4369,272,12,260
17669,10803,9932,0,4,35788,,,,,,1,1,7.41717983,18769,8369,8088,281,2,279
17669,10382,9607,2,0,35649,,,,,,1,1,7.33610399,18576,8379,8064,315,2,313
17669,8555,10889,0,0,37356,,,,,,1,1,7.795240216,19068,8989,8679,310,10,300
17669,10351,10897,0,3,28447,,,,,,1,1,5.906591842,14897,6625,6325,300,0,300
17669,10234,10686,0,0,3775,,,,,,1,1,0.786075958,1712,946,775,171,0,171
17669,10084,9240,0,4,38840,,,,,,1,1,8.121169164,19347,9600,9307,293,4,289
17669,10507,8899,0,2,37331,,,,,,1,1,7.720704584,19189,8930,8648,282,4,278
17669,10619,10302,0,0,5856,,,,,,1,1,1.207626184,2834,1416,1226,190,0,190
17669,10951,9302,1,0,35791,,,,,,1,1,7.424478872,18221,8639,8347,292,2,290
17669,9771,8009,0,0,38457,,,,,,1,1,8.054854097,19640,9278,9017,261,3,258
17669,9177,10075,2,0,35319,,,,,,1,1,7.349344469,18350,8351,8084,267,1,266
17669,10611,9278,2,0,35285,,,,,,1,1,7.268246958,18625,8194,7922,272,4,268
17669,9294,9708,0,3,36879,,,,,,1,1,7.588614768,19032,8779,8490,289,5,284
17669,10825,10137,2,1,22616,,,,,,1,1,4.714264133,11299,5496,5171,325,2,323
17669,9838,9070,2,2,35613,,,,,,1,1,7.533573414,18669,8346,8094,252,7,245
17669,10428,10531,0,0,1084,,,,,,1,1,0.229226587,405,285,176,109,0,109
17669,9466,9714,0,0,37721,,,,,,1,1,7.753845574,19164,9138,8857,281,0,281
17669,9748,9048,0,4,35817,,,,,,1,1,7.389012368,18928,8303,8020,283,11,272
17669,10121,10820,0,4,4857,,,,,,1,1,1.004872443,2230,1233,1072,161,2,159
17669,10534,9451,6,0,36432,,,,,,1,1,7.570450405,18982,8582,8296,286,1,285
17669,10063,10085,2,2,37463,,,,,,1,1,7.689846862,19163,8990,8670,320,7,313
17669,9813,11107,0,2,20311,,,,,,1,1,4.2277853069999995,10280,4868,4573,295,4,291
17669,9501,10378,1,0,39775,,,,,,1,1,8.307167045,19741,9843,9495,348,1,347
17669,10473,10819,0,0,4824,,,,,,1,1,1.025613215,2224,1202,1006,196,0,196
17669,10940,9980,0,0,2522,,,,,,1,1,0.525892441,1090,640,488,152,0,152
17669,10888,10031,0,0,2453,,,,,,1,1,0.522666112,1074,614,463,151,0,151
17669,10001,10400,2,0,37450,,,,,,1,1,7.68496825,18941,9102,8797,305,0,305
17669,11433,9495,4,0,6110,,,,,,1,1,1.256223728,2920,1494,1292,202,2,200
17669,10298,9615,2,0,35590,,,,,,1,1,7.378225097,18351,8471,8174,297,2,295
17669,10633,10286,2,2,6811,,,,,,1,1,1.402947027,3287,1656,1444,212,6,206
17669,10778,10141,2,0,10416,,,,,,1,1,2.146680518,5155,2520,2299,221,1,220
17669,10446,9804,2,0,37211,,,,,,1,1,7.643145215,19089,8918,8632,286,5,281
17669,10775,10145,0,0,2850,,,,,,1,1,0.590720518,1235,736,593,143,0,143
17669,10413,10508,4,0,9130,,,,,,1,1,1.908722287,4497,2202,1973,229,1,228
17669,10574,10374,0,0,1946,,,,,,1,1,0.408000804,845,486,357,129,0,129
17669,9381,11765,0,4,16291,,,,,,1,1,3.470401375,8390,3834,3601,233,1,232
17669,11318,9647,0,4,7522,,,,,,1,1,1.6495320169999999,3534,1883,1661,222,3,219
17669,9812,10591,0,0,35747,,,,,,1,1,7.450743452,18791,8322,8010,312,2,310
17669,10200,10546,0,0,37631,,,,,,1,1,7.820074926,19281,9020,8710,310,1,309
17669,10152,10133,0,2,36080,,,,,,1,1,7.462352786,18684,8552,8260,292,3,289
17669,10695,10225,0,0,2187,,,,,,1,1,0.453455135,962,542,401,141,0,141
17669,10169,10384,0,1,36246,,,,,,1,1,7.452956305,18746,8595,8285,310,0,310
17669,10779,9900,3,0,35632,,,,,,1,1,7.403683412,18493,8420,8121,299,1,298
17669,9274,10514,0,2,35817,,,,,,1,1,7.423710874,18404,8564,8279,285,2,283
17669,9704,11220,0,0,5723,,,,,,1,1,1.189170711,2702,1402,1185,217,0,217
17669,10561,10036,0,0,35819,,,,,,1,1,7.366654666,18305,8607,8307,300,2,298
17669,10533,10043,3,2,37046,,,,,,1,1,7.571465061,18786,8965,8635,330,3,327
17669,11006,9914,0,0,2293,,,,,,1,1,0.475367822,1017,561,407,154,0,154
17669,10788,9178,0,3,36200,,,,,,1,1,7.488357406,18557,8653,8316,337,9,328
17669,9466,11593,0,2,17530,,,,,,1,1,3.593811181,8899,4173,3888,285,1,284
17669,11090,10004,0,0,8993,,,,,,1,1,1.842386238,4376,2189,1950,239,0,239
17669,10703,10237,2,0,2417,,,,,,1,1,0.499263361,1064,597,438,159,2,157
17669,9940,9956,0,0,36836,,,,,,1,1,7.56082399,18698,8916,8610,306,2,304
17669,11187,9733,0,0,3936,,,,,,1,1,0.818329688,1716,1016,828,188,0,188
17669,9684,11320,0,4,5552,,,,,,1,1,1.142689232,2600,1378,1182,196,10,186
17669,11189,9742,0,4,3480,,,,,,1,1,0.717888093,1584,868,708,160,0,160
17669,9040,11463,0,0,35001,,,,,,1,1,7.431793425,18480,8116,7827,289,8,281
17669,10365,10221,0,2,36271,,,,,,1,1,7.512457395,18537,8733,8465,268,4,264
17669,9280,10307,0,4,38327,,,,,,1,1,8.006960648,19244,9407,9138,269,3,266
17669,10210,9359,3,2,37083,,,,,,1,1,7.762115363,18789,8992,8682,310,5,305
17669,10903,9988,2,2,34167,,,,,,1,1,7.144834395,17745,8057,7749,308,6,302
17669,9852,10981,2,8,38323,,,,,,1,1,7.98714924,19373,9305,8965,340,17,323
17669,10297,10622,2,2,16894,,,,,,1,1,3.485901277,8583,4024,3761,263,8,255
17669,10496,9551,2,0,35844,,,,,,1,1,7.386099861,18628,8458,8158,300,6,294
17669,9258,11466,0,2,36248,,,,,,1,1,7.476941931,18445,8750,8447,303,5,298
17669,10599,10327,0,2,7197,,,,,,1,1,1.473568467,3465,1762,1554,208,1,207
17669,10342,10668,2,2,6808,,,,,,1,1,1.430578266,3381,1606,1391,215,4,211
17669,10708,9109,6,4,34933,,,,,,1,1,7.252101027,17986,8348,8097,251,8,243
17669,10620,10299,0,0,5718,,,,,,1,1,1.172170984,2700,1409,1209,200,0,200
17669,10592,9509,2,0,36316,,,,,,1,1,7.468568594,18724,8656,8376,280,4,276
17669,10836,10090,0,2,13591,,,,,,1,1,2.7814003940000003,6686,3331,3088,243,4,239
17669,11232,9847,0,0,2884,,,,,,1,1,0.596644065,1338,701,557,144,1,143
17669,8873,9408,1,2,37275,,,,,,1,1,7.645092265,19213,8901,8641,260,1,259
17669,9259,10218,0,0,37643,,,,,,1,1,7.784244302,19441,8955,8663,292,3,289
17669,9587,8730,0,0,37325,,,,,,1,1,7.824565882,19015,9009,8717,292,3,289
17669,9648,11297,0,2,1416,,,,,,1,1,0.372215424,543,374,249,125,0,125
17669,10245,10681,0,2,2463,,,,,,1,1,0.509145345,1031,637,479,158,1,157
17669,11208,9783,0,0,1257,,,,,,1,1,0.266639503,505,316,196,120,0,120
17669,9916,10729,0,2,35746,,,,,,1,1,7.360015546,18619,8428,8157,271,3,268
17669,10887,10038,0,0,15152,,,,,,1,1,3.108979019,7565,3674,3435,239,1,238
17669,10715,9479,0,2,36729,,,,,,1,1,7.582422686,19092,8643,8292,351,6,345
17669,10634,9222,2,0,39677,,,,,,1,1,8.127987858000001,19899,9713,9361,352,0,352
17669,11195,9372,0,2,34593,,,,,,1,1,7.240740105,18091,8091,7771,320,11,309
17669,11429,8548,3,0,36824,,,,,,1,1,7.711474292,18884,8822,8526,296,2,294
17669,9989,10379,0,0,36000,,,,,,1,1,7.460421137,18647,8514,8189,325,2,323
17669,11337,8526,2,1,37476,,,,,,1,1,7.729853207,18967,9109,8818,291,2,289
17669,9995,10545,2,2,36436,,,,,,1,1,7.587051875,18822,8658,8360,298,2,296
17669,10357,10320,5,0,37957,,,,,,1,1,7.761869379,18999,9325,9017,308,5,303
17669,10824,10221,2,0,5077,,,,,,1,1,1.047628058,2428,1229,1038,191,2,189
17669,10316,10604,0,0,14186,,,,,,1,1,2.991999754,7250,3339,3081,258,2,256
17669,10505,10673,0,4,22170,,,,,,1,1,4.564688448,11389,5254,4981,273,1,272
17669,10572,10050,0,2,35572,,,,,,1,1,7.533107802,18503,8384,8083,301,3,298
17669,10750,10220,0,3,11299,,,,,,1,1,2.318125202,5524,2775,2550,225,0,225
17669,10540,10379,0,0,2236,,,,,,1,1,0.48628994,1014,544,410,134,0,134
17669,9481,11583,2,0,12633,,,,,,1,1,2.595611019,6312,3041,2802,239,1,238
17669,10788,9304,4,2,35782,,,,,,1,1,7.443888916,18534,8488,8216,272,1,271
17669,8957,10269,0,0,36456,,,,,,1,1,7.572719291,18870,8641,8337,304,2,302
17669,8674,11416,0,2,37665,,,,,,1,1,7.767407972,19045,9153,8839,314,5,309
17669,9712,7907,0,0,38698,,,,,,1,1,7.916398259,19756,9334,9060,274,0,274
17669,9726,11194,0,0,2166,,,,,,1,1,0.448969758,922,550,406,144,1,143
17669,9785,11144,0,0,2566,,,,,,1,1,0.540485869,1102,646,474,172,1,171
17669,10369,10482,0,4,35887,,,,,,1,1,7.44265273,18745,8422,8124,298,1,297
17669,9853,11116,0,0,882,,,,,,1,1,0.188571739,309,237,138,99,0,99
17669,10280,9746,0,2,36641,,,,,,1,1,7.567032002,18779,8788,8502,286,2,284
17669,9667,9498,0,4,36405,,,,,,1,1,7.504240651,18959,8587,8315,272,0,272
17669,11001,9920,0,1,4174,,,,,,1,1,0.88339406,1959,1018,839,179,0,179
17669,9844,11086,0,0,2568,,,,,,1,1,0.542648066,1098,645,465,180,0,180
17669,10923,10001,2,0,3607,,,,,,1,1,0.747632203,1595,915,733,182,3,179
17669,8617,10954,0,0,36449,,,,,,1,1,7.552510945,18852,8664,8395,269,0,269
17669,10137,9631,0,0,35032,,,,,,1,1,7.249355729,18262,8264,8022,242,0,242
17669,10946,10082,2,2,2069,,,,,,1,1,0.434546664,911,511,375,136,4,132
17669,9136,9123,2,1,38897,,,,,,1,1,8.005556931,19813,9384,9068,316,5,311
17669,7981,8355,0,0,39444,,,,,,1,1,8.095372762,19977,9607,9354,253,2,251
17669,10570,9536,2,2,37885,,,,,,1,1,7.865246432,19115,9222,8896,326,2,324
17669,9633,10520,2,2,36149,,,,,,1,1,7.5005249,18860,8498,8205,293,8,285
17669,8118,11337,0,3,39270,,,,,,1,1,8.036709713,19457,9736,9395,341,9,332
17669,10628,10177,0,0,34827,,,,,,1,1,7.239505846,18196,8151,7822,329,0,329
17669,10584,10357,0,0,2129,,,,,,1,1,0.441963654,912,535,388,147,0,147
17669,10852,9485,4,0,35994,,,,,,1,1,7.512295835,18628,8545,8269,276,3,273
17669,10959,10023,0,2,18731,,,,,,1,1,3.883526377,9036,4689,4372,317,4,313
17669,10481,10230,0,0,38607,,,,,,1,1,7.876389404,19191,9543,9213,330,1,329
17669,10122,10832,0,0,3783,,,,,,1,1,0.812973227,1764,920,741,179,0,179
17669,9980,11276,0,0,4265,,,,,,1,1,0.931372045,2036,1021,834,187,0,187
17669,10305,10621,2,3,11392,,,,,,1,1,2.4070234839999998,5491,2835,2604,231,4,227
17669,10332,10776,0,0,5626,,,,,,1,1,1.1541894,2652,1382,1172,210,0,210
17669,10468,10452,0,0,23813,,,,,,1,1,4.899685621,11904,5807,5512,295,1,294
17669,10261,10691,0,0,787,,,,,,1,1,0.169336485,268,214,123,91,0,91
17669,10590,10650,0,0,3698,,,,,,1,1,0.769291578,1633,934,737,197,0,197
17669,9564,11581,2,2,23448,,,,,,1,1,4.875149545,12048,5567,5301,266,2,264
17669,9991,10945,0,0,19877,,,,,,1,1,4.165397753,9802,4906,4643,263,0,263
17669,11017,9905,0,2,11465,,,,,,1,1,2.365667504,5814,2707,2470,237,0,237
17669,11181,9757,0,0,1630,,,,,,1,1,0.339762654,662,422,298,124,0,124
17669,10120,11043,0,2,3865,,,,,,1,1,0.81801516,1769,969,811,158,2,156
17669,10591,10337,0,0,2458,,,,,,1,1,0.534484318,1125,589,434,155,0,155
17669,10249,10018,0,4,36733,,,,,,1,1,7.517800221,18658,8881,8568,313,2,311
17669,10374,9215,2,0,38101,,,,,,1,1,7.957880371,19550,9129,8836,293,2,291
17669,10916,10017,0,0,4150,,,,,,1,1,0.98600072,1947,1012,833,179,0,179
17669,9352,10099,2,0,36266,,,,,,1,1,7.556889804,18765,8608,8323,285,5,280
17669,11745,9323,2,0,31814,,,,,,1,1,6.693449161,16561,7486,7205,281,2,279
17669,9993,10965,0,2,27347,,,,,,1,1,5.793117648,13665,6702,6424,278,1,277
17669,10430,10494,0,0,3053,,,,,,1,1,0.63333589,1291,790,608,182,0,182
17669,10024,8202,2,0,37818,,,,,,1,1,7.778699736,19352,9111,8867,244,5,239
17669,8779,9262,0,3,38854,,,,,,1,1,7.967082176,19543,9528,9273,255,1,254
17669,11604,8925,3,0,36433,,,,,,1,1,7.704689656,18389,8881,8599,282,0,282
17669,9688,11273,2,2,28392,,,,,,1,1,5.889700731,14625,6717,6384,333,3,330
17669,10204,10221,0,0,35370,,,,,,1,1,7.44745286,18365,8343,8024,319,4,315
17669,10588,9348,4,2,38757,,,,,,1,1,8.027208229,19690,9382,9079,303,5,298
17669,10017,10096,0,4,38490,,,,,,1,1,7.86987892,19690,9245,8935,310,0,310
17669,8175,11577,2,5,36531,,,,,,1,1,7.638776336,18842,8712,8447,265,5,260
17669,9339,10759,0,0,35179,,,,,,1,1,7.334539993,18386,8249,7954,295,2,293
17669,9851,10557,2,0,35288,,,,,,1,1,7.327812332,18354,8330,8056,274,0,274
17669,7995,9070,4,2,37130,,,,,,1,1,7.74606936,19005,8938,8689,249,3,246
17669,11669,9250,0,0,17386,,,,,,1,1,3.571833369,8316,4407,4151,256,2,254
17669,10229,10695,2,0,2959,,,,,,1,1,0.62155891,1318,741,582,159,0,159
17669,9823,10518,0,0,33617,,,,,,1,1,7.096315279,17883,7726,7444,282,1,281
17669,10937,9611,2,0,34199,,,,,,1,1,7.094279374,18132,7883,7582,301,0,301
17669,10012,10814,6,2,35306,,,,,,1,1,7.391747946,18126,8438,8134,304,13,291
17669,9729,11350,0,0,6652,,,,,,1,1,1.364040969,3219,1598,1361,237,1,236
17669,9885,11360,0,0,3141,,,,,,1,1,0.645553401,1380,793,618,175,0,175
17669,9485,9459,2,0,37087,,,,,,1,1,7.669384142,18804,9007,8738,269,1,268
17669,11071,8738,0,0,36993,,,,,,1,1,7.574647901,18760,8954,8629,325,3,322
17669,9560,9700,0,2,37048,,,,,,1,1,7.590473797,18988,8885,8595,290,9,281
17669,9973,10946,0,2,32764,,,,,,1,1,6.945336006,16855,7798,7485,313,13,300
17669,10499,10445,0,0,3157,,,,,,1,1,0.652016101,1358,807,622,185,0,185
17669,10556,10273,2,0,36526,,,,,,1,1,7.629407504,18642,8793,8495,298,1,297
17669,10378,9698,0,0,36886,,,,,,1,1,7.615655836,19079,8747,8434,313,0,313
17669,11254,9667,0,2,7111,,,,,,1,1,1.461316222,3405,1740,1514,226,0,226
17669,9973,10979,0,0,1966,,,,,,1,1,0.41073303,830,497,355,142,0,142
17669,10234,9841,2,0,37613,,,,,,1,1,7.746568427,19214,9032,8697,335,7,328
17669,11183,10118,0,4,25359,,,,,,1,1,5.209894866,12928,6071,5782,289,6,283
17669,10094,10775,4,0,35614,,,,,,1,1,7.454923508,18651,8344,8069,275,3,272
17669,9173,8282,0,0,36694,,,,,,1,1,7.688425054,19004,8713,8449,264,0,264
17669,10202,10901,0,2,6784,,,,,,1,1,1.3895905929999999,3190,1694,1488,206,0,206
17669,9953,10013,0,5,38044,,,,,,1,1,7.877239798,19489,9120,8805,315,8,307
17669,11034,10146,2,2,11172,,,,,,1,1,2.367342062,5378,2776,2534,242,2,240
17669,9493,10626,0,0,35180,,,,,,1,1,7.258412526,18361,8257,7952,305,3,302
17669,9887,10698,0,0,36447,,,,,,1,1,7.636244795,18519,8801,8475,326,5,321
17669,10459,9882,0,3,36197,,,,,,1,1,7.546313126,18724,8591,8300,291,4,287
17669,9850,11219,0,2,28755,,,,,,1,1,5.937382926,14837,6820,6542,278,3,275
17669,9878,10271,0,0,36167,,,,,,1,1,7.453259579,18759,8568,8296,272,2,270
17669,10364,9734,0,0,35203,,,,,,1,1,7.369708757,18372,8266,7967,299,3,296
17669,8639,9996,0,11,37430,,,,,,1,1,7.765855071,19114,9023,8753,270,4,266
17669,8881,10197,0,0,39496,,,,,,1,1,8.082913472,19972,9608,9300,308,0,308
17669,10465,10646,0,0,4381,,,,,,1,1,0.903796386,2040,1077,890,187,1,186
17669,10239,7962,0,0,36555,,,,,,1,1,7.592230956,19165,8563,8299,264,4,260
17669,9507,10574,0,2,38636,,,,,,1,1,8.063271979,19559,9392,9099,293,7,286
17669,10738,9025,4,0,34810,,,,,,1,1,7.282240674,18458,8036,7756,280,6,274
17669,7595,9782,0,1,39131,,,,,,1,1,8.078471116,19842,9501,9214,287,2,285
17669,9324,11229,4,0,33532,,,,,,1,1,7.02160257,17670,7786,7496,290,5,285
17669,10733,10136,3,0,36940,,,,,,1,1,7.59537579,19006,8803,8475,328,5,323
17669,10564,10371,0,0,2637,,,,,,1,1,0.542796478,1105,684,520,164,0,164
17669,8269,10987,0,2,36999,,,,,,1,1,7.634387551,19012,8858,8587,271,2,269
17669,10407,9901,0,0,36664,,,,,,1,1,7.513096977,18883,8726,8397,329,1,328
17669,9721,11209,0,0,6184,,,,,,1,1,1.338020056,2997,1492,1289,203,0,203
17669,9798,11123,2,0,5055,,,,,,1,1,1.03807501,2358,1251,1056,195,1,194
17669,10933,9992,5,0,8356,,,,,,1,1,1.736750454,3942,2100,1886,214,2,212
17669,10849,10182,0,2,7894,,,,,,1,1,1.633903184,3922,1880,1668,212,6,206
17669,8962,10956,0,0,38065,,,,,,1,1,7.924946498,18913,9429,9135,294,1,293
17669,11006,10088,0,0,4553,,,,,,1,1,0.960877672,2093,1136,948,188,0,188
17669,11156,9635,0,2,35590,,,,,,1,1,7.389857099,18118,8589,8295,294,2,292
17669,9148,11160,0,0,35972,,,,,,1,1,7.421758619,18683,8501,8214,287,1,286
17669,11172,9025,0,0,35616,,,,,,1,1,7.409845536,18591,8352,8031,321,4,317
17669,10383,10894,2,2,14035,,,,,,1,1,2.88703396,6925,3434,3192,242,5,237
17669,10578,9485,4,2,36973,,,,,,1,1,7.5697231689999995,18999,8836,8534,302,6,296
17669,9571,10612,2,0,37020,,,,,,1,1,7.663665352,18747,8982,8673,309,6,303
17669,10614,10396,0,0,5422,,,,,,1,1,1.142327949,2661,1291,1112,179,0,179
17669,10622,9636,2,2,37393,,,,,,1,1,7.796507161,19239,8934,8648,286,4,282
17669,10686,9868,0,0,36810,,,,,,1,1,7.688752862,18952,8772,8458,314,3,311
17669,10281,10644,0,0,7135,,,,,,1,1,1.485313632,3410,1747,1516,231,0,231
17669,10005,10914,3,2,14877,,,,,,1,1,3.098682408,7436,3595,3344,251,4,247
17669,9951,11151,4,0,6035,,,,,,1,1,1.242798793,2861,1484,1278,206,3,203
17669,11322,9597,0,0,8303,,,,,,1,1,1.780714985,4171,1963,1757,206,0,206
17669,9570,11076,2,0,34815,,,,,,1,1,7.401842502,18231,8150,7866,284,0,284
17669,9714,9893,0,2,36575,,,,,,1,1,7.5575356849999995,18738,8770,8473,297,0,297
17669,11132,9787,2,2,15670,,,,,,1,1,3.24317097,7839,3779,3506,273,6,267
17669,12468,8587,4,0,4551,,,,,,1,1,0.935260355,2037,1172,1002,170,0,170
17669,9658,10186,2,3,37715,,,,,,1,1,7.899922874,19081,9174,8888,286,2,284
17669,9211,10362,2,0,37681,,,,,,1,1,7.715834847,19007,9172,8842,330,2,328
17669,11075,9741,0,2,34879,,,,,,1,1,7.197565299,18289,8134,7812,322,4,318
17669,8927,8964,0,0,38804,,,,,,1,1,7.977949758,19877,9327,9054,273,1,272
17669,10566,9857,2,0,35338,,,,,,1,1,7.364880126,18320,8375,8107,268,2,266
17669,9253,10352,1,3,37913,,,,,,1,1,7.953461931,19020,9284,8959,325,0,325
17669,10504,10773,0,0,3196,,,,,,1,1,0.663840275,1523,760,607,153,0,153
17669,10586,9600,0,0,35515,,,,,,1,1,7.411065634,18694,8252,7935,317,3,314
17669,10598,9873,2,0,34674,,,,,,1,1,7.201924009,18101,8139,7844,295,2,293
17669,9772,11169,0,0,5572,,,,,,1,1,1.145359694,2687,1345,1150,195,0,195
17669,10747,10438,0,0,11418,,,,,,1,1,2.3919741979999998,5744,2727,2507,220,0,220
17669,8799,10213,0,0,37991,,,,,,1,1,7.980118425,19188,9268,9001,267,0,267
17669,10144,10775,0,2,15696,,,,,,1,1,3.259249818,7939,3739,3460,279,0,279
17669,10351,10581,0,0,2769,,,,,,1,1,0.571271521,1241,684,524,160,0,160
17669,10701,10222,0,0,2825,,,,,,1,1,0.584335269,1259,703,543,160,0,160
17669,10490,10447,2,0,1317,,,,,,1,1,0.280773686,513,344,228,116,0,116
17669,10214,9978,0,0,37215,,,,,,1,1,7.670268372,19245,8836,8538,298,2,296
17669,11254,8956,2,3,37844,,,,,,1,1,7.731905511,19379,9074,8757,317,6,311
17669,9894,10428,0,0,36880,,,,,,1,1,7.581250451,18496,9049,8763,286,3,283
17669,8651,9773,0,0,37480,,,,,,1,1,7.672883907,19368,8920,8648,272,0,272
17669,10102,10412,0,0,36671,,,,,,1,1,7.539954831,19076,8657,8376,281,1,280
17669,11469,8684,4,2,36236,,,,,,1,1,7.520989232,18581,8670,8355,315,7,308
17669,10457,10462,0,0,4070,,,,,,1,1,0.846612101,1931,975,786,189,0,189
17669,9201,8844,2,0,36818,,,,,,1,1,7.700872833,19134,8725,8491,234,4,230
17669,8569,10498,0,1,38389,,,,,,1,1,8.080612975,19514,9293,9004,289,8,281
17669,11894,9186,0,0,4049,,,,,,1,1,0.831298246,1855,1011,839,172,1,171
17669,10716,10125,2,0,36238,,,,,,1,1,7.497478668,18850,8554,8274,280,2,278
17669,10807,9805,2,2,35136,,,,,,1,1,7.232559758,18219,8308,8007,301,5,296
17669,10168,10751,0,2,11012,,,,,,1,1,2.257352449,5492,2651,2433,218,1,217
17669,9456,10514,0,0,37733,,,,,,1,1,7.725241004,19189,9116,8804,312,4,308
17669,8455,9958,2,2,36742,,,,,,1,1,7.656831359,18999,8744,8489,255,1,254
17669,10825,8353,2,0,37944,,,,,,1,1,7.754484028,18966,9343,9051,292,6,286
17669,11892,8858,5,0,34336,,,,,,1,1,7.058055807,18203,7932,7663,269,2,267
17669,10891,10031,0,2,14236,,,,,,1,1,2.967253531,7121,3438,3199,239,0,239
17669,10937,9791,0,0,35419,,,,,,1,1,7.299990975,18463,8322,8010,312,0,312
17669,9638,11285,0,4,4099,,,,,,1,1,0.843237334,1850,1039,868,171,3,168
17669,8567,10821,2,0,38851,,,,,,1,1,7.922413407,19233,9657,9353,304,5,299
17669,8946,9186,0,0,36771,,,,,,1,1,7.648393009,19040,8742,8495,247,2,245
17669,10479,10576,0,2,23632,,,,,,1,1,4.875418524,11653,5835,5526,309,1,308
17669,10162,8765,2,0,35258,,,,,,1,1,7.248015302,18271,8360,8093,267,4,263
17669,9756,11060,0,0,38967,,,,,,1,1,8.070408847,19431,9596,9252,344,0,344
17669,10367,10754,2,2,25371,,,,,,1,1,5.305721114,12847,6111,5809,302,3,299
17669,9878,9736,7,2,35352,,,,,,1,1,7.305399809,18491,8301,8042,259,3,256
17669,10503,10505,0,2,4062,,,,,,1,1,0.853079256,1898,990,806,184,1,183
17669,10946,9977,2,0,13196,,,,,,1,1,2.747097321,6720,3116,2872,244,5,239
17669,10425,9983,2,2,37657,,,,,,1,1,7.750836556,19418,8956,8629,327,4,323
17669,9071,10515,2,0,35505,,,,,,1,1,7.387343373,18379,8427,8155,272,6,266
17669,9504,11417,2,0,10658,,,,,,1,1,2.200839834,5294,2560,2316,244,0,244
17669,8487,9844,0,3,38491,,,,,,1,1,7.908132492,19463,9365,9067,298,7,291
17669,8085,10256,0,0,36581,,,,,,1,1,7.646095064,18876,8719,8452,267,0,267
17669,11496,9723,2,0,2213,,,,,,1,1,0.468192011,1004,541,414,127,0,127
17669,8504,9854,0,0,36422,,,,,,1,1,7.483649191,18973,8596,8339,257,4,253
17669,9479,9623,0,0,38817,,,,,,1,1,7.989949913,19023,9750,9456,294,3,291
17669,10508,10480,0,0,1897,,,,,,1,1,0.394172079,766,493,348,145,1,144
17669,10828,10044,2,0,36535,,,,,,1,1,7.48932881,18655,8774,8442,332,3,329
17669,9947,9229,0,0,38490,,,,,,1,1,7.976465711,19207,9494,9199,295,2,293
17669,10279,10201,0,2,35743,,,,,,1,1,7.597983455,18630,8401,8090,311,10,301
17669,9494,10974,2,1,34373,,,,,,1,1,7.308677018,17906,8076,7761,315,5,310
17669,7844,10127,0,2,37693,,,,,,1,1,7.845536862,19272,9078,8813,265,1,264
17669,10374,10100,0,1,37088,,,,,,1,1,7.604947236,19005,8878,8551,327,2,325
17669,9990,10934,0,0,1882,,,,,,1,1,0.40314627,797,475,340,135,0,135
17669,10653,10273,0,0,4858,,,,,,1,1,1.004441143,2241,1209,1010,199,0,199
17669,8801,12131,0,0,2057,,,,,,1,1,0.437547449,900,509,370,139,0,139
17669,8994,11409,0,2,35134,,,,,,1,1,7.367310861,18621,8102,7793,309,1,308
17669,10124,10589,2,2,36817,,,,,,1,1,7.549980506,18659,8930,8632,298,5,293
17669,10993,9950,0,0,3486,,,,,,1,1,0.721508587,1612,848,670,178,0,178
17669,10351,10636,0,0,5535,,,,,,1,1,1.14290834,2554,1387,1180,207,1,206
17669,9344,8593,0,0,37007,,,,,,1,1,7.7327647840000004,19219,8766,8510,256,3,253
17669,9429,9791,5,0,35196,,,,,,1,1,7.330119762,18152,8397,8147,250,1,249
17669,9102,10464,0,2,37873,,,,,,1,1,7.790412767,19065,9253,8951,302,2,300
17669,9869,10891,0,0,35422,,,,,,1,1,7.382165882,18299,8420,8137,283,5,278
17669,11194,9844,0,0,2382,,,,,,1,1,0.496555658,1078,581,439,142,0,142
17669,7620,11961,2,0,36408,,,,,,1,1,7.5204278559999995,18884,8630,8366,264,4,260
17669,8990,11952,0,0,1416,,,,,,1,1,0.298644308,588,352,228,124,0,124
17669,9929,11051,0,2,2427,,,,,,1,1,0.507671194,1073,608,470,138,1,137
17669,10600,10630,0,0,1701,,,,,,1,1,0.355055715,668,457,338,119,2,117
17669,10909,10097,0,0,6996,,,,,,1,1,1.446701312,3283,1744,1519,225,0,225
17669,10506,10512,0,0,3186,,,,,,1,1,0.658346939,1394,816,656,160,0,160
17669,10360,10585,0,2,2189,,,,,,1,1,0.458209082,937,553,407,146,0,146
17669,10658,10265,0,2,1894,,,,,,1,1,0.393142569,785,483,340,143,1,142
17669,9866,10448,2,2,38822,,,,,,1,1,7.971382795,19357,9567,9236,331,4,327
17669,10379,10544,2,0,12262,,,,,,1,1,2.526449226,6176,2915,2659,256,3,253
17669,9047,10326,0,0,35868,,,,,,1,1,7.483398239,18396,8585,8283,302,0,302
17669,10328,9710,0,0,37713,,,,,,1,1,7.807962822,19095,9149,8829,320,5,315
17669,10722,10084,0,0,35337,,,,,,1,1,7.288531059,18339,8354,8064,290,2,288
17669,10555,10408,2,0,3705,,,,,,1,1,0.764859638,1694,919,746,173,1,172
17669,10596,10332,2,0,2017,,,,,,1,1,0.420502553,857,508,364,144,0,144
17669,10066,9591,4,0,36677,,,,,,1,1,7.570470736,18798,8785,8476,309,1,308
17669,11011,9908,4,2,6696,,,,,,1,1,1.383477605,3280,1611,1417,194,2,192
17669,9968,8507,2,0,35579,,,,,,1,1,7.363492417,18326,8501,8250,251,4,247
17669,9734,10847,2,2,36574,,,,,,1,1,7.595492023,18773,8743,8428,315,4,311
17669,11562,9361,0,2,3864,,,,,,1,1,0.796641327,1786,947,763,184,2,182
17669,9669,11251,0,2,9632,,,,,,1,1,2.11516681,4963,2234,2033,201,0,201
17669,8853,12191,0,2,35334,,,,,,1,1,7.272183318,17397,8790,8433,357,13,344
17669,9157,10237,0,0,36750,,,,,,1,1,7.658903036,18941,8763,8480,283,3,280
17669,10434,10490,0,0,1884,,,,,,1,1,0.400189846,819,465,330,135,0,135
17669,9145,9960,0,2,36375,,,,,,1,1,7.606825465,18787,8650,8362,288,5,283
17669,10999,9651,4,0,36042,,,,,,1,1,7.566819668,18203,8759,8438,321,15,306
17669,10236,10683,0,0,5032,,,,,,1,1,1.069126007,2365,1241,1056,185,1,184
17669,12065,8912,3,2,25367,,,,,,1,1,5.371594962,12983,6041,5739,302,0,302
17669,9774,11116,0,3,36502,,,,,,1,1,7.542061094,18640,8765,8433,332,5,327
17669,9793,11138,0,0,5437,,,,,,1,1,1.11523448,2585,1326,1126,200,0,200
17669,8980,9920,4,1,36155,,,,,,1,1,7.519851258,18354,8758,8473,285,3,282
17669,9758,10627,0,2,35321,,,,,,1,1,7.262006561,18382,8329,8048,281,3,278
17669,9647,11284,0,0,4900,,,,,,1,1,1.008696202,2276,1221,1039,182,2,180
17669,11393,9857,2,0,3903,,,,,,1,1,0.801396577,1741,994,820,174,2,172
17669,8578,9491,0,2,38302,,,,,,1,1,7.868803729,19277,9383,9124,259,4,255
17669,10180,9897,0,2,37196,,,,,,1,1,7.670616939,18929,8973,8652,321,6,315
17669,9781,10426,0,0,36306,,,,,,1,1,7.6138614,18594,8704,8400,304,0,304
17669,10923,9583,0,0,36902,,,,,,1,1,7.586940474,18890,8861,8571,290,0,290
17669,10541,10378,0,0,30746,,,,,,1,1,6.304381531,15881,7283,6984,299,1,298
17669,10275,10660,0,0,1828,,,,,,1,1,0.386738284,786,448,302,146,0,146
17669,10822,10097,0,3,26025,,,,,,1,1,5.387415254,13477,6134,5854,280,2,278
17669,11383,9619,0,2,8072,,,,,,1,1,1.650456198,3794,2031,1815,216,4,212
17669,10464,10473,2,0,4032,,,,,,1,1,0.835199301,1966,947,775,172,0,172
17669,9553,11011,2,0,35342,,,,,,1,1,7.370183276,18200,8408,8082,326,3,323
17669,8137,10095,2,0,36538,,,,,,1,1,7.572526831,19153,8556,8283,273,6,267
17669,10103,10821,0,1,19019,,,,,,1,1,3.971716379,9519,4608,4324,284,1,283
17669,10758,10200,0,0,1573,,,,,,1,1,0.387347982,680,382,253,129,0,129
17669,9628,9453,0,2,36731,,,,,,1,1,7.5494315069999995,18980,8737,8460,277,2,275
17669,10747,10500,0,0,5613,,,,,,1,1,1.183957683,2665,1383,1201,182,1,181
17669,8714,10986,0,0,35952,,,,,,1,1,7.395873986,18351,8661,8382,279,2,277
17669,10004,10915,0,2,31188,,,,,,1,1,6.56692385,16322,7292,7010,282,1,281
17669,10613,10037,0,0,35602,,,,,,1,1,7.315762147,18417,8441,8138,303,1,302
17669,11215,8960,0,2,34565,,,,,,1,1,7.202580297,18183,8054,7780,274,1,273
17669,9690,10568,4,0,35335,,,,,,1,1,7.285592809,18350,8358,8089,269,1,268
17669,10486,8254,2,0,37153,,,,,,1,1,7.597245698,19026,8931,8666,265,11,254
17669,10744,9572,2,0,38694,,,,,,1,1,7.955817308,19145,9612,9287,325,3,322
17669,10224,10596,2,0,35841,,,,,,1,1,7.348583951,18773,8370,8042,328,3,325
17669,10223,8637,0,0,38117,,,,,,1,1,7.800222624,19448,9187,8892,295,1,294
17669,10079,10846,2,2,7386,,,,,,1,1,1.5374606640000001,3517,1820,1591,229,8,221
17669,7951,9949,0,0,38895,,,,,,1,1,7.9476231120000005,19806,9400,9111,289,1,288
17669,9817,9269,2,2,36071,,,,,,1,1,7.524421181,18724,8532,8249,283,6,277
17669,10642,10343,0,2,12465,,,,,,1,1,2.601667441,6337,2945,2707,238,1,237
17669,10931,9991,0,0,9347,,,,,,1,1,1.9498954259999999,4531,2299,2081,218,0,218
17669,9328,10015,0,1,36306,,,,,,1,1,7.612717506,18796,8603,8299,304,4,300
17669,10107,10496,2,0,34525,,,,,,1,1,7.263208077,18039,8101,7817,284,3,281
17669,10562,10358,0,0,22399,,,,,,1,1,4.633689859,11292,5396,5081,315,0,315
17669,9501,11105,1,2,38518,,,,,,1,1,7.9252648,19499,9343,9010,333,1,332
17669,9739,10838,0,0,37050,,,,,,1,1,7.612110626,18669,9033,8718,315,3,312
17669,9433,10467,0,0,35659,,,,,,1,1,7.442321432,18308,8527,8230,297,2,295
17669,10145,10774,0,4,21739,,,,,,1,1,4.55374139,10758,5349,5066,283,7,276
17669,10422,10467,3,0,37059,,,,,,1,1,7.613904575,18810,8968,8655,313,1,312
17669,11022,9888,0,0,33278,,,,,,1,1,6.926117003,17897,7543,7248,295,2,293
17669,9803,11118,0,0,2680,,,,,,1,1,0.550655706,1153,683,522,161,1,160
17669,11358,9561,0,2,21268,,,,,,1,1,4.359905532,10574,5219,4963,256,1,255
17669,10204,10721,0,0,2041,,,,,,1,1,0.423288793,866,521,388,133,0,133
17669,10173,9825,1,0,36879,,,,,,1,1,7.7178215439999995,18733,8925,8629,296,3,293
17669,10780,8820,2,0,36357,,,,,,1,1,7.515510029,18997,8530,8230,300,1,299
17669,9322,8946,2,0,38132,,,,,,1,1,7.9258964800000005,19078,9381,9089,292,5,287
17669,10567,9137,5,0,37644,,,,,,1,1,7.719834849,19159,9083,8764,319,19,300
17669,8887,12268,0,0,32082,,,,,,1,1,6.605813718,16313,7714,7373,341,2,339
17669,10619,10303,0,0,9487,,,,,,1,1,1.9483812390000002,4710,2274,2045,229,0,229
17669,10361,8125,0,0,37498,,,,,,1,1,7.641470498,19179,9029,8768,261,2,259
17669,10402,10012,0,4,36405,,,,,,1,1,7.471167744,18988,8549,8230,319,5,314
17669,8604,10786,0,0,35101,,,,,,1,1,7.253233277,18299,8260,7978,282,2,280
17669,10320,10833,0,0,10342,,,,,,1,1,2.123620536,5061,2519,2276,243,1,242
17669,10735,10321,0,2,4067,,,,,,1,1,0.863685277,1908,987,802,185,1,184
17669,10016,10626,5,2,35513,,,,,,1,1,7.509616683,18606,8314,8035,279,9,270
17669,11913,8473,0,0,35472,,,,,,1,1,7.397300964,18234,8478,8196,282,2,280
17669,9572,9736,0,0,38816,,,,,,1,1,7.937690674,19413,9550,9247,303,4,299
17669,9971,10959,0,0,3599,,,,,,1,1,0.760434138,1726,849,674,175,0,175
17669,9463,11441,0,2,35854,,,,,,1,1,7.418888875,18431,8561,8260,301,1,300
17669,9964,11042,4,0,6783,,,,,,1,1,1.3982249,3255,1648,1416,232,2,230
17669,10459,9714,0,0,35226,,,,,,1,1,7.285253527,18142,8401,8119,282,1,281
17669,9929,10992,0,0,9844,,,,,,1,1,2.033987467,4829,2400,2185,215,0,215
17669,10743,9053,2,0,37939,,,,,,1,1,7.851539679,19032,9289,8960,329,2,327
17669,10901,10019,0,0,10093,,,,,,1,1,2.086163535,4909,2463,2205,258,2,256
17669,9333,11033,0,2,37291,,,,,,1,1,7.632751913,18964,8992,8649,343,6,337
17669,9630,11290,0,4,6167,,,,,,1,1,1.286759101,2836,1552,1325,227,7,220
17669,10039,10231,4,0,36624,,,,,,1,1,7.691873485,18898,8714,8416,298,0,298
17669,9377,11126,0,0,36467,,,,,,1,1,7.642699379,18628,8765,8456,309,2,307
17669,10600,9458,0,0,35664,,,,,,1,1,7.318806709,18719,8328,8039,289,2,287
17669,10385,9376,2,0,37777,,,,,,1,1,7.768682166,19293,9085,8771,314,1,313
17669,10624,10298,0,0,8490,,,,,,1,1,1.783392662,4062,2099,1869,230,0,230
17669,10673,10399,2,0,17488,,,,,,1,1,3.593107554,8759,4221,3934,287,1,286
17669,11747,9351,2,0,2113,,,,,,1,1,0.440495036,899,539,403,136,2,134
17669,9622,11246,2,3,34685,,,,,,1,1,7.372604113,18127,8136,7850,286,3,283
17669,10416,10307,3,0,36313,,,,,,1,1,7.55280138,18301,8839,8505,334,4,330
17669,10869,9971,0,0,32040,,,,,,1,1,6.670681662,16998,7372,7074,298,1,297
17669,9380,9052,0,0,38885,,,,,,1,1,8.052321569,19572,9503,9196,307,1,306
17669,10521,10631,0,2,1047,,,,,,1,1,0.221691485,393,274,168,106,0,106
17669,10193,10555,0,0,34664,,,,,,1,1,7.282494155,18367,7999,7700,299,3,296
17669,10906,10198,0,0,8361,,,,,,1,1,1.772540125,4099,2012,1774,238,0,238
17669,11731,9471,4,0,18877,,,,,,1,1,4.002420141,9712,4448,4179,269,2,267
17669,10326,8851,2,0,37719,,,,,,1,1,7.778398295,19379,9018,8714,304,3,301
17669,9949,10972,0,0,6496,,,,,,1,1,1.371596863,3187,1567,1392,175,1,174
17669,10177,10920,2,4,18035,,,,,,1,1,3.7071672700000002,8912,4423,4146,277,8,269
17669,11576,9360,0,0,4353,,,,,,1,1,0.891507624,1959,1096,894,202,2,200
17669,10430,9831,2,8,35572,,,,,,1,1,7.342261059,18313,8476,8169,307,14,293
17669,10343,10692,0,2,9652,,,,,,1,1,1.9817982920000001,4555,2428,2187,241,6,235
17669,9881,10883,2,0,37331,,,,,,1,1,7.685683551,18836,9082,8751,331,4,327
17669,10966,9961,0,0,3252,,,,,,1,1,0.67072986,1397,845,680,165,0,165
17669,9379,9695,2,2,36912,,,,,,1,1,7.789938025,19031,8785,8474,311,6,305
17669,10535,9986,0,2,37047,,,,,,1,1,7.6842571060000004,19081,8828,8518,310,1,309
17669,9558,11362,0,2,1417,,,,,,1,1,0.299976412,578,362,247,115,0,115
17669,10554,9409,2,2,38334,,,,,,1,1,7.957162107,19354,9341,9043,298,14,284
17669,9335,8955,0,0,36277,,,,,,1,1,7.5434107820000005,18474,8775,8522,253,0,253
17669,10333,10046,2,0,34826,,,,,,1,1,7.326363495,18238,8141,7835,306,8,298
17669,9681,10881,0,0,37017,,,,,,1,1,7.612312558,18834,8918,8571,347,0,347
17669,11478,8803,2,0,35172,,,,,,1,1,7.410476448,18177,8340,8025,315,0,315
17669,9037,12070,0,0,4539,,,,,,1,1,0.929882424,2085,1136,954,182,1,181
17669,10284,10637,0,0,8245,,,,,,1,1,1.716434407,3882,2065,1832,233,0,233
17669,9812,9487,0,2,36655,,,,,,1,1,7.577458977,18704,8830,8539,291,2,289
17669,10175,8937,3,2,34887,,,,,,1,1,7.290704939,18144,8237,7968,269,1,268
17669,9506,10009,2,2,37769,,,,,,1,1,7.756123092,19295,9088,8790,298,7,291
17669,10182,9946,2,2,35803,,,,,,1,1,7.40925506,18417,8554,8276,278,7,271
17669,9624,10810,1,2,35855,,,,,,1,1,7.362244106,18582,8485,8182,303,3,300
17669,10436,10509,2,2,15833,,,,,,1,1,3.323335438,7960,3812,3563,249,1,248
17669,9329,10272,2,0,36904,,,,,,1,1,7.639225469,19172,8722,8434,288,1,287
17669,9562,11358,0,2,6273,,,,,,1,1,1.28327881,2953,1556,1348,208,4,204
17669,10700,9860,4,2,38254,,,,,,1,1,8.101478334,19132,9393,9057,336,6,330
17669,10347,10573,0,0,8909,,,,,,1,1,1.8291064769999998,4331,2177,1953,224,1,223
17669,10431,9543,0,0,37646,,,,,,1,1,7.850295845,19326,8995,8665,330,2,328
17669,9106,11016,0,0,36870,,,,,,1,1,7.781970072,18977,8794,8489,305,1,304
17669,10989,10268,0,2,7627,,,,,,1,1,1.567403922,3660,1880,1673,207,3,204
17669,10348,10574,0,0,7948,,,,,,1,1,1.6341269569999999,3865,1928,1701,227,1,226
17669,11299,9640,2,0,4028,,,,,,1,1,0.870012336,1839,1000,811,189,1,188
17669,10796,9748,0,2,37183,,,,,,1,1,7.676124446,18732,9057,8720,337,2,335
17669,10871,10048,4,0,18625,,,,,,1,1,3.880580671,9441,4460,4196,264,2,262
17669,10654,10304,3,0,18887,,,,,,1,1,3.923419396,10036,4304,4061,243,2,241
17669,9605,11316,0,0,8373,,,,,,1,1,1.7286688749999999,4024,2066,1849,217,1,216
17669,9840,8900,0,2,36821,,,,,,1,1,7.585876488,19007,8759,8463,296,2,294
17669,10655,9181,2,2,36185,,,,,,1,1,7.462251742,18677,8615,8337,278,1,277
17669,11286,8778,4,0,38355,,,,,,1,1,7.942388185,19347,9332,8988,344,8,336
17669,9045,11048,0,0,36367,,,,,,1,1,7.579391564,18816,8613,8288,325,4,321
17669,10291,10005,1,4,34400,,,,,,1,1,7.224980347,18153,7985,7708,277,2,275
17669,9717,9993,0,2,35399,,,,,,1,1,7.3060516589999995,18418,8360,8099,261,2,259
17669,10869,9571,0,0,35351,,,,,,1,1,7.282906286,18370,8329,8006,323,2,321
17669,9562,10626,0,3,35778,,,,,,1,1,7.413017095,18506,8497,8219,278,2,276
17669,10598,10362,2,0,2106,,,,,,1,1,0.446271232,847,553,400,153,3,150
17669,10280,10642,0,0,4094,,,,,,1,1,0.84718093,1978,972,800,172,0,172
17669,10981,9751,2,0,35810,,,,,,1,1,7.379229647,18568,8462,8144,318,5,313
17669,9770,11163,0,0,2573,,,,,,1,1,0.552540701,1104,659,508,151,0,151
17669,11095,9971,0,0,5954,,,,,,1,1,1.238052326,2831,1460,1257,203,0,203
17669,10242,10528,0,0,36438,,,,,,1,1,7.491497239,18805,8675,8392,283,0,283
17669,9018,10203,4,0,38312,,,,,,1,1,7.982722129,19315,9349,9050,299,2,297
17669,9489,11382,0,0,34154,,,,,,1,1,7.144590226,17940,7947,7627,320,2,318
17669,10542,9894,0,0,35128,,,,,,1,1,7.292051028,18581,8115,7798,317,3,314
17669,10378,10620,2,0,20826,,,,,,1,1,4.27995925,10501,5022,4741,281,4,277
17669,9764,9431,0,2,34722,,,,,,1,1,7.217281186,18283,8087,7822,265,2,263
17669,10830,10286,0,2,11293,,,,,,1,1,2.314703313,5564,2748,2515,233,1,232
17669,10444,9955,0,2,37953,,,,,,1,1,7.763213035,18972,9324,8991,333,2,331
17669,10625,10443,2,0,3973,,,,,,1,1,0.819364183,1766,1013,832,181,0,181
17669,10713,9239,0,0,35926,,,,,,1,1,7.419117417,18710,8456,8152,304,4,300
17669,10883,9671,0,0,36495,,,,,,1,1,7.487697749,18516,8831,8514,317,0,317
17669,10347,8033,0,0,38107,,,,,,1,1,7.894478239,19554,9144,8879,265,5,260
17669,10168,10752,2,0,3494,,,,,,1,1,0.736888635,1476,915,727,188,3,185
17669,10010,10326,0,0,37500,,,,,,1,1,7.877129669,18725,9227,8906,321,0,321
17669,8942,8023,0,0,37871,,,,,,1,1,7.961372198,19561,9022,8756,266,4,262
17669,10487,10447,4,2,2615,,,,,,1,1,0.562453034,1207,636,500,136,0,136
17669,10090,10447,0,0,37747,,,,,,1,1,7.804188512,18918,9240,8891,349,4,345
17669,10537,10623,0,2,12118,,,,,,1,1,2.5037021470000003,6094,2890,2646,244,1,243
17669,9557,10624,3,1,36529,,,,,,1,1,7.483949492,18691,8764,8454,310,12,298
17669,10962,9957,0,0,15700,,,,,,1,1,3.232174088,8153,3636,3361,275,2,273
17669,10724,10217,0,0,2997,,,,,,1,1,0.621139341,1365,741,591,150,0,150
17669,10707,9147,0,0,35545,,,,,,1,1,7.320369636,18449,8409,8131,278,1,277
17669,9855,11205,0,0,3874,,,,,,1,1,0.803868125,1826,939,769,170,0,170
17669,11131,9849,2,0,5558,,,,,,1,1,1.152011161,2637,1360,1159,201,1,200
17669,10196,10619,0,2,34093,,,,,,1,1,7.033361995,17988,7913,7634,279,3,276
17669,9936,10985,0,0,6701,,,,,,1,1,1.384520293,3057,1707,1477,230,0,230
17669,10620,10441,2,2,8488,,,,,,1,1,1.746130434,4203,2036,1823,213,1,212
17669,11050,9175,1,0,34895,,,,,,1,1,7.240889097,18301,8167,7907,260,3,257
17669,10967,8778,0,0,36867,,,,,,1,1,7.557483848,18986,8785,8474,311,1,310
17669,9592,11341,2,0,6825,,,,,,1,1,1.407004989,3274,1666,1447,219,4,215
17669,9282,10863,1,0,36954,,,,,,1,1,7.897713046,18969,8840,8535,305,1,304
17669,10759,10351,2,0,4600,,,,,,1,1,0.988154629,2182,1124,954,170,0,170
17669,10927,9017,1,0,36250,,,,,,1,1,7.541758118,18551,8700,8401,299,2,297
17669,10814,10015,0,2,36021,,,,,,1,1,7.400436931,18386,8670,8375,295,2,293
17669,10575,9688,0,0,35594,,,,,,1,1,7.483362947,18440,8424,8118,306,2,304
17669,10219,9006,2,0,34613,,,,,,1,1,7.182706824,18273,8048,7804,244,5,239
17669,10466,10489,2,2,15518,,,,,,1,1,3.211842451,7825,3714,3449,265,1,264
17669,9407,11836,0,2,6300,,,,,,1,1,1.4012705109999999,2953,1560,1333,227,2,225
17669,11515,9458,0,0,6673,,,,,,1,1,1.435689282,3203,1642,1456,186,1,185
17669,10598,10326,0,0,1493,,,,,,1,1,0.32307111,634,372,257,115,1,114
17669,9572,10119,2,0,34860,,,,,,1,1,7.224081352,18294,8141,7857,284,2,282
17669,10393,10172,5,0,37100,,,,,,1,1,7.717905237,18842,8962,8628,334,0,334
17669,10786,10145,0,2,2413,,,,,,1,1,0.525135851,1004,625,466,159,1,158
17669,11172,8575,3,0,36497,,,,,,1,1,7.498567459,18952,8646,8393,253,5,248
17669,10879,10042,0,0,1963,,,,,,1,1,0.414794632,885,473,341,132,1,131
17669,10498,10708,0,0,1759,,,,,,1,1,0.382822801,715,457,327,130,0,130
17669,8555,9775,0,0,36648,,,,,,1,1,7.5459040680000005,18859,8756,8479,277,1,276
17669,10464,9024,2,0,35610,,,,,,1,1,7.539208838,18687,8288,7941,347,0,347
17669,10639,9940,0,2,36232,,,,,,1,1,7.44741948,18761,8581,8272,309,2,307
17669,11092,10065,0,0,13996,,,,,,1,1,2.906317145,6808,3462,3198,264,0,264
17669,10507,9415,2,2,35594,,,,,,1,1,7.370431004,18335,8500,8241,259,9,250
17669,9716,11206,2,0,5735,,,,,,1,1,1.181232325,2727,1407,1213,194,0,194
17669,9768,10619,0,0,37744,,,,,,1,1,7.832944071,19168,9126,8802,324,3,321
17669,8825,9915,2,4,38441,,,,,,1,1,7.873580429,19475,9325,9009,316,8,308
17669,10422,10596,2,0,23842,,,,,,1,1,5.120997527,12073,5743,5460,283,1,282
17669,9453,11489,0,2,2529,,,,,,1,1,0.525110802,1099,638,484,154,0,154
17669,9277,10223,2,2,37006,,,,,,1,1,7.7628289299999995,18795,8960,8669,291,0,291
17669,10008,10917,0,0,13521,,,,,,1,1,2.775546752,6901,3191,2953,238,0,238
17669,10322,10806,0,0,15062,,,,,,1,1,3.165322227,7412,3701,3453,248,0,248
17669,8940,10684,2,2,37537,,,,,,1,1,7.768503182,19373,8941,8659,282,7,275
17669,10448,9439,0,0,35547,,,,,,1,1,7.400365932,18427,8417,8131,286,0,286
17669,10677,10547,0,0,2095,,,,,,1,1,0.45380061,910,523,384,139,0,139
17669,10826,10436,0,3,3356,,,,,,1,1,0.712359832,1549,821,656,165,0,165
17669,9555,11411,0,2,3152,,,,,,1,1,0.651384607,1434,784,634,150,0,150
17669,10032,11026,2,0,3656,,,,,,1,1,0.78325047,1592,946,774,172,2,170
17669,9953,9421,0,0,36203,,,,,,1,1,7.546940528,18809,8548,8250,298,2,296
17669,10047,10883,0,0,1975,,,,,,1,1,0.409907143,800,514,367,147,0,147
17669,10050,8167,2,0,36713,,,,,,1,1,7.545430685,18937,8769,8531,238,8,230
17669,10152,9606,2,1,36967,,,,,,1,1,7.705835579,18888,8891,8594,297,2,295
17669,9444,10991,5,0,34735,,,,,,1,1,7.341481325,18544,7952,7665,287,2,285
17669,10338,10408,1,1,36289,,,,,,1,1,7.467345265,18511,8729,8409,320,3,317
17669,10952,9974,2,0,5293,,,,,,1,1,1.088501745,2449,1315,1101,214,1,213
17669,10920,8913,0,0,36731,,,,,,1,1,7.815422344,18877,8780,8486,294,5,289
17669,11279,9644,0,0,3265,,,,,,1,1,0.670953627,1479,802,620,182,0,182
17669,8398,10527,0,0,36677,,,,,,1,1,7.72569432,19125,8645,8383,262,2,260
17669,10522,9286,0,0,37235,,,,,,1,1,7.663307128,19186,8881,8594,287,1,286
17669,9725,11196,2,2,24614,,,,,,1,1,5.126050986,12224,6053,5769,284,7,277
17669,9769,11355,0,2,2762,,,,,,1,1,0.576695925,1224,694,544,150,2,148
17669,10705,10486,0,2,3824,,,,,,1,1,0.789552088,1752,951,781,170,3,167
17669,9258,9858,0,2,35860,,,,,,1,1,7.472974154,18214,8688,8418,270,0,270
17669,9454,11465,0,1,19009,,,,,,1,1,3.965808172,9408,4670,4409,261,0,261
17669,10040,10891,0,0,1763,,,,,,1,1,0.367453746,660,485,352,133,0,133
17669,10751,10168,0,0,7042,,,,,,1,1,1.510760423,3467,1691,1498,193,1,192
17669,10963,9312,0,0,36759,,,,,,1,1,7.6946813469999995,18802,8821,8506,315,1,314
17669,8455,9585,2,0,36621,,,,,,1,1,7.582216802,18656,8851,8588,263,2,261
17669,11081,9198,4,0,36188,,,,,,1,1,7.993133749,18727,8569,8246,323,2,321
17669,8577,10229,2,2,37861,,,,,,1,1,7.922335782,19287,9128,8810,318,12,306
17669,10036,11008,0,0,1713,,,,,,1,1,0.365231939,699,444,318,126,0,126
17669,11431,9598,2,0,2067,,,,,,1,1,0.426243466,821,550,404,146,3,143
17669,10386,10540,1,0,2509,,,,,,1,1,0.531128239,1101,628,476,152,0,152
17669,10741,10203,0,0,1941,,,,,,1,1,0.403863191,821,491,353,138,0,138
17669,10586,10426,2,0,11824,,,,,,1,1,2.492369323,5684,2944,2692,252,0,252
17669,11205,10008,4,2,13792,,,,,,1,1,2.851995593,6681,3426,3167,259,7,252
17669,10273,10704,2,0,27912,,,,,,1,1,5.707216309,14211,6689,6366,323,5,318
17669,10418,10633,0,0,1885,,,,,,1,1,0.393961991,846,457,332,125,0,125
17669,8934,9722,0,0,38491,,,,,,1,1,7.916794405,19554,9309,8990,319,1,318
17669,10002,10919,0,2,5803,,,,,,1,1,1.207654287,2746,1435,1248,187,0,187
17669,10360,10566,0,0,1924,,,,,,1,1,0.40203825,832,479,345,134,0,134
17669,10550,9399,4,0,37642,,,,,,1,1,7.795197721,19258,9057,8787,270,5,265
17669,10885,9478,0,0,38038,,,,,,1,1,7.860624753,18902,9406,9082,324,3,321
17669,10242,10801,1,2,8402,,,,,,1,1,1.76435201,4270,1963,1757,206,1,205
17669,10220,10985,0,2,7024,,,,,,1,1,1.44141251,3364,1719,1497,222,1,221
17669,8607,9613,1,2,37743,,,,,,1,1,7.7224494759999995,19487,9002,8750,252,3,249
17669,9829,10805,0,0,34381,,,,,,1,1,7.100835065,18118,7982,7683,299,0,299
17669,10139,9310,0,0,36103,,,,,,1,1,7.543416309,18713,8553,8269,284,4,280
17669,11319,9249,0,2,35663,,,,,,1,1,7.45674635,18509,8425,8121,304,3,301
17669,9923,11042,0,2,1512,,,,,,1,1,0.323972724,588,405,291,114,2,112
17669,8734,11909,0,2,35801,,,,,,1,1,7.462030669,18509,8498,8202,296,1,295
17669,10300,9739,0,0,36978,,,,,,1,1,7.784546453,19004,8838,8540,298,1,297
17669,10269,10651,0,0,4082,,,,,,1,1,0.857016739,1875,1012,829,183,1,182
17669,10802,10443,0,0,5472,,,,,,1,1,1.132259497,2526,1379,1191,188,1,187
17669,10281,9578,0,0,35957,,,,,,1,1,7.376864603,18813,8429,8143,286,3,283
17669,9770,9921,2,0,37759,,,,,,1,1,7.825584895,19039,9197,8871,326,7,319
17669,10154,10162,0,0,35064,,,,,,1,1,7.279427216,18075,8344,8043,301,1,300
17669,10549,10471,0,0,14831,,,,,,1,1,3.030924737,7318,3614,3329,285,0,285
17669,10381,10398,0,0,36019,,,,,,1,1,7.493010194,18591,8547,8213,334,1,333
17669,10149,10297,0,0,37556,,,,,,1,1,7.715662189,19116,9076,8788,288,5,283
17669,10632,9032,4,0,35768,,,,,,1,1,7.352444095,18593,8452,8181,271,5,266
17669,10200,10787,4,0,13736,,,,,,1,1,2.821539618,6826,3331,3083,248,6,242
17669,9718,11261,0,0,18096,,,,,,1,1,3.779749658,9063,4375,4092,283,2,281
17669,10926,9892,0,0,34767,,,,,,1,1,7.1627579279999996,18153,8153,7845,308,2,306
17669,10591,10064,0,2,36121,,,,,,1,1,7.4048754500000005,18680,8563,8248,315,1,314
17669,9268,8487,0,0,36853,,,,,,1,1,7.668514309,18998,8795,8530,265,3,262
17669,8840,10701,0,0,37080,,,,,,1,1,7.775929034,19105,8843,8554,289,1,288
17669,10061,10387,0,3,37975,,,,,,1,1,7.836325163,19298,9175,8848,327,3,324
17669,10080,10268,0,0,36474,,,,,,1,1,7.4737503499999995,18973,8589,8266,323,2,321
17669,10259,10149,3,2,35173,,,,,,1,1,7.306985661,18372,8272,8015,257,2,255
17669,10856,10065,0,0,9665,,,,,,1,1,2.17496684,4593,2420,2188,232,0,232
17669,11099,8953,2,0,36299,,,,,,1,1,7.528240042,18864,8573,8284,289,1,288
17669,9501,8826,2,0,35194,,,,,,1,1,7.279774494,18734,8102,7846,256,1,255
17669,9436,9822,0,4,37520,,,,,,1,1,7.775055947,19280,8976,8688,288,4,284
17669,7665,10535,0,0,37134,,,,,,1,1,7.785314001,19416,8717,8433,284,3,281
17669,8791,9914,0,2,37394,,,,,,1,1,7.799787242,19074,9006,8698,308,2,306
17669,10938,10310,0,0,2509,,,,,,1,1,0.521336004,1078,643,498,145,0,145
17669,9540,11379,0,2,34270,,,,,,1,1,7.217245733,17499,8227,7910,317,1,316
17669,10843,10076,1,0,14857,,,,,,1,1,3.09031054,7334,3631,3370,261,1,260
17669,10357,10570,0,4,10898,,,,,,1,1,2.234649893,5303,2669,2412,257,8,249
17669,10744,9793,0,0,36313,,,,,,1,1,7.535595424,18706,8651,8346,305,0,305
17669,10332,10332,4,4,37343,,,,,,1,1,7.683492756,19172,8943,8658,285,1,284
17669,10158,10632,2,0,37148,,,,,,1,1,7.622164109,19027,8884,8531,353,2,351
17669,10217,10829,0,0,10102,,,,,,1,1,2.07723058,5088,2395,2171,224,3,221
17669,10073,10090,0,0,36938,,,,,,1,1,7.675051213,18864,8877,8557,320,0,320
17669,9843,9819,7,0,35596,,,,,,1,1,7.53181377,18143,8588,8311,277,6,271
17669,9873,10546,1,2,34266,,,,,,1,1,7.065768417,17982,7998,7710,288,3,285
17669,10872,10052,0,0,1030,,,,,,1,1,0.219791981,368,276,166,110,1,109
17669,11503,9422,0,0,6691,,,,,,1,1,1.3914620420000001,3247,1609,1383,226,1,225
17669,9916,10097,0,2,35669,,,,,,1,1,7.328276022,18533,8421,8127,294,1,293
17669,10037,10265,2,2,35597,,,,,,1,1,7.356933054,18610,8338,8027,311,1,310
17669,10160,8955,2,0,36712,,,,,,1,1,7.523948298,18738,8851,8579,272,3,269
17669,10339,10589,2,2,6066,,,,,,1,1,1.244794946,2943,1459,1254,205,1,204
17669,10452,10468,0,0,9998,,,,,,1,1,2.092825994,4867,2449,2216,233,1,232
17669,11000,9923,0,0,2109,,,,,,1,1,0.442316899,934,520,385,135,0,135
17669,10134,10446,0,0,36265,,,,,,1,1,7.505966752,18693,8631,8321,310,0,310
17669,10808,9864,0,3,36995,,,,,,1,1,7.573134515,19338,8665,8338,327,2,325
17669,8640,10402,0,2,37015,,,,,,1,1,7.655644809,18964,8889,8616,273,3,270
17669,8646,9486,0,0,37994,,,,,,1,1,7.923867366,19463,9123,8838,285,2,283
17669,9898,9902,2,0,37915,,,,,,1,1,7.836636398,19024,9285,8964,321,2,319
17669,10013,10124,0,2,37056,,,,,,1,1,7.7502287039999995,18987,8886,8589,297,2,295
17669,10703,9337,0,2,37072,,,,,,1,1,7.612843844,18906,8936,8642,294,7,287
17669,10294,10424,2,0,34654,,,,,,1,1,7.311334785,17998,8183,7893,290,0,290
17669,10485,10214,1,2,37954,,,,,,1,1,7.879150217,19164,9234,8912,322,0,322
17669,9406,10325,0,0,34637,,,,,,1,1,7.287085869,18084,8137,7858,279,1,278
17669,10899,8981,0,2,37187,,,,,,1,1,7.72728133,18797,9050,8760,290,0,290
17669,10906,10015,0,2,18722,,,,,,1,1,3.85366022,9348,4548,4270,278,6,272
17669,10234,10314,0,0,35687,,,,,,1,1,7.350495257,18505,8441,8141,300,7,293
17669,10676,10251,0,0,3764,,,,,,1,1,0.789888369,1745,919,738,181,1,180
17669,10439,9704,0,0,35153,,,,,,1,1,7.201925021,18292,8288,8003,285,2,283
17669,9772,9768,2,0,35954,,,,,,1,1,7.398474,18857,8409,8130,279,2,277
17669,10654,10266,0,0,6760,,,,,,1,1,1.452767201,3243,1651,1436,215,1,214
17669,11125,8668,2,2,36191,,,,,,1,1,7.464505991,18811,8546,8258,288,3,285
17669,9672,11284,0,4,16179,,,,,,1,1,3.423502345,8121,3898,3636,262,6,256
17669,10317,10611,2,0,4668,,,,,,1,1,1.002889509,2249,1116,929,187,0,187
17669,10358,8884,0,2,37191,,,,,,1,1,7.8964642210000004,18908,8983,8666,317,2,315
17669,9241,11700,0,2,2046,,,,,,1,1,0.427679891,884,518,392,126,1,125
17669,10199,10733,0,0,3911,,,,,,1,1,0.804240605,1778,978,801,177,0,177
17669,9204,11726,0,0,3039,,,,,,1,1,0.628734455,1341,771,615,156,0,156
17669,9738,11032,1,4,34860,,,,,,1,1,7.341035939,18394,8095,7819,276,2,274
17669,11271,9651,0,0,13566,,,,,,1,1,2.8177591189999998,6743,3285,3032,253,1,252
17669,10717,10114,2,0,34225,,,,,,1,1,7.15478795,17983,7966,7656,310,2,308
17669,9687,11220,0,0,38788,,,,,,1,1,7.928004022,19443,9498,9149,349,0,349
17669,10463,9184,0,2,37079,,,,,,1,1,7.568760213,18887,8953,8667,286,0,286
17669,10418,10233,2,2,36335,,,,,,1,1,7.520468001,18435,8804,8512,292,1,291
17669,8810,10726,0,3,37728,,,,,,1,1,7.734434663,19327,9055,8764,291,6,285
17669,11011,9920,0,4,4032,,,,,,1,1,0.853329828,1825,1017,844,173,2,171
17669,10078,10841,0,5,12612,,,,,,1,1,2.529405907,6388,2997,2767,230,4,226
17669,10277,10819,2,9,15302,,,,,,1,1,3.01752769,7793,3640,3411,229,8,221
17669,10084,10381,4,2,35890,,,,,,1,1,7.407129906,18490,8551,8253,298,2,296
17669,9694,10179,0,0,37833,,,,,,1,1,7.876179735,19294,9114,8803,311,2,309
17669,10530,9592,0,6,34608,,,,,,1,1,7.175060378,18361,7982,7699,283,3,280
17669,10618,9900,2,4,36508,,,,,,1,1,7.556040196,18595,8808,8511,297,10,287
17669,10588,9139,0,2,35955,,,,,,1,1,5.891006537,18321,8676,8394,282,6,276
17669,9109,10993,2,4,35561,,,,,,1,1,5.748973467,18409,8442,8174,268,0,268
17669,9701,10289,1,0,38401,,,,,,1,1,7.632291352,19255,9414,9096,318,9,309
17669,9898,11021,0,2,30006,,,,,,1,1,4.437970784,15091,7300,6985,315,0,315
17669,10122,10552,2,0,35317,,,,,,1,1,7.280646866,18054,8488,8201,287,0,287
17669,9183,11118,2,0,37022,,,,,,1,1,7.365290158,19065,8827,8524,303,5,298
17669,9813,9728,2,0,34234,,,,,,1,1,6.098443697,18054,7956,7688,268,3,265
17669,11031,8703,0,0,34011,,,,,,1,1,6.996030387,17905,7919,7651,268,1,267
17669,11037,9563,0,0,37387,,,,,,1,1,7.69567629,19085,8989,8665,324,0,324
17669,9918,9533,0,0,34375,,,,,,1,1,7.074718555,18172,7958,7671,287,2,285
17669,10812,9583,2,0,36685,,,,,,1,1,5.303612263,18646,8866,8559,307,6,301
17669,9944,8774,0,0,36636,,,,,,1,1,5.617533781,18875,8740,8459,281,5,276
17669,9320,9425,2,0,34741,,,,,,1,1,6.692516087,18380,8051,7792,259,5,254
17669,9765,10766,2,1,37625,,,,,,1,1,6.600029777,19085,9112,8796,316,6,310
17669,9780,10578,1,0,36628,,,,,,1,1,6.309230603,18887,8718,8413,305,2,303
