key_bits,recovered_zeros_x,recovered_zeros_y,wrong_zeros_x,wrong_zeros_y,queries,traces,calibration_traces,threshold,tpr,tnr,attack_tpr,attack_tnr,duration_seconds,test_outcomes_0_false,test_outcomes_0_true,test_outcomes_1_false,test_outcomes_1_true,test_outcomes_2_false,test_outcomes_2_true
17669,11504,9818,2,0,3987,,,,,,1,1,0.834739132,1781,1013,833,180,2,178
17669,11521,9874,0,2,4373,,,,,,1,1,0.895903929,1921,1139,965,174,2,172
17669,11079,10285,0,0,4189,,,,,,1,1,0.900666283,1962,1023,842,181,0,181
17669,10070,11290,0,0,4924,,,,,,1,1,1.022861288,2388,1175,989,186,1,185
17669,11093,10080,2,0,5770,,,,,,1,1,1.181960695,2770,1401,1203,198,1,197
17669,9821,11669,0,0,6051,,,,,,1,1,1.273611556,2916,1463,1254,209,0,209
17669,11108,10408,2,2,6699,,,,,,1,1,1.413465217,3118,1684,1471,213,5,208
17669,10931,10239,0,0,7379,,,,,,1,1,1.5358943950000001,3492,1843,1642,201,0,201
17669,10201,10976,0,0,1242,,,,,,1,1,0.262473153,508,312,202,110,1,109
17669,10777,10407,0,1,5051,,,,,,1,1,1.070695495,2348,1255,1062,193,3,190
17669,9925,11287,0,0,4639,,,,,,1,1,0.964920116,2091,1175,977,198,0,198
17669,10525,10680,0,2,7682,,,,,,1,1,1.5710408980000001,3656,1906,1692,214,1,213
17669,10370,10801,0,0,12571,,,,,,1,1,2.591421983,6158,3081,2830,251,0,251
17669,11846,9331,0,0,7334,,,,,,1,1,1.540583542,3595,1768,1565,203,0,203
17669,10869,10406,4,0,20123,,,,,,1,1,4.063544365,10213,4812,4526,286,2,284
17669,10637,10534,0,0,3530,,,,,,1,1,0.769898841,1653,860,703,157,0,157
17669,10157,11394,4,4,22019,,,,,,1,1,4.648979864,11166,5291,5020,271,1,270
17669,9835,11335,2,2,23135,,,,,,1,1,4.779697213,11951,5432,5112,320,9,311
17669,11612,9905,0,0,5710,,,,,,1,1,1.183719174,2729,1383,1168,215,0,215
17669,11113,9767,3,0,34166,,,,,,1,1,7.172222558,18127,7878,7595,283,1,282
17669,10549,9811,0,2,35255,,,,,,1,1,7.297810006,18490,8243,7964,279,4,275
17669,10896,9351,1,1,35398,,,,,,1,1,7.302115251,18629,8252,7987,265,1,264
17669,10572,10050,0,2,35543,,,,,,1,1,7.386215806,18504,8374,8083,291,3,288
17669,9838,9070,2,2,35680,,,,,,1,1,7.532716586,18673,8368,8097,271,8,263
17669,9619,9271,2,2,35559,,,,,,1,1,7.541151973,18629,8327,8051,276,14,262
17669,9514,10878,2,0,36270,,,,,,1,1,7.545660582,18261,8855,8556,299,2,297
17669,9721,9170,2,0,36916,,,,,,1,1,7.624544606,19085,8766,8467,299,14,285
17669,9633,10520,2,2,36281,,,,,,1,1,7.636918721,18866,8542,8211,331,6,325
17669,10413,10261,2,0,36166,,,,,,1,1,7.729937831,18561,8651,8348,303,1,302
17669,10230,11262,0,1,36630,,,,,,1,1,7.785990508,18594,8862,8550,312,0,312
17669,10199,9012,2,0,37535,,,,,,1,1,7.811001883,19360,8945,8660,285,1,284
17669,10337,10939,2,0,2310,,,,,,1,1,0.573397915,968,602,464,138,2,136
17669,10476,10432,0,0,37552,,,,,,1,1,7.952281724,19051,9092,8775,317,4,313
17669,10012,10814,6,2,35566,,,,,,1,1,7.391093774,18237,8504,8183,321,20,301
17669,10920,10540,0,0,4188,,,,,,1,1,0.872611274,1946,1036,866,170,1,169
17669,10565,9329,4,0,35831,,,,,,1,1,7.296955015,18276,8616,8293,323,4,319
17669,10098,9364,0,2,36561,,,,,,1,1,8.096496565,19008,8637,8358,279,4,275
17669,10341,8234,0,0,36834,,,,,,1,1,8.129104775,18950,8803,8525,278,2,276
17669,10631,10628,0,0,2324,,,,,,1,1,0.486958644,1039,569,422,147,0,147
17669,10780,10455,2,0,9312,,,,,,1,1,2.076682481,4470,2299,2055,244,2,242
17669,11610,9565,0,2,6285,,,,,,1,1,1.303396486,2996,1532,1307,225,5,220
17669,10462,10129,4,2,37022,,,,,,1,1,7.854664851,18715,9004,8705,299,4,295
17669,10379,10400,2,0,32063,,,,,,1,1,6.713367663,16989,7407,7147,260,1,259
17669,11599,9913,0,0,3554,,,,,,1,1,0.818398398,1639,880,725,155,0,155
17669,10953,10056,0,2,36128,,,,,,1,1,7.496173591,18701,8561,8256,305,1,304
17669,10282,11258,0,0,6758,,,,,,1,1,1.466582484,3256,1652,1454,198,0,198
17669,10377,10543,0,0,36341,,,,,,1,1,7.8661009360000005,18750,8628,8293,335,4,331
17669,9626,11575,2,0,19941,,,,,,1,1,4.581479052,9824,4914,4625,289,2,287
17669,11017,9763,1,2,35833,,,,,,1,1,7.48267823,18423,8530,8180,350,14,336
17669,10003,11079,0,0,35468,,,,,,1,1,7.416688545,18446,8359,8055,304,1,303
17669,10926,10353,0,2,3152,,,,,,1,1,0.643504457,1430,788,642,146,3,143
17669,9589,11362,0,4,35400,,,,,,1,1,7.67677195,18159,8471,8172,299,5,294
17669,10685,10613,0,0,4313,,,,,,1,1,0.866990268,2009,1060,876,184,0,184
17669,10726,10600,0,0,15335,,,,,,1,1,3.257740474,7567,3741,3455,286,1,285
17669,9630,11626,2,3,15417,,,,,,1,1,3.334389383,7833,3649,3363,286,8,278
17669,11430,9854,2,0,5863,,,,,,1,1,1.189293604,2839,1413,1215,198,1,197
17669,10457,10955,0,2,27747,,,,,,1,1,5.879931952,14073,6697,6417,280,8,272
17669,10836,10336,2,0,10573,,,,,,1,1,2.165180966,5156,2603,2392,211,0,211
17669,10294,10911,1,2,22362,,,,,,1,1,4.75248758,11339,5370,5087,283,2,281
17669,10887,10298,5,0,31499,,,,,,1,1,6.519711146,16131,7526,7210,316,2,314
17669,10888,9079,0,0,37161,,,,,,1,1,7.638034128,18980,8939,8636,303,1,302
17669,10486,10477,0,0,37133,,,,,,1,1,7.698001328,18638,9081,8748,333,1,332
17669,9660,10907,0,0,35769,,,,,,1,1,7.599030691,18450,8501,8184,317,0,317
17669,10736,9657,2,2,35720,,,,,,1,1,7.415965223,18524,8445,8139,306,4,302
17669,10096,10070,0,2,36897,,,,,,1,1,7.865590271,18912,8847,8556,291,2,289
17669,10490,9100,0,0,36080,,,,,,1,1,7.411358577,18444,8678,8398,280,3,277
17669,7995,9070,4,2,37059,,,,,,1,1,7.93462596,18996,8920,8697,223,3,220
17669,9510,10899,0,0,37162,,,,,,1,1,7.646279757,18874,8990,8682,308,2,306
17669,9072,12097,0,0,3834,,,,,,1,1,0.890661331,1731,967,798,169,0,169
17669,9319,10977,0,4,36594,,,,,,1,1,7.888408679,19012,8620,8278,342,3,339
17669,10412,9028,4,2,37680,,,,,,1,1,7.681063518,19248,9049,8715,334,6,328
17669,10071,11104,3,0,6900,,,,,,1,1,1.445188471,3232,1724,1504,220,3,217
17669,9737,9330,0,0,37853,,,,,,1,1,8.179906641,19277,9144,8856,288,1,287
17669,10708,9109,6,4,34823,,,,,,1,1,7.1737084939999995,17942,8316,8067,249,6,243
17669,9489,11680,0,0,19049,,,,,,1,1,3.94451881,9310,4723,4430,293,1,292
17669,9587,11582,2,0,17739,,,,,,1,1,3.667431969,9309,4087,3831,256,0,256
17669,9476,11230,0,2,34881,,,,,,1,1,7.209445466,18242,8170,7871,299,8,291
17669,11237,10237,0,0,6860,,,,,,1,1,1.469055763,3309,1669,1456,213,0,213
17669,8550,9701,0,2,36637,,,,,,1,1,7.592557755,19245,8548,8252,296,11,285
17669,10130,10455,2,2,37183,,,,,,1,1,7.555276866,19252,8818,8523,295,2,293
17669,10974,9646,2,2,38409,,,,,,1,1,7.917326914,19602,9244,8925,319,4,315
17669,10011,10511,0,0,36979,,,,,,1,1,7.52452094,18809,8935,8635,300,1,299
17669,8269,10987,0,2,36883,,,,,,1,1,7.835070039,18990,8822,8573,249,2,247
17669,10793,10529,4,1,25105,,,,,,1,1,5.163479852,13011,5892,5582,310,2,308
17669,11215,8866,2,0,36503,,,,,,1,1,7.918867751,18612,8805,8524,281,3,278
17669,10502,10669,2,2,8191,,,,,,1,1,1.669336677,4056,1953,1724,229,7,222
17669,9334,9937,2,2,36953,,,,,,1,1,7.671837629,18942,8873,8608,265,1,264
17669,10342,9789,3,0,36865,,,,,,1,1,7.634449236,18919,8827,8535,292,4,288
17669,9572,10906,0,2,37153,,,,,,1,1,7.927686929,18892,8961,8622,339,3,336
17669,10937,9611,2,0,33985,,,,,,1,1,7.265007164,18022,7832,7533,299,0,299
17669,10721,10536,0,2,7634,,,,,,1,1,1.696886728,3628,1898,1688,210,7,203
17669,11168,9780,4,0,38635,,,,,,1,1,8.263848555,19359,9449,9071,378,16,362
17669,11495,9126,3,2,35563,,,,,,1,1,7.361723781,18296,8485,8188,297,3,294
17669,10364,9734,0,0,35293,,,,,,1,1,7.389661096,18372,8296,7967,329,3,326
17669,10382,9607,2,0,35496,,,,,,1,1,7.442939807,18522,8340,8046,294,1,293
17669,10075,11096,0,0,8216,,,,,,1,1,1.667187588,4091,1942,1701,241,1,240
17669,10454,9687,4,1,38508,,,,,,1,1,8.055414098,19767,9201,8862,339,18,321
17669,9969,10162,4,5,37494,,,,,,1,1,7.659852027,19246,8966,8650,316,15,301
17669,10067,11102,0,0,13552,,,,,,1,1,2.748414427,6697,3301,3048,253,1,252
17669,10063,10085,2,2,37516,,,,,,1,1,8.029190525,19164,9008,8672,336,4,332
17669,9771,8009,0,0,38532,,,,,,1,1,7.83472906,19640,9303,9017,286,3,283
17669,10180,11074,2,4,17662,,,,,,1,1,3.564968649,8817,4283,4004,279,6,273
17669,10600,10871,0,6,11363,,,,,,1,1,2.305407001,5484,2827,2602,225,0,225
17669,10609,10623,0,0,2422,,,,,,1,1,0.529521357,1055,610,463,147,1,146
17669,9667,9498,0,4,36417,,,,,,1,1,7.435061604,18959,8592,8318,274,0,274
17669,10507,8899,0,2,37384,,,,,,1,1,7.73792598,19197,8945,8648,297,4,293
17669,10621,10555,2,0,2463,,,,,,1,1,0.503339191,1022,645,494,151,0,151
17669,10993,10259,2,2,2595,,,,,,1,1,0.53222067,1133,652,494,158,1,157
17669,10382,10026,0,0,37274,,,,,,1,1,7.820865436,18866,9033,8691,342,2,340
17669,9712,10758,1,2,36827,,,,,,1,1,7.529238918,18973,8793,8525,268,4,264
17669,10753,10416,0,0,21022,,,,,,1,1,4.483434106,10772,4985,4705,280,4,276
17669,10514,10369,0,2,38103,,,,,,1,1,7.77603053,19356,9211,8886,325,1,324
17669,10020,9149,2,0,37779,,,,,,1,1,7.929020653,19171,9162,8878,284,2,282
17669,9633,10889,2,0,34558,,,,,,1,1,7.445678033,18116,8083,7807,276,2,274
17669,10612,10860,2,0,5854,,,,,,1,1,1.240887205,2827,1403,1182,221,1,220
17669,9453,9795,0,0,36326,,,,,,1,1,7.809497663,18925,8553,8258,295,4,291
17669,10600,10712,1,4,18796,,,,,,1,1,3.9707676469999997,9345,4585,4304,281,11,270
17669,10986,10199,0,0,3114,,,,,,1,1,0.653115355,1412,768,602,166,0,166
17669,8799,10213,0,0,38042,,,,,,1,1,8.154014716,19188,9285,9001,284,0,284
17669,10842,10547,2,3,6281,,,,,,1,1,1.5368425559999999,2925,1567,1345,222,1,221
17669,10826,9781,2,0,37627,,,,,,1,1,8.118510387,19031,9130,8794,336,2,334
17669,11128,9233,1,0,35419,,,,,,1,1,8.528663435,18444,8333,8024,309,5,304
17669,11360,10150,2,2,4679,,,,,,1,1,1.3574565189999999,2157,1169,985,184,2,182
17669,10239,7962,0,0,36516,,,,,,1,1,8.184498512,19165,8550,8299,251,4,247
17669,9727,11423,0,2,35000,,,,,,1,1,7.990272239,18022,8340,8042,298,6,292
17669,10945,10230,0,2,6306,,,,,,1,1,1.668372027,3003,1544,1329,215,5,210
17669,11160,9551,3,0,35267,,,,,,1,1,7.877719681,18570,8204,7915,289,5,284
17669,9815,11356,0,0,5842,,,,,,1,1,1.182009899,2702,1472,1276,196,0,196
17669,7964,10771,0,0,37164,,,,,,1,1,8.641481711,19094,8891,8603,288,3,285
17669,9104,9819,0,2,37210,,,,,,1,1,8.138828569,18922,9003,8721,282,1,281
17669,9623,11716,2,0,2062,,,,,,1,1,0.421404497,876,517,365,152,1,151
17669,10881,10339,0,0,1951,,,,,,1,1,0.409040923,852,485,356,129,0,129
17669,8927,8964,0,0,38858,,,,,,1,1,9.009638494,19877,9345,9054,291,1,290
17669,9898,11272,0,1,18261,,,,,,1,1,4.463699192,9141,4419,4137,282,1,281
17669,10680,9779,2,0,36156,,,,,,1,1,8.09612538,18362,8735,8411,324,1,323
17669,9295,11930,4,2,2788,,,,,,1,1,0.601721824,1268,687,541,146,2,144
17669,11353,10104,0,0,1903,,,,,,1,1,0.432338203,819,478,350,128,0,128
17669,9387,11315,0,0,34588,,,,,,1,1,7.835070584,17775,8258,7961,297,2,295
17669,9940,9956,0,0,36833,,,,,,1,1,8.393028986000001,18698,8915,8610,305,2,303
17669,10268,10903,0,0,1413,,,,,,1,1,0.290860333,520,385,262,123,0,123
17669,10405,9700,0,0,35999,,,,,,1,1,8.089954333,18329,8687,8391,296,3,293
17669,10386,10785,0,2,8029,,,,,,1,1,1.768323454,4016,1904,1699,205,2,203
17669,9852,10981,2,8,38163,,,,,,1,1,8.668140938,19344,9256,8949,307,10,297
17669,10281,10889,0,0,8396,,,,,,1,1,1.7381441720000002,4222,1983,1775,208,1,207
17669,10561,10036,0,0,35774,,,,,,1,1,7.955993212,18305,8592,8307,285,2,283
17669,9983,11284,2,2,13345,,,,,,1,1,3.173074811,6550,3273,3024,249,5,244
17669,10204,10221,0,0,35361,,,,,,1,1,7.923580902,18365,8340,8024,316,4,312
17669,11131,10044,0,0,5013,,,,,,1,1,1.186229365,2408,1207,1016,191,0,191
17669,9328,10888,0,4,35826,,,,,,1,1,7.640792378,18516,8510,8220,290,0,290
17669,10566,10610,0,0,3636,,,,,,1,1,0.758627375,1645,911,742,169,0,169
17669,9815,11355,0,0,15333,,,,,,1,1,3.128043879,7897,3579,3301,278,2,276
17669,9312,9402,0,4,36395,,,,,,1,1,7.716844623,19273,8434,8180,254,1,253
17669,11343,9828,0,0,5992,,,,,,1,1,1.248577238,2881,1448,1233,215,0,215
17669,10533,10043,3,2,36837,,,,,,1,1,8.202224978,18722,8911,8618,293,3,290
17669,10116,11058,0,2,4373,,,,,,1,1,0.985842744,2092,1051,872,179,2,177
17669,10995,10176,0,2,13682,,,,,,1,1,2.757287538,6580,3418,3152,266,1,265
17669,10792,10386,2,0,1950,,,,,,1,1,0.440649825,823,491,346,145,3,142
17669,8980,9279,2,2,38435,,,,,,1,1,8.556212547,19084,9527,9230,297,6,291
17669,9706,10698,2,0,36786,,,,,,1,1,8.032647488,18699,8858,8487,371,9,362
17669,8813,10486,0,4,36919,,,,,,1,1,7.993087876,18954,8844,8567,277,8,269
17669,10425,9983,2,2,37677,,,,,,1,1,8.392545219,19457,8952,8636,316,3,313
17669,11113,10056,0,0,7714,,,,,,1,1,1.6970753520000001,3778,1861,1647,214,1,213
17669,9998,9898,0,0,36009,,,,,,1,1,7.708966354,18724,8493,8194,299,4,295
17669,11297,9981,0,0,2970,,,,,,1,1,0.610196626,1414,696,532,164,1,163
17669,10642,10672,0,0,2418,,,,,,1,1,0.493335106,1048,603,439,164,0,164
17669,9723,10928,2,0,34607,,,,,,1,1,7.61160131,18032,8143,7854,289,3,286
17669,10078,9989,0,0,35186,,,,,,1,1,7.631739416,18451,8217,7916,301,1,300
17669,10826,9259,0,4,36742,,,,,,1,1,7.631410325,18669,8893,8606,287,3,284
17669,10563,10606,0,0,31797,,,,,,1,1,6.8690504919999995,16307,7601,7313,288,1,287
17669,10593,10580,0,0,7061,,,,,,1,1,1.427789038,3429,1719,1525,194,0,194
17669,8946,9186,0,0,36786,,,,,,1,1,7.978576792,19040,8747,8495,252,2,250
17669,10551,10749,0,4,5391,,,,,,1,1,1.142978987,2538,1341,1170,171,2,169
17669,9070,9613,1,0,36073,,,,,,1,1,7.590952627,18839,8466,8164,302,2,300
17669,10788,9304,4,2,35620,,,,,,1,1,7.338099766,18453,8439,8150,289,5,284
17669,9906,9229,0,4,36117,,,,,,1,1,7.379944517,18868,8494,8233,261,2,259
17669,11042,10504,0,0,15675,,,,,,1,1,3.270304111,7648,3873,3592,281,1,280
17669,10423,10075,0,0,35528,,,,,,1,1,7.69367114,18040,8591,8285,306,0,306
17669,10662,10510,4,0,3546,,,,,,1,1,0.747190328,1694,847,689,158,2,156
17669,10357,10320,5,0,37647,,,,,,1,1,7.960976762,18852,9244,8937,307,5,302
17669,10258,10613,0,0,37663,,,,,,1,1,7.724653288,19061,9134,8800,334,1,333
17669,9115,12095,0,5,26819,,,,,,1,1,5.5794479930000005,13993,6261,5957,304,22,282
17669,10333,10836,0,3,14395,,,,,,1,1,3.043946776,7345,3403,3159,244,0,244
17669,10357,10812,0,2,11141,,,,,,1,1,2.364228085,5458,2718,2471,247,9,238
17669,10752,10510,0,4,14853,,,,,,1,1,3.094206894,7226,3679,3410,269,5,264
17669,11469,8684,4,2,36780,,,,,,1,1,7.986119074,18820,8817,8491,326,9,317
17669,8481,10554,0,0,37470,,,,,,1,1,7.699162695,18914,9141,8867,274,2,272
17669,9755,11417,0,0,8211,,,,,,1,1,1.663349936,3945,2022,1800,222,1,221
17669,10024,11145,0,2,35879,,,,,,1,1,7.549424638,17870,8826,8469,357,8,349
17669,10838,9737,0,2,35768,,,,,,1,1,7.524563123,18562,8454,8156,298,4,294
17669,10556,10273,2,0,36514,,,,,,1,1,7.62589002,18642,8789,8495,294,1,293
17669,9995,10545,2,2,36241,,,,,,1,1,7.452859459,18742,8596,8289,307,2,305
17669,10716,9284,0,0,35902,,,,,,1,1,7.361435063,18643,8477,8172,305,3,302
17669,10144,11201,0,0,3500,,,,,,1,1,0.710675275,1561,871,674,197,0,197
17669,10424,10746,0,0,1984,,,,,,1,1,0.405748682,829,511,378,133,0,133
17669,10689,8501,2,0,35895,,,,,,1,1,7.511075705,18773,8426,8156,270,2,268
17669,9639,11547,0,0,3413,,,,,,1,1,0.67569992,1487,874,696,178,0,178
17669,9803,8757,0,0,38866,,,,,,1,1,7.865239083,19362,9594,9278,316,1,315
17669,8807,10608,0,0,35635,,,,,,1,1,7.245666314,18542,8398,8101,297,4,293
17669,10380,10794,0,0,22598,,,,,,1,1,4.71294399,11557,5377,5090,287,2,285
17669,10094,10775,4,0,35675,,,,,,1,1,7.288427426,18654,8364,8071,293,5,288
17669,10085,11023,2,2,34356,,,,,,1,1,7.023220481,18074,7982,7664,318,3,315
17669,9869,10891,0,0,35383,,,,,,1,1,7.436681837,18299,8407,8137,270,5,265
17669,10706,10652,0,2,15593,,,,,,1,1,3.259651535,7900,3713,3446,267,2,265
17669,10673,10723,0,0,6821,,,,,,1,1,1.408302964,3235,1689,1481,208,0,208
17669,11747,9324,2,0,35109,,,,,,1,1,7.190592077,18280,8273,7990,283,2,281
17669,10521,10477,1,0,35076,,,,,,1,1,7.22573595,18497,8151,7874,277,2,275
17669,10369,10874,2,0,1425,,,,,,1,1,0.291763149,533,387,269,118,0,118
17669,9259,11931,0,0,1431,,,,,,1,1,0.335551268,592,355,226,129,0,129
17669,9317,12030,2,2,3501,,,,,,1,1,0.712327774,1556,890,725,165,2,163
17669,9992,11027,0,4,36005,,,,,,1,1,7.525392862,18328,8682,8369,313,2,311
17669,10780,10414,0,0,2392,,,,,,1,1,0.489264522,1003,628,495,133,0,133
17669,9137,10221,3,0,36293,,,,,,1,1,7.342627483,18672,8674,8401,273,4,269
17669,10164,10874,3,1,38402,,,,,,1,1,7.731066689,19477,9301,8978,323,12,311
17669,10374,9215,2,0,38077,,,,,,1,1,7.675719588,19550,9121,8836,285,2,283
17669,10183,10549,2,0,36525,,,,,,1,1,7.376986842,18888,8664,8355,309,4,305
17669,9845,11129,0,2,35721,,,,,,1,1,7.437457585,18425,8502,8210,292,4,288
17669,9535,11635,2,0,25951,,,,,,1,1,5.276629509,13305,6181,5897,284,2,282
17669,10422,10382,2,0,36225,,,,,,1,1,7.51900855,18709,8589,8251,338,2,336
17669,11333,9853,2,0,1885,,,,,,1,1,0.39653476,761,495,361,134,0,134
17669,8504,9854,0,0,36425,,,,,,1,1,7.622629082,18973,8597,8339,258,4,254
17669,10576,9802,1,0,35205,,,,,,1,1,7.12116735,18467,8225,7937,288,1,287
17669,11562,9614,2,0,6342,,,,,,1,1,1.311276484,3098,1520,1316,204,1,203
17669,11018,10155,2,2,5053,,,,,,1,1,1.055167088,2283,1285,1085,200,3,197
17669,10836,10502,0,1,6829,,,,,,1,1,1.4455345,3328,1652,1455,197,0,197
17669,9008,8830,0,0,37934,,,,,,1,1,7.798545138,19322,9169,8895,274,2,272
17669,10229,9893,2,0,35617,,,,,,1,1,7.264272236,18546,8379,8066,313,2,311
17669,11220,9959,0,2,3128,,,,,,1,1,0.647211565,1368,794,622,172,1,171
17669,10778,10391,0,1,14940,,,,,,1,1,3.0399825,7791,3445,3186,259,0,259
17669,10092,9487,3,0,36231,,,,,,1,1,7.477774442,18745,8596,8302,294,1,293
17669,9948,11240,0,0,2914,,,,,,1,1,0.605642243,1326,724,584,140,0,140
17669,8962,10956,0,0,38242,,,,,,1,1,7.823830408,18913,9488,9135,353,1,352
17669,9504,10335,0,0,35891,,,,,,1,1,7.371856964,18896,8359,8082,277,1,276
17669,10361,10260,2,2,35374,,,,,,1,1,7.24609339,18014,8537,8251,286,8,278
17669,10290,8099,0,0,36615,,,,,,1,1,7.62423025,18740,8805,8540,265,0,265
17669,10666,10633,2,0,13007,,,,,,1,1,2.649098275,6527,3130,2910,220,0,220
17669,9036,12161,2,2,24505,,,,,,1,1,4.968667753,11928,6120,5783,337,12,325
17669,9878,11291,2,0,20348,,,,,,1,1,4.225627401,10133,4956,4653,303,8,295
17669,9571,10612,2,0,37011,,,,,,1,1,7.71963339,18743,8978,8666,312,3,309
17669,10860,10310,0,0,26483,,,,,,1,1,5.500527186,13740,6229,5944,285,3,282
17669,11192,9441,0,2,35788,,,,,,1,1,7.344523692,18474,8507,8207,300,2,298
17669,9173,8282,0,0,36646,,,,,,1,1,7.666306123,19004,8697,8449,248,0,248
17669,10730,10459,2,0,5298,,,,,,1,1,1.087714342,2490,1303,1101,202,1,201
17669,9877,10511,0,0,36413,,,,,,1,1,7.500361332,18866,8627,8334,293,1,292
17669,10271,8485,0,0,38478,,,,,,1,1,8.093679729,19271,9461,9176,285,3,282
17669,12023,9225,0,0,5778,,,,,,1,1,1.308485911,2726,1419,1205,214,0,214
17669,10542,10384,0,0,35776,,,,,,1,1,7.487446267,18486,8487,8171,316,1,315
17669,8993,10510,0,3,38669,,,,,,1,1,7.8273697559999995,19439,9464,9162,302,1,301
17669,9976,10953,0,2,36360,,,,,,1,1,7.700414313,18715,8655,8320,335,18,317
17669,9548,10312,0,0,35405,,,,,,1,1,7.223580313,18558,8287,8014,273,3,270
17669,10365,10221,0,2,36359,,,,,,1,1,7.5978802210000005,18546,8761,8470,291,6,285
17669,10386,10815,0,0,2644,,,,,,1,1,0.539108776,1143,672,515,157,0,157
17669,11629,9182,2,0,35996,,,,,,1,1,7.294534018,18569,8546,8211,335,5,330
17669,10874,10400,0,0,6038,,,,,,1,1,1.247069203,2898,1459,1237,222,0,222
17669,11672,9497,0,2,7014,,,,,,1,1,1.440289763,3428,1688,1478,210,5,205
17669,10521,9685,0,0,36460,,,,,,1,1,7.739536244,18476,8833,8515,318,4,314
17669,10841,10573,0,2,4389,,,,,,1,1,0.888429497,2079,1065,885,180,0,180
17669,8085,10256,0,0,36647,,,,,,1,1,7.660588647,18876,8741,8452,289,0,289
17669,11424,9999,2,4,10481,,,,,,1,1,2.301336785,5098,2585,2372,213,0,213
17669,11419,9751,0,0,5812,,,,,,1,1,1.180521051,2746,1423,1203,220,0,220
17669,10077,11297,0,0,3732,,,,,,1,1,0.776004856,1729,916,745,171,0,171
17669,10013,10479,0,2,35469,,,,,,1,1,7.397030565,18316,8422,8113,309,4,305
17669,10599,10579,2,0,6643,,,,,,1,1,1.348211812,3195,1600,1352,248,2,246
17669,10726,10317,2,2,35330,,,,,,1,1,7.143249249,18242,8389,8079,310,3,307
17669,10603,10567,0,0,2108,,,,,,1,1,0.471463916,943,509,362,147,1,146
17669,10449,10893,0,1,5062,,,,,,1,1,1.201484181,2383,1242,1047,195,0,195
17669,10687,9102,0,0,36346,,,,,,1,1,7.566912739,18543,8762,8483,279,3,276
17669,10663,10563,0,4,13853,,,,,,1,1,2.976170638,6681,3452,3184,268,2,266
17669,10071,11101,0,2,3781,,,,,,1,1,0.880860575,1681,947,741,206,1,205
17669,10214,9978,0,0,37329,,,,,,1,1,7.936617231,19245,8874,8538,336,2,334
17669,10797,9107,2,0,35961,,,,,,1,1,7.434120875,18644,8530,8273,257,2,255
17669,10653,9786,2,0,37819,,,,,,1,1,8.099519385,18980,9259,8938,321,7,314
17669,10503,10666,0,0,13111,,,,,,1,1,2.691402835,6557,3175,2971,204,2,202
17669,10297,10871,0,3,35496,,,,,,1,1,7.326014224,18422,8359,8003,356,3,353
17669,9294,9708,0,3,36950,,,,,,1,1,7.570421142,19063,8795,8498,297,5,292
17669,10285,10887,0,0,7085,,,,,,1,1,1.464309205,3510,1685,1480,205,1,204
17669,9201,8844,2,0,36845,,,,,,1,1,7.594800456,19134,8734,8491,243,4,239
17669,10427,10742,0,0,5791,,,,,,1,1,1.284941373,2834,1385,1198,187,0,187
17669,11172,9025,0,0,35529,,,,,,1,1,7.442301114,18591,8323,8031,292,4,288
17669,10616,10553,2,0,33213,,,,,,1,1,7.394359151,17320,7793,7486,307,6,301
17669,9471,10492,2,2,36910,,,,,,1,1,7.757500983,18800,8899,8587,312,1,311
17669,9830,10828,2,0,33595,,,,,,1,1,7.195881888,18105,7605,7325,280,3,277
17669,10950,10249,0,0,3104,,,,,,1,1,0.67228227,1385,777,612,165,0,165
17669,11415,9755,2,0,14129,,,,,,1,1,3.015979835,6981,3443,3181,262,1,261
17669,10171,11239,0,2,2446,,,,,,1,1,0.586687309,1025,628,463,165,0,165
17669,10281,10371,4,2,35796,,,,,,1,1,7.666754789,18659,8416,8111,305,12,293
17669,9517,11653,0,4,32468,,,,,,1,1,7.030201591,16518,7818,7504,314,7,307
17669,10486,8254,2,0,37248,,,,,,1,1,7.6250731290000004,19030,8964,8674,290,14,276
17669,11511,9656,0,4,33588,,,,,,1,1,7.199642082,17688,7827,7581,246,4,242
17669,10379,10159,4,0,37757,,,,,,1,1,7.93950898,19351,9054,8756,298,0,298
17669,10388,11063,0,0,9836,,,,,,1,1,2.310071026,4787,2402,2157,245,0,245
17669,9712,7907,0,0,38623,,,,,,1,1,8.132258583,19756,9309,9060,249,0,249
17669,9734,10847,2,2,36435,,,,,,1,1,8.155395344,18738,8703,8412,291,4,287
17669,10436,10417,0,0,36782,,,,,,1,1,7.480432646,18516,8956,8602,354,1,353
17669,8738,10186,0,1,37956,,,,,,1,1,8.212763289,19390,9150,8884,266,3,263
17669,10995,10184,0,4,5440,,,,,,1,1,1.149127023,2462,1388,1186,202,2,200
17669,10180,11219,0,0,2383,,,,,,1,1,0.488331238,975,633,491,142,0,142
17669,10496,10439,1,1,35592,,,,,,1,1,7.907616574,18613,8352,8077,275,4,271
17669,9913,11260,0,0,1268,,,,,,1,1,0.265606549,488,330,210,120,0,120
17669,9724,11512,2,2,2868,,,,,,1,1,0.582268415,1264,730,586,144,2,142
17669,10046,11191,0,4,4074,,,,,,1,1,0.811113389,1854,1025,855,170,2,168
17669,11421,9752,0,4,16030,,,,,,1,1,3.362945133,7948,3901,3621,280,5,275
17669,11190,9979,0,0,17431,,,,,,1,1,3.5229586470000003,8886,4128,3839,289,3,286
17669,11191,10043,0,2,4813,,,,,,1,1,1.001932192,2220,1204,1019,185,1,184
17669,9888,11658,0,0,2641,,,,,,1,1,0.542403614,1238,622,463,159,0,159
17669,10686,9868,0,0,36774,,,,,,1,1,7.789016599,18952,8760,8458,302,3,299
17669,10565,10687,0,0,6054,,,,,,1,1,1.22298688,2960,1452,1262,190,0,190
17669,8687,10486,0,2,37908,,,,,,1,1,8.181214726,18995,9320,9047,273,2,271
17669,10845,8230,2,0,38989,,,,,,1,1,8.319785452,19680,9511,9224,287,6,281
17669,10613,10037,0,0,35623,,,,,,1,1,7.567407654,18417,8448,8138,310,1,309
17669,9507,11301,3,2,35842,,,,,,1,1,7.818163615,18580,8487,8199,288,2,286
17669,8567,10821,2,0,38895,,,,,,1,1,8.255962671,19233,9672,9354,318,6,312
17669,10428,10828,4,0,7026,,,,,,1,1,1.527573456,3411,1709,1512,197,2,195
17669,10326,10850,0,0,4861,,,,,,1,1,0.995004799,2232,1210,1001,209,0,209
17669,10968,10563,2,4,15130,,,,,,1,1,3.243375391,7814,3518,3238,280,2,278
17669,10779,9900,3,0,35662,,,,,,1,1,7.657229616,18510,8427,8129,298,1,297
17669,11679,9512,0,0,2582,,,,,,1,1,0.530676545,1054,682,518,164,1,163
17669,10941,10178,0,3,35154,,,,,,1,1,7.480724635,17965,8445,8146,299,0,299
17669,9543,9257,0,0,36629,,,,,,1,1,7.453160209,18765,8783,8485,298,2,296
17669,8287,11605,0,2,36712,,,,,,1,1,7.642604911,18768,8829,8543,286,5,281
17669,9758,11415,0,0,5130,,,,,,1,1,1.080816655,2282,1327,1133,194,0,194
17669,10725,10698,4,4,29867,,,,,,1,1,6.126726639,15503,7028,6720,308,4,304
17669,9228,10249,0,1,36045,,,,,,1,1,7.448287714,18752,8514,8249,265,0,265
17669,10970,10100,4,2,36472,,,,,,1,1,7.673893285,18476,8850,8554,296,3,293
17669,11065,9689,6,2,37274,,,,,,1,1,7.798607158,19016,8987,8703,284,1,283
17669,10402,10012,0,4,36469,,,,,,1,1,7.697994584,19058,8560,8269,291,8,283
17669,10511,10932,0,0,4302,,,,,,1,1,0.866835681,1993,1061,874,187,0,187
17669,10716,10125,2,0,36232,,,,,,1,1,7.559141887,18850,8552,8274,278,2,276
17669,10527,10720,0,2,7220,,,,,,1,1,1.53798842,3438,1787,1579,208,1,207
17669,10805,10378,0,0,3327,,,,,,1,1,0.755521087,1440,860,693,167,1,166
17669,9466,9714,0,0,37826,,,,,,1,1,7.8006654730000005,19164,9173,8857,316,0,316
17669,8555,10889,0,0,37359,,,,,,1,1,7.642152042,19068,8990,8679,311,10,301
17669,9587,8730,0,0,37313,,,,,,1,1,7.72146608,19015,9005,8717,288,3,285
17669,8779,9262,0,3,38851,,,,,,1,1,8.029421935,19535,9528,9268,260,1,259
17669,9973,9138,4,0,35556,,,,,,1,1,7.358879672,18348,8472,8208,264,2,262
17669,9748,9048,0,4,35731,,,,,,1,1,7.246577342,18915,8275,8009,266,8,258
17669,10999,9018,3,0,36423,,,,,,1,1,7.452153518,19111,8492,8164,328,2,326
17669,9501,10378,1,0,39706,,,,,,1,1,8.059942673,19741,9820,9495,325,1,324
17669,9158,10676,0,0,36622,,,,,,1,1,7.629889488,19037,8638,8329,309,1,308
17669,9429,9791,5,0,35154,,,,,,1,1,7.523008585,18117,8389,8130,259,0,259
17669,10361,8125,0,0,37513,,,,,,1,1,7.868116956,19179,9034,8768,266,2,264
17669,9320,11853,0,0,9310,,,,,,1,1,1.945558597,4648,2215,1983,232,1,231
17669,9456,10514,0,0,37703,,,,,,1,1,7.795126719,19189,9106,8804,302,4,298
17669,10916,10256,0,0,11667,,,,,,1,1,2.429955776,5804,2814,2579,235,1,234
17669,10812,10381,2,2,15353,,,,,,1,1,3.207353526,7684,3694,3413,281,10,271
17669,10722,10084,0,0,35466,,,,,,1,1,7.407640718,18339,8397,8064,333,2,331
17669,10715,9479,0,2,36597,,,,,,1,1,7.622267372,19092,8599,8292,307,6,301
17669,9889,11634,0,1,19256,,,,,,1,1,4.20199507,9433,4765,4472,293,1,292
17669,9344,8593,0,0,37016,,,,,,1,1,7.674688278,19219,8769,8510,259,3,256
17669,10389,10782,0,2,5654,,,,,,1,1,1.160344264,2705,1369,1158,211,2,209
17669,10670,10526,0,0,2296,,,,,,1,1,0.466236825,939,596,431,165,0,165
17669,10803,9932,0,4,35740,,,,,,1,1,7.61632838,18769,8353,8088,265,2,263
17669,10082,9496,2,1,34764,,,,,,1,1,7.660813971,18221,8135,7862,273,9,264
17669,10829,10340,0,0,6210,,,,,,1,1,1.3591769550000001,2945,1521,1298,223,0,223
17669,10746,10514,0,0,3430,,,,,,1,1,0.869408541,1595,828,649,179,1,178
17669,10141,9952,3,0,36102,,,,,,1,1,7.670373705,18507,8637,8316,321,3,318
17669,7981,8355,0,0,39498,,,,,,1,1,8.173007891,19977,9625,9354,271,2,269
17669,10108,11241,4,0,18124,,,,,,1,1,3.768675539,9154,4343,4059,284,5,279
17669,9362,11702,4,0,35380,,,,,,1,1,7.622420322,17931,8568,8255,313,9,304
17669,10193,10555,0,0,34715,,,,,,1,1,7.423732928,18367,8016,7700,316,3,313
17669,10866,10615,0,0,4420,,,,,,1,1,0.894787194,2050,1092,906,186,0,186
17669,10446,9804,2,0,37269,,,,,,1,1,8.135665821,19092,8938,8637,301,7,294
17669,9071,10515,2,0,35519,,,,,,1,1,7.379625295,18334,8444,8147,297,6,291
17669,10545,10626,2,1,11905,,,,,,1,1,2.579616549,5727,2953,2681,272,2,270
17669,10661,10509,0,0,3440,,,,,,1,1,0.747978361,1584,847,685,162,0,162
17669,10169,10384,0,1,36222,,,,,,1,1,7.677606105,18746,8587,8285,302,0,302
17669,9953,10013,0,5,37674,,,,,,1,1,7.695534143,19255,9060,8761,299,7,292
17669,10951,9302,1,0,35794,,,,,,1,1,7.65141606,18221,8640,8347,293,2,291
17669,9280,10307,0,4,38393,,,,,,1,1,8.254857838,19244,9429,9138,291,3,288
17669,10210,9359,3,2,37316,,,,,,1,1,7.857590344,18907,9040,8711,329,5,324
17669,8807,10122,0,2,35162,,,,,,1,1,7.268364372,18391,8258,8003,255,5,250
17669,10923,9583,0,0,36881,,,,,,1,1,7.816527751,18890,8854,8571,283,0,283
17669,9494,10974,2,1,34276,,,,,,1,1,7.277635044,17906,8041,7753,288,6,282
17669,10433,10736,0,2,19685,,,,,,1,1,4.170501576,9705,4846,4558,288,3,285
17669,9210,12084,0,0,2354,,,,,,1,1,0.486105394,1016,596,450,146,0,146
17669,10200,10546,0,0,37739,,,,,,1,1,7.934391973,19281,9056,8710,346,1,345
17669,8714,10986,0,0,35952,,,,,,1,1,7.494461412,18351,8661,8382,279,2,277
17669,9510,11635,0,2,36412,,,,,,1,1,7.729696361,18889,8612,8313,299,3,296
17669,10852,9485,4,0,35997,,,,,,1,1,7.536988817,18616,8549,8266,283,3,280
17669,10279,10922,0,0,1568,,,,,,1,1,0.348016739,651,395,268,127,0,127
17669,10559,10613,0,0,2126,,,,,,1,1,0.435245901,893,542,393,149,0,149
17669,10999,9651,4,0,35858,,,,,,1,1,7.617004922,18177,8695,8404,291,9,282
17669,10152,10133,0,2,36114,,,,,,1,1,7.599842439,18680,8563,8255,308,3,305
17669,10680,10195,0,0,35115,,,,,,1,1,7.510631068,18438,8190,7893,297,0,297
17669,9177,10075,2,0,35297,,,,,,1,1,7.468503731,18362,8343,8094,249,2,247
17669,9762,11408,0,2,9735,,,,,,1,1,2.024350793,4809,2346,2112,234,0,234
17669,10663,10483,2,0,37887,,,,,,1,1,7.90007676,19247,9148,8804,344,4,340
17669,11195,9372,0,2,34536,,,,,,1,1,7.365107719,18089,8072,7769,303,11,292
17669,9339,10759,0,0,35158,,,,,,1,1,7.562761191,18386,8242,7954,288,2,286
17669,9379,9695,2,2,36779,,,,,,1,1,7.733595959,19000,8746,8459,287,5,282
17669,11110,10060,0,0,11571,,,,,,1,1,2.452030381,5741,2789,2537,252,2,250
17669,10066,9591,4,0,36435,,,,,,1,1,7.355507961,18748,8708,8437,271,1,270
17669,8865,10287,0,0,37044,,,,,,1,1,7.563790788,19136,8812,8528,284,2,282
17669,8873,9408,1,2,37410,,,,,,1,1,7.625196322,19229,8947,8660,287,1,286
17669,10791,10197,0,0,37595,,,,,,1,1,7.587304617,18961,9139,8783,356,1,355
17669,10622,9636,2,2,37372,,,,,,1,1,7.682987675,19190,8937,8629,308,6,302
17669,10035,11143,2,0,1960,,,,,,1,1,0.402341173,793,509,360,149,2,147
17669,10788,9178,0,3,36078,,,,,,1,1,7.449741926,18547,8616,8317,299,7,292
17669,10678,10502,0,2,16012,,,,,,1,1,3.274415464,8023,3863,3600,263,3,260
17669,10927,10069,0,0,36305,,,,,,1,1,7.308407324,18590,8698,8379,319,2,317
17669,10338,10862,4,0,35290,,,,,,1,1,7.261334187,17805,8560,8195,365,4,361
17669,11573,8990,0,1,37018,,,,,,1,1,7.491221706,18792,8968,8678,290,2,288
17669,10247,11259,0,0,4987,,,,,,1,1,1.032813598,2491,1161,987,174,0,174
17669,10175,8937,3,2,34721,,,,,,1,1,7.166627769,18033,8208,7936,272,3,269
17669,10422,10467,3,0,37044,,,,,,1,1,7.572784326,18810,8963,8655,308,1,307
17669,9968,8507,2,0,35421,,,,,,1,1,7.336473657,18231,8466,8208,258,4,254
17669,10183,11197,0,0,2489,,,,,,1,1,0.663177612,1098,617,460,157,0,157
17669,9826,11444,0,0,8777,,,,,,1,1,1.8705552,4213,2172,1952,220,0,220
17669,10884,10613,0,0,1598,,,,,,1,1,0.357903509,639,411,274,137,0,137
17669,9989,10379,0,0,35931,,,,,,1,1,7.397371754,18647,8491,8189,302,2,300
17669,10729,10671,0,2,3891,,,,,,1,1,1.036777257,1692,1012,837,175,0,175
17669,11752,9612,2,0,13182,,,,,,1,1,2.679661656,6731,3104,2861,243,1,242
17669,9322,8946,2,0,38150,,,,,,1,1,7.7317913560000004,19078,9387,9089,298,5,293
17669,9352,10099,2,0,36249,,,,,,1,1,7.518096209,18760,8602,8317,285,5,280
17669,10514,10751,2,0,32257,,,,,,1,1,6.69710888,16571,7683,7363,320,1,319
17669,10483,10939,0,0,6542,,,,,,1,1,1.364795885,3058,1634,1418,216,0,216
17669,9965,11392,0,0,6609,,,,,,1,1,1.400307413,3047,1668,1442,226,0,226
17669,9507,10574,0,2,38607,,,,,,1,1,7.973383645,19558,9382,9097,285,6,279
17669,11003,8909,2,0,37265,,,,,,1,1,7.588828419,18990,8985,8680,305,2,303
17669,10834,10335,0,0,3118,,,,,,1,1,0.626562157,1309,817,642,175,0,175
17669,10581,10594,0,2,4744,,,,,,1,1,0.991037593,2279,1140,955,185,0,185
17669,10684,10486,0,0,6020,,,,,,1,1,1.399161044,2951,1442,1257,185,0,185
17669,8118,11337,0,3,38900,,,,,,1,1,8.397844644,19352,9617,9303,314,8,306
17669,11913,8473,0,0,35493,,,,,,1,1,7.4927764,18234,8485,8196,289,2,287
17669,10366,10640,0,0,36068,,,,,,1,1,7.8474359830000004,18806,8471,8151,320,4,316
17669,8639,9996,0,11,37348,,,,,,1,1,7.855685721,19107,8994,8741,253,2,251
17669,10442,10597,2,0,34578,,,,,,1,1,7.286047882,18037,8105,7774,331,0,331
17669,10004,11352,0,0,3479,,,,,,1,1,0.766032868,1604,855,690,165,0,165
17669,10822,10367,0,0,3634,,,,,,1,1,0.780754845,1700,881,709,172,0,172
17669,11337,8526,2,1,37410,,,,,,1,1,7.79969615,18923,9099,8810,289,2,287
17669,10348,10823,2,4,29915,,,,,,1,1,6.207156084,15484,7069,6776,293,3,290
17669,10342,10841,0,0,6021,,,,,,1,1,1.241502576,2824,1487,1264,223,2,221
17669,10284,10903,0,0,823,,,,,,1,1,0.173754612,279,224,128,96,0,96
17669,9931,11239,2,0,9641,,,,,,1,1,2.304655645,4720,2337,2090,247,0,247
17669,9250,10740,0,2,37213,,,,,,1,1,7.81590857,18946,8973,8652,321,1,320
17669,12294,9233,2,0,5099,,,,,,1,1,1.033159186,2403,1256,1072,184,0,184
17669,9136,9123,2,1,38858,,,,,,1,1,7.895956732,19812,9370,9064,306,5,301
17669,10598,9623,0,0,34847,,,,,,1,1,7.37572665,18411,8079,7801,278,2,276
17669,8963,10282,0,2,34478,,,,,,1,1,7.127661421,18494,7871,7629,242,0,242
17669,10989,10361,2,0,24176,,,,,,1,1,5.238584955,12417,5738,5455,283,4,279
17669,10549,9468,2,4,36366,,,,,,1,1,7.492996084,18927,8578,8295,283,3,280
17669,11090,10082,0,0,4221,,,,,,1,1,0.854730968,2023,1007,823,184,1,183
17669,12662,8722,4,0,30795,,,,,,1,1,6.413655443,15296,7600,7301,299,1,298
17669,9393,7828,0,0,38307,,,,,,1,1,8.06333644,19363,9342,9082,260,3,257
17669,10148,11021,0,0,3773,,,,,,1,1,0.7827397,1659,966,784,182,0,182
17669,9110,10144,0,0,38517,,,,,,1,1,8.022977577,19001,9614,9326,288,3,285
17669,11080,10444,4,0,27864,,,,,,1,1,5.764357704,14208,6670,6354,316,3,313
17669,10600,9458,0,0,35688,,,,,,1,1,7.456068845,18719,8336,8039,297,2,295
17669,10459,9882,0,3,36162,,,,,,1,1,7.948372373,18697,8586,8293,293,5,288
17669,11379,10087,0,0,10646,,,,,,1,1,2.170847402,5013,2689,2434,255,0,255
17669,10234,9841,2,0,37600,,,,,,1,1,7.808131459,19212,9026,8690,336,6,330
17669,10127,10818,0,4,36389,,,,,,1,1,7.42087736,19019,8532,8226,306,2,304
17669,10102,10412,0,0,36773,,,,,,1,1,7.975837417,19076,8691,8376,315,1,314
17669,9068,10875,0,3,35526,,,,,,1,1,7.395642779,18652,8276,7954,322,10,312
17669,10899,10273,0,0,13717,,,,,,1,1,2.855689522,6942,3251,2978,273,1,272
17669,9253,10352,1,3,37754,,,,,,1,1,7.5789115030000005,19020,9231,8959,272,0,272
17669,9628,9453,0,2,36861,,,,,,1,1,7.467654511,19014,8777,8484,293,2,291
17669,9335,8955,0,0,36379,,,,,,1,1,7.469717151,18474,8809,8522,287,0,287
17669,10638,10680,4,1,15433,,,,,,1,1,3.244104584,7563,3800,3530,270,6,264
17669,10598,9873,2,0,34293,,,,,,1,1,7.175507774,17888,8051,7748,303,1,302
17669,10826,10280,0,3,36060,,,,,,1,1,7.604341548,18545,8613,8324,289,2,287
17669,11797,9606,4,0,15147,,,,,,1,1,3.075698794,7337,3778,3524,254,2,252
17669,9485,9459,2,0,37113,,,,,,1,1,7.679202452,18853,9003,8749,254,2,252
17669,9539,9964,2,2,35439,,,,,,1,1,7.225875159,18482,8344,8075,269,4,265
17669,8674,11416,0,2,37692,,,,,,1,1,7.932186445,19045,9162,8839,323,6,317
17669,10828,10044,2,0,36475,,,,,,1,1,7.56685352,18655,8754,8442,312,3,309
17669,9276,11403,0,0,37300,,,,,,1,1,7.712405309,18990,8998,8684,314,2,312
17669,10249,10018,0,4,36777,,,,,,1,1,7.545387316,18736,8874,8581,293,2,291
17669,10017,10096,0,4,38490,,,,,,1,1,7.849186912,19690,9245,8935,310,0,310
17669,9812,10591,0,0,35711,,,,,,1,1,7.215790742,18791,8310,8010,300,2,298
17669,10800,10374,0,0,2714,,,,,,1,1,0.571888838,1245,656,499,157,0,157
17669,11195,10030,0,0,3766,,,,,,1,1,0.780790449,1736,933,769,164,0,164
17669,10130,11410,2,4,13479,,,,,,1,1,2.719906857,6638,3281,3002,279,1,278
17669,10833,10337,0,0,1407,,,,,,1,1,0.291570686,563,362,242,120,0,120
17669,9493,10626,0,0,35126,,,,,,1,1,7.252861287,18361,8239,7952,287,3,284
17669,10298,9615,2,0,35596,,,,,,1,1,7.341903554,18351,8473,8174,299,2,297
17669,9658,10186,2,3,37649,,,,,,1,1,7.68775583,19028,9164,8871,293,1,292
17669,9881,10883,2,0,37322,,,,,,1,1,7.757027364,18836,9079,8751,328,4,324
17669,11478,8803,2,0,35302,,,,,,1,1,7.335933687,18239,8378,8071,307,0,307
17669,7951,9949,0,0,38832,,,,,,1,1,7.948665965,19806,9379,9111,268,1,267
17669,10382,10766,2,2,36006,,,,,,1,1,7.340996472,18362,8659,8333,326,5,321
17669,9251,8511,3,0,38438,,,,,,1,1,7.827229779,19662,9262,9010,252,1,251
17669,10870,10355,0,0,3808,,,,,,1,1,0.776682921,1734,953,785,168,1,167
17669,10544,8425,0,0,35910,,,,,,1,1,7.470020613,18326,8650,8366,284,8,276
17669,10876,9332,0,0,35018,,,,,,1,1,7.189647833,18286,8224,7940,284,1,283
17669,10981,9751,2,0,35842,,,,,,1,1,7.361762593,18561,8473,8138,335,5,330
17669,9756,11060,0,0,38859,,,,,,1,1,7.848669646,19431,9560,9252,308,0,308
17669,9878,9736,7,2,35627,,,,,,1,1,7.206655402,18619,8366,8090,276,6,270
17669,9218,10993,2,4,34537,,,,,,1,1,7.056106083,18310,7970,7683,287,6,281
17669,10289,9441,0,0,35524,,,,,,1,1,7.328578418,18788,8216,7912,304,5,299
17669,10738,9025,4,0,34831,,,,,,1,1,7.355836715,18454,8047,7764,283,10,273
17669,10023,10985,0,0,36703,,,,,,1,1,7.644042413,18215,9079,8749,330,0,330
17669,10512,10998,0,2,9361,,,,,,1,1,2.147743603,4570,2281,2052,229,2,227
17669,11008,10070,0,2,39032,,,,,,1,1,8.255264361,19400,9647,9309,338,4,334
17669,11255,10241,0,0,1623,,,,,,1,1,0.343526485,674,414,293,121,0,121
17669,9774,11116,0,3,36493,,,,,,1,1,7.687371737,18640,8762,8433,329,5,324
17669,11324,9101,3,0,37014,,,,,,1,1,7.514666022,18994,8856,8548,308,0,308
17669,11391,9783,0,0,9733,,,,,,1,1,1.9831057539999999,4691,2403,2167,236,0,236
17669,11586,9590,0,0,12503,,,,,,1,1,2.518278286,6296,2982,2739,243,0,243
17669,10768,10414,0,0,3423,,,,,,1,1,0.787008266,1601,828,662,166,0,166
17669,8881,10197,0,0,39481,,,,,,1,1,8.359420677,19972,9603,9300,303,0,303
17669,11376,9949,0,0,1391,,,,,,1,1,0.286394108,550,366,257,109,0,109
17669,10087,11440,0,0,6892,,,,,,1,1,1.452579313,3344,1667,1453,214,2,212
17669,9714,9893,0,2,36557,,,,,,1,1,7.5006140089999995,18738,8764,8473,291,0,291
17669,10223,8637,0,0,38132,,,,,,1,1,7.856756611,19448,9192,8892,300,1,299
17669,10634,9222,2,0,39608,,,,,,1,1,8.456234273,19899,9690,9361,329,0,329
17669,10393,11125,2,2,5422,,,,,,1,1,1.180540631,2676,1275,1079,196,7,189
17669,10570,9536,2,2,37981,,,,,,1,1,8.273568101,19160,9248,8923,325,2,323
17669,10850,10329,2,2,3556,,,,,,1,1,0.73739257,1624,880,708,172,3,169
17669,9822,11350,0,0,16179,,,,,,1,1,3.557734391,8277,3816,3546,270,0,270
17669,10496,9551,2,0,35806,,,,,,1,1,7.314284567,18626,8446,8158,288,5,283
17669,11892,8858,5,0,34496,,,,,,1,1,7.096838693,18229,7988,7697,291,4,287
17669,9157,10237,0,0,36783,,,,,,1,1,7.892941149,18941,8774,8480,294,3,291
17669,8891,12273,0,0,36130,,,,,,1,1,7.7281867,18447,8679,8354,325,2,323
17669,9018,10203,4,0,38386,,,,,,1,1,7.858945956,19381,9359,9072,287,2,285
17669,9047,10326,0,0,35748,,,,,,1,1,7.4853041000000005,18396,8545,8283,262,0,262
17669,10306,10725,4,0,35591,,,,,,1,1,7.281861338,18498,8391,8080,311,9,302
17669,11626,9859,2,0,1786,,,,,,1,1,0.373294951,736,461,333,128,1,127
17669,11498,9690,0,2,10785,,,,,,1,1,2.208440077,5068,2735,2488,247,6,241
17669,10535,9986,0,2,36931,,,,,,1,1,7.54051284,18996,8806,8483,323,1,322
17669,10751,10418,0,0,16747,,,,,,1,1,3.428843865,8320,4083,3822,261,0,261
17669,9866,10448,2,2,38561,,,,,,1,1,7.808776991,19255,9504,9206,298,4,294
17669,10328,9710,0,0,37635,,,,,,1,1,7.783586866,19095,9123,8829,294,5,289
17669,11228,9217,3,0,35607,,,,,,1,1,7.437818557,18773,8274,7988,286,0,286
17669,9851,10557,2,0,35252,,,,,,1,1,7.208538536,18354,8318,8056,262,0,262
17669,10784,10478,2,0,2659,,,,,,1,1,0.542614441,1209,651,503,148,2,146
17669,9560,9700,0,2,37062,,,,,,1,1,7.536024076,18982,8891,8593,298,4,294
17669,11524,9825,0,2,6044,,,,,,1,1,1.220738193,2916,1459,1249,210,1,209
17669,10001,10400,2,0,37614,,,,,,1,1,8.001257692,19015,9147,8842,305,0,305
17669,10338,10831,2,0,3976,,,,,,1,1,0.837539719,1847,976,799,177,1,176
17669,11075,9741,0,2,34794,,,,,,1,1,7.21362524,18257,8112,7799,313,4,309
17669,10777,9572,0,0,35367,,,,,,1,1,7.323993025,18427,8326,8038,288,4,284
17669,11277,10224,2,2,35173,,,,,,1,1,7.866097621,18281,8289,7975,314,9,305
17669,8604,10786,0,0,35098,,,,,,1,1,7.410963732,18299,8259,7978,281,2,279
17669,10825,8353,2,0,37908,,,,,,1,1,7.734067464,18966,9331,9051,280,6,274
17669,10411,10758,0,0,27011,,,,,,1,1,5.464927135,13499,6615,6333,282,0,282
17669,9501,11105,1,2,38458,,,,,,1,1,7.938896268,19499,9323,9010,313,1,312
17669,8175,11577,2,5,36315,,,,,,1,1,7.472099896,18696,8665,8376,289,11,278
17669,10481,10230,0,0,38538,,,,,,1,1,7.832254989,19191,9520,9213,307,1,306
17669,10034,10955,3,2,34396,,,,,,1,1,7.318661595,17879,8124,7855,269,6,263
17669,8994,11409,0,2,35131,,,,,,1,1,7.249789282,18621,8101,7793,308,1,307
17669,10285,10316,4,0,35633,,,,,,1,1,7.557546836,18648,8361,8098,263,5,258
17669,9061,12115,0,0,6464,,,,,,1,1,1.318313817,3122,1573,1377,196,0,196
17669,10749,10450,0,0,10269,,,,,,1,1,2.188777067,5118,2460,2229,231,0,231
17669,11215,8960,0,2,34532,,,,,,1,1,7.229803035,18167,8044,7767,277,1,276
17669,10231,10938,2,4,26991,,,,,,1,1,5.556567726,13364,6664,6365,299,6,293
17669,10498,10671,0,4,18357,,,,,,1,1,3.703019138,9396,4350,4089,261,1,260
17669,10871,10298,0,0,2084,,,,,,1,1,0.435719796,898,528,398,130,0,130
17669,9795,11402,0,0,10541,,,,,,1,1,2.157637673,5290,2497,2240,257,1,256
17669,10611,9278,2,0,35372,,,,,,1,1,7.329894721,18625,8223,7922,301,4,297
17669,9758,11438,0,4,5537,,,,,,1,1,1.124561323,2605,1374,1190,184,5,179
17669,10173,9825,1,0,37045,,,,,,1,1,7.5702566959999995,18857,8948,8656,292,4,288
17669,9562,10626,0,3,35789,,,,,,1,1,7.466046085,18512,8499,8220,279,4,275
17669,10372,11047,2,0,21997,,,,,,1,1,4.534191167,10948,5381,5094,287,1,286
17669,11358,9815,0,4,4444,,,,,,1,1,0.901522274,2104,1080,900,180,0,180
17669,9553,11011,2,0,35324,,,,,,1,1,7.444725451,18201,8401,8080,321,3,318
17669,11014,10406,0,2,15764,,,,,,1,1,3.243110641,7877,3812,3549,263,1,262
17669,11026,10104,2,3,34546,,,,,,1,1,7.194737117,18052,8089,7773,316,3,313
17669,11800,9370,2,0,4319,,,,,,1,1,0.903166079,1893,1119,931,188,0,188
17669,9324,11229,4,0,33756,,,,,,1,1,7.125752265,17842,7824,7558,266,6,260
17669,10942,8966,2,0,37993,,,,,,1,1,7.948551917,19119,9274,8948,326,2,324
17669,9258,11466,0,2,36327,,,,,,1,1,7.416963606,18443,8779,8453,326,9,317
17669,7595,9782,0,1,39107,,,,,,1,1,8.141319465,19842,9493,9214,279,2,277
17669,9848,11324,0,0,7374,,,,,,1,1,1.492747807,3580,1796,1594,202,1,201
17669,9624,10810,1,2,35852,,,,,,1,1,7.498443009,18582,8484,8182,302,3,299
17669,9591,11303,0,0,36658,,,,,,1,1,7.727705315,18512,8902,8560,342,1,341
17669,9949,11244,3,0,24699,,,,,,1,1,5.062611083,12599,5907,5621,286,2,284
17669,10124,10589,2,2,36909,,,,,,1,1,7.594272557,18690,8955,8646,309,3,306
17669,10369,10482,0,4,35924,,,,,,1,1,7.412979719,18758,8431,8127,304,1,303
17669,10567,9137,5,0,37727,,,,,,1,1,8.102952152,19197,9106,8788,318,16,302
17669,10807,9805,2,2,35115,,,,,,1,1,7.44696247,18244,8295,8014,281,5,276
17669,10279,10201,0,2,35798,,,,,,1,1,7.452779975,18630,8419,8089,330,8,322
17669,10904,10267,0,2,15115,,,,,,1,1,3.070861629,7704,3581,3332,249,7,242
17669,10931,10277,4,0,6105,,,,,,1,1,1.226553527,2919,1493,1293,200,7,193
17669,9991,11099,2,0,36862,,,,,,1,1,7.661411234,18629,8954,8629,325,2,323
17669,11358,10061,5,0,9558,,,,,,1,1,2.008607067,4534,2402,2182,220,3,217
17669,10655,9181,2,2,36308,,,,,,1,1,7.485259187,18716,8657,8379,278,1,277
17669,11429,8548,3,0,36765,,,,,,1,1,7.442741567,18856,8810,8521,289,2,287
17669,10431,9543,0,0,37622,,,,,,1,1,7.587220159,19326,8987,8665,322,2,320
17669,10955,10388,0,0,4653,,,,,,1,1,0.946065667,2251,1116,946,170,0,170
17669,10848,10326,0,2,6959,,,,,,1,1,1.478426214,3449,1658,1464,194,1,193
17669,9851,11459,0,2,6933,,,,,,1,1,1.396547282,3287,1717,1505,212,1,211
17669,9414,11978,0,6,32415,,,,,,1,1,6.8055679,17004,7564,7281,283,3,280
17669,10441,10729,0,0,6895,,,,,,1,1,1.4491726630000001,3423,1636,1436,200,1,199
17669,10216,10973,0,0,3523,,,,,,1,1,0.710585301,1541,897,709,188,0,188
17669,11274,9932,2,0,2952,,,,,,1,1,0.596949423,1246,768,598,170,0,170
17669,10588,10751,0,2,32738,,,,,,1,1,6.880862688,16761,7833,7522,311,0,311
17669,10008,10918,0,2,35501,,,,,,1,1,7.403292759,18634,8297,8024,273,1,272
17669,10970,10154,2,2,35681,,,,,,1,1,7.279149464,18237,8563,8245,318,12,306
17669,9681,10881,0,0,36906,,,,,,1,1,7.715783861,18834,8881,8571,310,0,310
17669,9690,10568,4,0,35785,,,,,,1,1,7.244891255,18551,8482,8212,270,1,269
17669,10157,11052,0,2,2504,,,,,,1,1,0.505827194,1034,661,513,148,2,146
17669,10743,9053,2,0,37755,,,,,,1,1,7.610865604,18983,9239,8945,294,1,293
17669,10913,10543,6,2,36698,,,,,,1,1,7.669522914,18717,8835,8524,311,1,310
17669,11111,10065,2,2,13248,,,,,,1,1,2.670493385,6479,3263,3020,243,3,240
17669,8957,10269,0,0,36483,,,,,,1,1,7.420213058,18870,8650,8337,313,2,311
17669,11214,9860,4,2,34673,,,,,,1,1,7.084029582,18132,8118,7813,305,12,293
17669,9992,11184,0,0,3239,,,,,,1,1,0.659956068,1465,803,635,168,0,168
17669,10444,9955,0,2,37835,,,,,,1,1,7.678692981,18965,9286,8988,298,1,297
17669,10016,10626,5,2,35758,,,,,,1,1,7.348444548,18705,8374,8069,305,12,293
17669,11071,8738,0,0,36960,,,,,,1,1,7.532346581,18760,8943,8629,314,3,311
17669,10008,10977,0,2,36550,,,,,,1,1,7.451748734,18399,8913,8588,325,1,324
17669,9570,11076,2,0,34572,,,,,,1,1,7.072818695,18125,8080,7793,287,0,287
17669,10569,10603,0,0,3217,,,,,,1,1,0.660914367,1467,784,602,182,0,182
17669,8980,9920,4,1,36494,,,,,,1,1,7.592653792,18603,8808,8533,275,3,272
17669,7844,10127,0,2,37681,,,,,,1,1,7.69426043,19272,9074,8813,261,1,260
17669,10628,10177,0,0,34743,,,,,,1,1,7.254694392,18196,8123,7822,301,0,301
17669,11206,10210,0,1,12231,,,,,,1,1,2.475888278,6145,2916,2662,254,0,254
17669,10291,10005,1,4,34610,,,,,,1,1,7.152476094,18278,8032,7764,268,2,266
17669,9946,9676,2,2,37699,,,,,,1,1,7.815160223,19251,9059,8729,330,5,325
17669,10359,11053,0,0,2827,,,,,,1,1,0.579098907,1305,690,548,142,0,142
17669,10406,10790,0,0,2788,,,,,,1,1,0.626925418,1284,669,503,166,0,166
17669,10937,9791,0,0,35347,,,,,,1,1,7.412315702,18463,8298,8010,288,0,288
17669,8569,10498,0,1,38409,,,,,,1,1,7.8256637940000005,19514,9300,9005,295,8,287
17669,10592,9509,2,0,36364,,,,,,1,1,7.498482591,18730,8672,8382,290,7,283
17669,9899,11272,0,2,1208,,,,,,1,1,0.250474359,439,323,200,123,0,123
17669,10980,10191,0,0,12066,,,,,,1,1,2.441696488,5766,3015,2745,270,0,270
17669,10537,10662,0,2,1661,,,,,,1,1,0.340819423,631,446,308,138,1,137
17669,10472,10743,0,0,9490,,,,,,1,1,1.927196716,4633,2313,2082,231,0,231
17669,8942,8023,0,0,37889,,,,,,1,1,7.709494069,19561,9028,8756,272,4,268
17669,10385,9376,2,0,37706,,,,,,1,1,7.678453743,19276,9066,8768,298,1,297
17669,10166,10800,0,4,37477,,,,,,1,1,7.615452706,18987,9093,8789,304,8,296
17669,10430,9831,2,8,35285,,,,,,1,1,7.313395657,18152,8415,8112,303,12,291
17669,10280,9746,0,2,36697,,,,,,1,1,7.448791526,18735,8817,8489,328,2,326
17669,10659,10785,0,0,7313,,,,,,1,1,1.490078161,3484,1804,1583,221,0,221
17669,11254,8956,2,3,37775,,,,,,1,1,7.636065789,19379,9051,8757,294,6,288
17669,9572,9736,0,0,38795,,,,,,1,1,7.937204834,19413,9543,9247,296,4,292
17669,10326,8851,2,0,37765,,,,,,1,1,7.655946393,19387,9034,8724,310,3,307
17669,9894,11528,0,0,3526,,,,,,1,1,0.759097614,1616,867,691,176,0,176
17669,10888,10443,4,2,31043,,,,,,1,1,6.292965391,15832,7451,7142,309,3,306
17669,9154,10978,0,0,37701,,,,,,1,1,7.663718365,18995,9183,8843,340,2,338
17669,9848,11027,0,0,36451,,,,,,1,1,7.460469773,18605,8779,8491,288,1,287
17669,11048,10121,0,0,33326,,,,,,1,1,6.858336372,16934,8020,7668,352,4,348
17669,10974,10342,0,0,1708,,,,,,1,1,0.355875996,750,415,287,128,0,128
17669,10967,10204,0,2,9375,,,,,,1,1,1.914854875,4580,2285,2060,225,6,219
17669,8455,9958,2,2,36714,,,,,,1,1,7.581689094,18950,8745,8471,274,10,264
17669,9433,10467,0,0,35632,,,,,,1,1,7.315684484,18308,8518,8230,288,2,286
17669,10654,10291,0,2,37927,,,,,,1,1,7.87774177,19380,9112,8789,323,7,316
17669,10493,10426,0,0,34102,,,,,,1,1,7.076349042,17925,7924,7595,329,1,328
17669,10406,10687,2,3,35933,,,,,,1,1,7.415249899,18346,8647,8354,293,5,288
17669,10500,10598,0,2,37106,,,,,,1,1,7.603747482,18561,9106,8773,333,3,330
17669,9697,11280,2,2,35136,,,,,,1,1,7.547729728,18334,8244,7930,314,4,310
17669,9102,10464,0,2,37897,,,,,,1,1,7.756505767,19065,9261,8951,310,2,308
17669,8617,10954,0,0,36530,,,,,,1,1,7.46700001,18852,8691,8395,296,0,296
17669,11022,9888,0,0,33398,,,,,,1,1,6.8792103860000005,17897,7583,7248,335,2,333
17669,9947,9229,0,0,38496,,,,,,1,1,7.901282034,19207,9496,9199,297,2,295
17669,11392,9779,0,0,4291,,,,,,1,1,0.881808469,1992,1060,881,179,0,179
17669,9781,10426,0,0,36291,,,,,,1,1,7.487539527,18594,8699,8400,299,0,299
17669,9622,11246,2,3,34698,,,,,,1,1,7.276105113,18111,8144,7845,299,1,298
17669,9506,10009,2,2,37834,,,,,,1,1,7.671653371,19285,9112,8787,325,2,323
17669,10630,10550,0,2,5593,,,,,,1,1,1.242308678,2593,1394,1182,212,3,209
17669,10700,9860,4,2,38515,,,,,,1,1,7.854007348,19240,9461,9108,353,11,342
17669,11196,10072,3,2,19438,,,,,,1,1,4.070570243,9667,4749,4476,273,0,273
17669,10554,9409,2,2,38369,,,,,,1,1,7.744040181,19352,9351,9036,315,14,301
17669,10495,10687,0,0,1614,,,,,,1,1,0.332096273,681,406,285,121,0,121
17669,9377,11126,0,0,36431,,,,,,1,1,7.59509027,18628,8753,8456,297,2,295
17669,10481,10693,0,2,3824,,,,,,1,1,0.781493071,1661,983,786,197,1,196
17669,9840,8900,0,2,36892,,,,,,1,1,7.628905415,19071,8770,8489,281,1,280
17669,9479,9623,0,0,38748,,,,,,1,1,7.9953725989999995,19023,9727,9456,271,3,268
17669,10024,8202,2,0,37864,,,,,,1,1,7.844979699,19353,9127,8870,257,4,253
17669,10830,10340,0,0,14788,,,,,,1,1,3.096851236,7379,3575,3316,259,0,259
17669,10916,9003,0,0,36638,,,,,,1,1,7.73086245,18837,8748,8443,305,2,303
17669,10708,9802,3,2,36186,,,,,,1,1,7.418587949,18322,8796,8524,272,3,269
17669,11207,10115,0,0,2236,,,,,,1,1,0.492688211,1035,527,380,147,0,147
17669,11933,9491,6,0,7468,,,,,,1,1,1.642302674,3456,1896,1676,220,8,212
17669,10625,10756,0,2,12055,,,,,,1,1,2.465490903,6098,2856,2611,245,0,245
17669,11000,10182,0,0,4613,,,,,,1,1,0.974520832,2225,1095,897,198,0,198
17669,9544,11344,2,2,36031,,,,,,1,1,7.516007023,18773,8478,8176,302,1,301
17669,10101,11068,0,2,12826,,,,,,1,1,2.6094164859999998,6200,3173,2893,280,7,273
17669,9145,9960,0,2,36608,,,,,,1,1,7.450615548,18894,8709,8413,296,5,291
17669,10578,9485,4,2,36980,,,,,,1,1,7.499181978,19001,8838,8535,303,7,296
17669,10416,10307,3,0,36009,,,,,,1,1,7.404814302,18100,8787,8452,335,4,331
17669,9823,10518,0,0,33632,,,,,,1,1,6.986396618,17883,7731,7444,287,1,286
17669,9120,9852,0,2,35688,,,,,,1,1,7.427024084,18697,8357,8080,277,1,276
17669,7620,11961,2,0,36425,,,,,,1,1,7.609610464,18885,8638,8374,264,4,260
17669,9952,11497,0,0,4379,,,,,,1,1,0.896227347,2028,1083,898,185,2,183
17669,11604,8925,3,0,36348,,,,,,1,1,7.509172932,18289,8873,8560,313,0,313
17669,11001,10182,0,0,3145,,,,,,1,1,0.637264795,1363,809,645,164,0,164
17669,11674,9580,0,2,20172,,,,,,1,1,4.111825267,9759,5066,4785,281,2,279
17669,11083,9956,0,2,35579,,,,,,1,1,7.362969574,18564,8352,8041,311,0,311
17669,9693,11495,0,2,1511,,,,,,1,1,0.332528121,609,389,265,124,2,122
17669,10872,10304,0,0,1826,,,,,,1,1,0.419064226,819,438,307,131,1,130
17669,9860,11233,0,2,35557,,,,,,1,1,7.282393953,18406,8415,8094,321,2,319
17669,9380,9052,0,0,38813,,,,,,1,1,7.878350386,19572,9479,9196,283,1,282
17669,10625,10555,0,2,1434,,,,,,1,1,0.316860271,587,363,242,121,0,121
17669,10182,9946,2,2,35804,,,,,,1,1,7.499255725,18416,8554,8274,280,9,271
17669,11275,10159,4,0,3207,,,,,,1,1,0.652515317,1425,805,633,172,2,170
17669,11101,10216,2,0,14797,,,,,,1,1,3.038713431,7446,3547,3290,257,0,257
17669,9045,11048,0,0,36253,,,,,,1,1,7.313836503,18816,8575,8288,287,4,283
17669,10333,10046,2,0,34808,,,,,,1,1,7.229242755,18246,8135,7843,292,7,285
17669,8137,10095,2,0,36532,,,,,,1,1,7.492097051,19153,8554,8283,271,6,265
17669,10869,9571,0,0,35312,,,,,,1,1,7.28577501,18370,8316,8006,310,2,308
17669,10542,9894,0,0,35104,,,,,,1,1,7.334685686,18581,8107,7798,309,3,306
17669,11168,10210,2,6,25635,,,,,,1,1,5.239056231,13084,6127,5830,297,7,290
17669,10196,10619,0,2,34165,,,,,,1,1,6.97198889,17988,7937,7634,303,3,300
17669,9972,11209,0,0,3288,,,,,,1,1,0.815394554,1432,844,676,168,0,168
17669,10903,9988,2,2,34243,,,,,,1,1,7.024963702,17786,8079,7780,299,6,293
17669,12079,8918,3,2,34059,,,,,,1,1,7.116029682,17638,8064,7771,293,1,292
17669,10404,11073,0,0,9757,,,,,,1,1,2.072649933,4835,2357,2149,208,0,208
17669,10459,9714,0,0,35271,,,,,,1,1,7.3598071449999996,18142,8416,8119,297,1,296
17669,9764,9431,0,2,35082,,,,,,1,1,7.203023437,18482,8172,7916,256,2,254
17669,9668,10712,4,0,38506,,,,,,1,1,7.827697741,19148,9526,9220,306,11,295
17669,11397,9582,0,2,37531,,,,,,1,1,7.655556496,18927,9143,8825,318,2,316
17669,11020,10294,5,0,13602,,,,,,1,1,2.766366025,7081,3139,2896,243,3,240
17669,10180,9897,0,2,37442,,,,,,1,1,7.619873204,19045,9027,8684,343,7,336
17669,9333,11033,0,2,37321,,,,,,1,1,7.878103414,18959,9003,8647,356,3,353
17669,10370,10799,0,2,8390,,,,,,1,1,1.7408185010000001,4080,2041,1813,228,0,228
17669,10394,10337,0,0,37741,,,,,,1,1,7.609191503,19184,9126,8821,305,2,303
17669,9944,11233,2,0,1696,,,,,,1,1,0.348301739,699,431,296,135,0,135
17669,9887,10698,0,0,36387,,,,,,1,1,7.453996533,18519,8781,8475,306,5,301
17669,10415,10755,2,4,13983,,,,,,1,1,2.9424093,7156,3285,3028,257,7,250
17669,10514,10759,3,2,18107,,,,,,1,1,3.662797876,9180,4330,4063,267,4,263
17669,11758,9471,4,0,23930,,,,,,1,1,4.839119825,12542,5555,5277,278,1,277
17669,9796,11342,0,2,34568,,,,,,1,1,7.171524284,18474,7894,7588,306,3,303
17669,10269,11039,2,0,1582,,,,,,1,1,0.325799567,621,416,287,129,0,129
17669,9710,11459,2,0,20775,,,,,,1,1,4.334507311,10579,4961,4687,274,2,272
17669,9717,9993,0,2,35390,,,,,,1,1,7.437833072,18402,8356,8080,276,2,274
17669,9211,10362,2,0,37380,,,,,,1,1,7.689582654,18872,9099,8789,310,2,308
17669,10378,9698,0,0,36919,,,,,,1,1,7.8906366,19079,8758,8434,324,0,324
17669,10796,9748,0,2,37182,,,,,,1,1,7.566430724,18757,9051,8728,323,2,321
17669,11005,10175,0,0,6687,,,,,,1,1,1.356509929,3226,1630,1429,201,0,201
17669,9329,10272,2,0,36949,,,,,,1,1,7.655194193,19184,8734,8437,297,2,295
17669,10242,10528,0,0,36465,,,,,,1,1,7.452795912,18805,8684,8392,292,0,292
17669,10780,8820,2,0,36267,,,,,,1,1,7.682920497,18997,8500,8230,270,1,269
17669,10869,9971,0,0,31974,,,,,,1,1,6.565446779,16998,7350,7074,276,1,275
17669,9768,10619,0,0,37738,,,,,,1,1,7.60213102,19168,9124,8802,322,3,319
17669,9817,9269,2,2,36045,,,,,,1,1,7.298263228,18723,8526,8256,270,7,263
17669,11050,9175,1,0,34956,,,,,,1,1,7.24261877,18350,8174,7916,258,3,255
17669,11176,10113,0,4,25864,,,,,,1,1,5.371470925,13060,6271,6009,262,3,259
17669,11286,8778,4,0,38260,,,,,,1,1,7.795328738,19253,9327,8974,353,8,345
17669,10377,10795,0,0,3833,,,,,,1,1,0.772934079,1769,942,762,180,0,180
17669,10737,10401,0,0,37439,,,,,,1,1,7.902369475,18723,9196,8872,324,0,324
17669,9829,10805,0,0,34336,,,,,,1,1,7.041140047,18118,7967,7683,284,0,284
17669,9659,11551,0,2,1277,,,,,,1,1,0.267887257,508,331,224,107,1,106
17669,9812,9487,0,2,36547,,,,,,1,1,7.522737537,18639,8806,8510,296,2,294
17669,10739,10432,0,2,4447,,,,,,1,1,0.899001605,2056,1111,942,169,0,169
17669,10883,9671,0,0,36450,,,,,,1,1,7.531070847,18516,8816,8514,302,0,302
17669,10588,9348,4,2,38554,,,,,,1,1,7.826951245,19558,9343,9033,310,5,305
17669,9785,11138,0,2,36528,,,,,,1,1,7.51396762,18771,8713,8382,331,2,329
17669,9916,10729,0,2,35678,,,,,,1,1,7.344121384,18581,8413,8142,271,3,268
17669,10889,10642,2,0,3072,,,,,,1,1,0.629914493,1332,786,618,168,1,167
17669,10152,9606,2,1,37043,,,,,,1,1,7.6062284049999995,18880,8919,8594,325,2,323
17669,10347,8033,0,0,38038,,,,,,1,1,7.844229338,19554,9121,8879,242,5,237
17669,10733,10136,3,0,36906,,,,,,1,1,7.845363496,19007,8792,8477,315,4,311
17669,10338,10408,1,1,36399,,,,,,1,1,7.848238898,18562,8764,8455,309,3,306
17669,11156,9635,0,2,35620,,,,,,1,1,7.884173989,18118,8599,8295,304,2,302
17669,10655,10795,0,2,3744,,,,,,1,1,1.306846818,1753,922,775,147,2,145
17669,10407,9901,0,0,36685,,,,,,1,1,8.557728015,18883,8733,8397,336,1,335
17669,11426,9745,0,0,4739,,,,,,1,1,1.745491624,2203,1167,965,202,1,201
17669,10076,11093,0,0,13648,,,,,,1,1,4.492850025,6668,3359,3097,262,1,261
17669,10090,10447,0,0,37693,,,,,,1,1,9.344137687,18918,9222,8891,331,4,327
17669,9489,11382,0,0,34049,,,,,,1,1,8.802942448,17940,7912,7627,285,2,283
17669,11288,10106,0,0,11037,,,,,,1,1,5.047728161,5303,2741,2489,252,1,251
17669,9908,11262,0,0,5970,,,,,,1,1,1.8407843210000001,2776,1482,1252,230,0,230
17669,8578,9491,0,2,37934,,,,,,1,1,10.822094456,19061,9306,9045,261,3,258
17669,11165,10007,0,2,9621,,,,,,1,1,2.8253726930000003,4833,2277,2043,234,0,234
17669,10507,9415,2,2,35684,,,,,,1,1,10.892026281,18368,8523,8253,270,11,259
17669,9894,10428,0,0,36967,,,,,,1,1,13.472120752,18496,9078,8763,315,3,312
17669,10039,10231,4,0,36558,,,,,,1,1,13.240249069,18898,8692,8416,276,0,276
17669,9106,11016,0,0,36960,,,,,,1,1,12.548124162,18977,8824,8489,335,1,334
17669,9148,11160,0,0,36158,,,,,,1,1,12.667152641,18683,8563,8214,349,1,348
17669,9282,10863,1,0,36884,,,,,,1,1,13.273688051,18937,8824,8525,299,1,298
17669,9445,11962,0,2,7278,,,,,,1,1,2.29721464,3582,1735,1509,226,0,226
17669,10051,11437,2,0,30204,,,,,,1,1,13.886513778,15465,7221,6924,297,1,296
17669,9463,11441,0,2,35818,,,,,,1,1,15.671760501,18432,8549,8261,288,1,287
17669,10927,9017,1,0,36121,,,,,,1,1,13.584035077,18497,8669,8383,286,2,284
17669,10475,10664,0,0,36696,,,,,,1,1,15.383033023,18709,8829,8500,329,2,327
17669,9541,11380,0,2,36887,,,,,,1,1,15.66580786,18869,8859,8559,300,1,299
17669,9808,11361,2,0,10665,,,,,,1,1,4.136319076,5172,2626,2385,241,2,239
17669,9878,10271,0,0,36230,,,,,,1,1,15.2106548,18759,8589,8296,293,2,291
17669,10137,9631,0,0,35143,,,,,,1,1,15.497427791,18262,8301,8022,279,0,279
17669,10873,10663,0,0,33300,,,,,,1,1,13.973860925,17214,7894,7596,298,2,296
17669,10967,8778,0,0,36825,,,,,,1,1,15.650247295,18986,8771,8474,297,1,296
17669,10162,8765,2,0,35309,,,,,,1,1,13.443308286,18272,8377,8094,283,1,282
17669,11559,9612,2,0,2833,,,,,,1,1,0.883598458,1191,734,560,174,2,172
17669,9668,11678,0,4,8945,,,,,,1,1,4.475405928,4332,2193,1966,227,10,217
17669,10154,10162,0,0,35001,,,,,,1,1,14.497122686,18075,8323,8043,280,1,279
17669,11591,9924,0,0,4988,,,,,,1,1,2.48959627,2242,1273,1073,200,0,200
17669,8651,9773,0,0,37483,,,,,,1,1,16.447353008,19368,8921,8648,273,0,273
17669,10586,9600,0,0,35572,,,,,,1,1,17.281423363,18694,8271,7935,336,3,333
17669,10149,10297,0,0,37553,,,,,,1,1,16.087255732,19116,9075,8788,287,5,282
17669,10512,10771,0,0,8563,,,,,,1,1,4.153526523,4159,2080,1836,244,0,244
17669,9956,11485,2,0,27128,,,,,,1,1,10.282868693,13915,6467,6188,279,0,279
17669,10741,10601,4,0,25881,,,,,,1,1,7.155175583,13210,6196,5917,279,3,276
17669,10485,10214,1,2,37908,,,,,,1,1,16.103681177,19161,9219,8910,309,0,309
17669,10222,11068,0,2,13914,,,,,,1,1,7.405007936,7054,3289,3007,282,3,279
17669,10448,9439,0,0,35541,,,,,,1,1,16.987254839,18427,8415,8131,284,0,284
17669,10219,9006,2,0,34729,,,,,,1,1,15.564495217,18276,8085,7802,283,6,277
17669,10609,10689,7,0,19330,,,,,,1,1,7.199806772,9712,4663,4371,292,2,290
17669,11359,10081,0,0,5363,,,,,,1,1,2.80644689,2510,1325,1122,203,0,203
17669,10717,10515,2,0,4002,,,,,,1,1,1.9749733379999999,1814,1008,836,172,1,171
17669,9739,10838,0,0,37041,,,,,,1,1,18.402649764,18669,9030,8718,312,3,309
17669,9258,9858,0,2,35784,,,,,,1,1,14.396139458,18184,8667,8401,266,0,266
17669,10256,10913,0,2,5311,,,,,,1,1,2.828335567,2513,1296,1090,206,0,206
17669,10114,11058,0,0,4156,,,,,,1,1,1.131622028,1885,1046,867,179,1,178
17669,8934,9722,0,0,38482,,,,,,1,1,17.971130043,19554,9306,8990,316,1,315
17669,11652,9517,0,0,12936,,,,,,1,1,5.769167691,6642,3029,2793,236,1,235
17669,9790,11388,0,1,9607,,,,,,1,1,3.681753985,4682,2354,2137,217,0,217
17669,10291,10888,0,0,1915,,,,,,1,1,0.598240576,758,508,367,141,0,141
17669,10010,10326,0,0,37443,,,,,,1,1,18.35482566,18725,9208,8906,302,0,302
17669,10793,10642,2,0,31548,,,,,,1,1,16.795196943,16165,7539,7234,305,5,300
17669,9444,10991,5,0,34758,,,,,,1,1,17.432180853,18525,7964,7659,305,1,304
17669,10713,9239,0,0,35839,,,,,,1,1,14.776983697,18710,8427,8152,275,4,271
17669,9758,10627,0,2,35375,,,,,,1,1,12.524821903,18382,8347,8048,299,3,296
17669,10090,11099,2,0,2717,,,,,,1,1,1.113540587,1164,698,541,157,1,156
17669,10885,9478,0,0,38011,,,,,,1,1,15.618585736,18902,9397,9082,315,3,312
17669,10363,10807,1,0,6683,,,,,,1,1,2.410520786,3154,1650,1421,229,3,226
17669,10061,10387,0,3,37778,,,,,,1,1,13.977779829,19148,9151,8823,328,3,325
17669,10134,10446,0,0,36202,,,,,,1,1,13.853285606,18693,8610,8321,289,0,289
17669,9843,9819,7,0,35683,,,,,,1,1,14.385665744,18196,8603,8322,281,8,273
17669,10792,10630,2,2,5875,,,,,,1,1,2.218591986,2954,1361,1162,199,2,197
17669,9916,10097,0,2,35422,,,,,,1,1,14.378491065,18406,8364,8076,288,1,287
17669,10566,9857,2,0,35632,,,,,,1,1,14.395345548,18415,8452,8139,313,2,311
17669,9277,10223,2,2,37260,,,,,,1,1,16.403988788,18881,9027,8702,325,0,325
17669,10103,11066,0,2,15573,,,,,,1,1,7.281557641,7622,3832,3545,287,1,286
17669,10683,9508,0,2,35990,,,,,,1,1,16.2775336,18830,8435,8145,290,0,290
17669,10236,10833,0,2,36014,,,,,,1,1,16.276437501,18712,8495,8183,312,6,306
17669,9557,10624,3,1,36424,,,,,,1,1,14.61478311,18604,8752,8436,316,13,303
17669,10283,10886,0,0,3823,,,,,,1,1,1.118793005,1869,891,719,172,1,171
17669,9982,11209,2,2,4908,,,,,,1,1,1.027220827,2248,1224,1012,212,0,212
17669,9183,11118,2,0,36713,,,,,,1,1,13.889649952,18932,8749,8466,283,4,279
17669,10707,9147,0,0,35509,,,,,,1,1,13.635680624999999,18449,8397,8131,266,1,265
17669,10281,10902,1,2,20809,,,,,,1,1,6.022403358,10868,4833,4558,275,2,273
17669,10632,9032,4,0,35812,,,,,,1,1,11.422892021,18598,8466,8184,282,9,273
17669,11320,9967,2,0,19493,,,,,,1,1,5.150137287,9884,4675,4416,259,1,258
17669,10639,9940,0,2,36602,,,,,,1,1,12.575249357,18969,8662,8353,309,3,306
17669,9999,11288,1,0,14840,,,,,,1,1,3.224263916,7297,3636,3365,271,0,271
17669,8810,10726,0,3,37368,,,,,,1,1,10.638500518,19084,8983,8665,318,4,314
17669,10759,10414,0,0,4432,,,,,,1,1,1.023918187,2151,1061,902,159,0,159
17669,10551,10619,0,2,14829,,,,,,1,1,3.786913218,7413,3565,3279,286,0,286
17669,11172,8575,3,0,36715,,,,,,1,1,10.055955972,18996,8722,8447,275,4,271
17669,10259,10149,3,2,35029,,,,,,1,1,12.026500991,18269,8248,7984,264,2,262
17669,10281,9578,0,0,35942,,,,,,1,1,11.476688355,18813,8424,8143,281,3,278
17669,10458,10925,0,0,1526,,,,,,1,1,0.314242433,607,397,272,125,0,125
17669,10436,10742,0,0,5126,,,,,,1,1,1.087147308,2545,1198,1013,185,0,185
17669,8825,9915,2,4,38159,,,,,,1,1,11.254411078,19389,9240,8950,290,7,283
17669,9328,10015,0,1,36286,,,,,,1,1,10.172673874000001,18795,8597,8300,297,2,295
17669,9770,9921,2,0,37787,,,,,,1,1,10.963868729,19048,9203,8870,333,5,328
17669,10464,9024,2,0,35340,,,,,,1,1,9.335697338,18653,8206,7931,275,0,275
17669,11662,9818,3,0,2246,,,,,,1,1,0.457671223,926,588,444,144,1,143
17669,10300,11209,0,0,3152,,,,,,1,1,0.646087945,1444,768,596,172,2,170
17669,11353,10033,6,2,30140,,,,,,1,1,6.440532555,15887,6974,6669,305,19,286
17669,9898,9902,2,0,37751,,,,,,1,1,9.539486978,18939,9248,8932,316,2,314
17669,9694,10179,0,0,37854,,,,,,1,1,8.738988496,19294,9121,8803,318,2,316
17669,10013,10124,0,2,36568,,,,,,1,1,8.909393372,18721,8761,8436,325,2,323
17669,10434,10684,0,4,35187,,,,,,1,1,7.497571896,17996,8429,8096,333,14,319
17669,10607,10572,0,0,3768,,,,,,1,1,0.772316056,1750,928,766,162,1,161
17669,9207,10964,0,2,35197,,,,,,1,1,7.548552303,18260,8322,8029,293,3,290
17669,11070,10105,0,0,2802,,,,,,1,1,0.57697589,1280,691,551,140,0,140
17669,10374,10100,0,1,37029,,,,,,1,1,8.209788447,19017,8855,8553,302,2,300
17669,10812,9583,2,0,36673,,,,,,1,1,7.83967039,18649,8861,8559,302,3,299
17669,10300,9739,0,0,36942,,,,,,1,1,8.051592893,19004,8826,8540,286,1,285
17669,11802,9535,2,0,13931,,,,,,1,1,2.834247157,6912,3396,3169,227,0,227
17669,10853,10333,0,0,1507,,,,,,1,1,0.312979954,618,383,260,123,1,122
17669,8940,10684,2,2,37507,,,,,,1,1,7.845535089,19356,8933,8648,285,8,277
17669,10579,10877,0,0,23213,,,,,,1,1,4.7348796669999995,11678,5609,5292,317,1,316
17669,8791,9914,0,2,37268,,,,,,1,1,8.035422719,19061,8968,8697,271,2,269
17669,10813,10359,0,4,1492,,,,,,1,1,0.541876476,595,389,270,119,1,118
17669,11005,10300,0,0,2668,,,,,,1,1,0.557966995,1197,655,494,161,2,159
17669,10660,10535,0,0,3334,,,,,,1,1,0.696540396,1448,859,691,168,0,168
17669,11016,9995,1,0,34731,,,,,,1,1,7.439227403,18033,8172,7818,354,3,351
17669,9953,9421,0,0,36122,,,,,,1,1,8.001011898,18809,8521,8250,271,2,269
17669,10084,10381,4,2,35865,,,,,,1,1,7.359137051,18489,8543,8253,290,2,288
17669,10046,10958,0,0,34964,,,,,,1,1,7.368430859,18333,8166,7867,299,2,297
17669,10814,10015,0,2,36225,,,,,,1,1,7.547945401,18424,8731,8392,339,2,337
17669,10332,10332,4,4,37335,,,,,,1,1,7.717284075,19149,8945,8649,296,1,295
17669,9268,8487,0,0,36844,,,,,,1,1,7.633051067,18998,8792,8530,262,3,259
17669,7665,10535,0,0,37083,,,,,,1,1,7.840492055,19416,8700,8433,267,3,264
17669,10357,10830,0,0,2325,,,,,,1,1,0.481672487,987,591,435,156,0,156
17669,9606,11571,0,2,4530,,,,,,1,1,0.96185212,2155,1103,934,169,1,168
17669,10406,10951,0,0,2135,,,,,,1,1,0.435699223,889,546,392,154,0,154
17669,8487,9844,0,3,38425,,,,,,1,1,8.253564205,19473,9341,9071,270,9,261
17669,10107,10496,2,0,34513,,,,,,1,1,7.164910467,18048,8092,7811,281,4,277
17669,8455,9585,2,0,36627,,,,,,1,1,7.657826315,18656,8853,8588,265,2,263
17669,10530,9592,0,6,34502,,,,,,1,1,7.410289299,18312,7959,7687,272,3,269
17669,10943,10239,0,0,3151,,,,,,1,1,0.650729815,1437,770,596,174,0,174
17669,8607,9613,1,2,37846,,,,,,1,1,8.063871064,19471,9041,8748,293,3,290
17669,10387,10808,0,2,5429,,,,,,1,1,1.137788547,2546,1343,1146,197,1,196
17669,10668,10501,2,2,15144,,,,,,1,1,3.149102143,7687,3611,3376,235,5,230
17669,10439,9704,0,0,35162,,,,,,1,1,7.49635478,18292,8291,8003,288,2,286
17669,9687,11220,0,0,38737,,,,,,1,1,8.10654844,19443,9481,9149,332,0,332
17669,10417,10765,0,0,2119,,,,,,1,1,0.434912095,924,528,389,139,0,139
17669,10744,9572,2,0,38738,,,,,,1,1,7.979654502,19140,9627,9283,344,2,342
17669,10283,11222,2,11,20303,,,,,,1,1,4.161475724,10447,4811,4577,234,6,228
17669,9642,9345,0,0,36791,,,,,,1,1,7.93624283,19026,8728,8419,309,3,306
17669,9501,8826,2,0,35230,,,,,,1,1,7.4181337339999995,18734,8114,7846,268,1,267
17669,8398,10527,0,0,36749,,,,,,1,1,7.913194584,19125,8669,8383,286,2,284
17669,10463,9184,0,2,37136,,,,,,1,1,7.812833933,18887,8972,8667,305,0,305
17669,9945,11310,0,2,3606,,,,,,1,1,0.725669406,1628,911,755,156,0,156
17669,9873,10546,1,2,34237,,,,,,1,1,7.315443541,17991,7980,7694,286,2,284
17669,10224,10596,2,0,36050,,,,,,1,1,7.773332531,18859,8424,8081,343,4,339
17669,11202,10341,4,2,10035,,,,,,1,1,2.022460355,4848,2477,2244,233,2,231
17669,10963,9312,0,0,36804,,,,,,1,1,7.850752058,18802,8836,8506,330,1,329
17669,11081,9198,4,0,36196,,,,,,1,1,7.398194399,18746,8567,8251,316,2,314
17669,10887,10116,1,0,37278,,,,,,1,1,7.6584529759999995,18948,9003,8679,324,2,322
17669,10652,10523,0,0,3177,,,,,,1,1,0.65753666,1389,810,642,168,0,168
17669,10855,10314,0,2,17373,,,,,,1,1,3.574665402,8654,4217,3932,285,4,281
17669,10877,10668,2,2,14273,,,,,,1,1,2.972341363,7351,3334,3080,254,3,251
17669,10920,8913,0,0,36746,,,,,,1,1,7.545058597,18877,8785,8486,299,5,294
17669,10160,8955,2,0,36769,,,,,,1,1,7.5254881860000005,18738,8870,8579,291,3,288
17669,10037,10265,2,2,35893,,,,,,1,1,7.514181021,18765,8405,8087,318,1,317
17669,11099,8953,2,0,36215,,,,,,1,1,7.44729298,18864,8545,8284,261,1,260
17669,8734,11909,0,2,35973,,,,,,1,1,7.414179731,18588,8545,8250,295,1,294
17669,10899,8981,0,2,36929,,,,,,1,1,7.572431227,18651,8994,8704,290,0,290
17669,9918,9533,0,0,34267,,,,,,1,1,6.983014381,18172,7922,7671,251,2,249
17669,10926,9892,0,0,34797,,,,,,1,1,7.162216022,18153,8163,7845,318,2,316
17669,10575,10596,0,0,2322,,,,,,1,1,0.474826707,1029,579,444,135,0,135
17669,10139,9310,0,0,36112,,,,,,1,1,7.302262498,18713,8556,8269,287,4,283
17669,10840,10332,0,4,10784,,,,,,1,1,2.261235577,5230,2658,2420,238,3,235
17669,9435,11743,0,0,4308,,,,,,1,1,0.884754885,2047,1043,868,175,2,173
17669,10393,10172,5,0,37077,,,,,,1,1,7.531465063,18841,8954,8626,328,0,328
17669,8646,9486,0,0,37946,,,,,,1,1,7.871823753,19463,9107,8838,269,2,267
17669,10717,10114,2,0,34264,,,,,,1,1,7.18478632,18044,7966,7678,288,2,286
17669,9780,10578,1,0,36644,,,,,,1,1,7.5822674899999996,18875,8725,8406,319,2,317
17669,10080,10268,0,0,36450,,,,,,1,1,7.520058261,18973,8581,8266,315,2,313
17669,10763,10625,1,4,30931,,,,,,1,1,6.269076709,15713,7462,7168,294,2,292
17669,9944,8774,0,0,36603,,,,,,1,1,7.412331493,18875,8729,8459,270,5,265
17669,10618,9900,2,4,36489,,,,,,1,1,7.424326395,18603,8801,8517,284,11,273
17669,10869,10301,0,0,1034,,,,,,1,1,0.217699907,375,277,172,105,1,104
17669,10591,10064,0,2,36178,,,,,,1,1,7.472985562,18680,8582,8248,334,1,333
17669,11334,9706,0,0,36242,,,,,,1,1,7.402171815,18640,8629,8285,344,2,342
17669,11037,9563,0,0,37396,,,,,,1,1,7.521788772,19085,8992,8665,327,0,327
17669,8640,10402,0,2,37027,,,,,,1,1,7.55651873,18941,8896,8602,294,3,291
17669,8555,9775,0,0,36582,,,,,,1,1,7.480669853,18859,8734,8479,255,1,254
17669,9908,11025,0,2,36597,,,,,,1,1,7.555262225,18503,8882,8552,330,0,330
17669,9397,11772,0,0,5486,,,,,,1,1,1.128500568,2617,1348,1175,173,0,173
17669,10703,9337,0,2,37116,,,,,,1,1,7.683896673,18909,8950,8643,307,6,301
17669,9109,10993,2,4,35815,,,,,,1,1,7.358743607,18574,8491,8232,259,2,257
17669,10744,9793,0,0,36268,,,,,,1,1,7.3995399410000005,18706,8636,8346,290,0,290
17669,10659,10515,2,0,3601,,,,,,1,1,0.734835827,1696,869,702,167,2,165
17669,10553,10568,0,0,37647,,,,,,1,1,7.665080475,19388,8956,8609,347,3,344
17669,10575,9688,0,0,35582,,,,,,1,1,7.360520469,18440,8420,8118,302,2,300
17669,10234,10314,0,0,35741,,,,,,1,1,7.37089729,18505,8459,8141,318,7,311
17669,10952,10225,0,0,4312,,,,,,1,1,0.881489854,2008,1061,879,182,0,182
17669,10808,9864,0,3,36971,,,,,,1,1,7.565451111,19338,8657,8338,319,2,317
17669,10122,10552,2,0,35277,,,,,,1,1,7.29947045,18062,8473,8204,269,0,269
17669,10358,8884,0,2,37158,,,,,,1,1,7.557796501,18908,8972,8666,306,2,304
17669,10306,9920,0,0,35546,,,,,,1,1,7.3407575099999995,18580,8324,8006,318,6,312
17669,9572,10119,2,0,34748,,,,,,1,1,7.125105452,18249,8112,7837,275,1,274
17669,10778,10392,0,0,26707,,,,,,1,1,5.419413446,13620,6373,6032,341,1,340
17669,11035,9978,0,0,34597,,,,,,1,1,7.142700262,17916,8190,7889,301,0,301
17669,9591,11691,0,2,2962,,,,,,1,1,0.606092238,1314,753,611,142,4,138
17669,9404,11104,0,0,35745,,,,,,1,1,7.517859127,18576,8430,8121,309,1,308
17669,9938,10639,0,0,35652,,,,,,1,1,7.391923935,18511,8417,8110,307,3,304
17669,10091,11350,0,0,2343,,,,,,1,1,0.483361493,1017,591,447,144,0,144
17669,10893,10292,0,0,2774,,,,,,1,1,0.562024977,1239,688,529,159,0,159
17669,9701,10289,1,0,38518,,,,,,1,1,7.953836461,19255,9453,9096,357,9,348
17669,10588,9139,0,2,35940,,,,,,1,1,7.3108378609999995,18323,8670,8393,277,6,271
17669,10586,10584,4,0,7164,,,,,,1,1,1.4464745190000001,3433,1757,1540,217,4,213
17669,11231,10089,2,0,17443,,,,,,1,1,3.597945235,8638,4270,4005,265,0,265
17669,10053,11257,3,4,14036,,,,,,1,1,2.869377821,7071,3365,3130,235,5,230
17669,9738,11032,1,4,34941,,,,,,1,1,7.240143954,18389,8123,7817,306,2,304
17669,10877,10506,4,2,21948,,,,,,1,1,4.470222128,11234,5221,4949,272,5,267
17669,10294,10424,2,0,34756,,,,,,1,1,7.083508586,18055,8206,7917,289,0,289
17669,9500,11670,0,0,10531,,,,,,1,1,2.147677715,5162,2553,2290,263,0,263
17669,9745,11230,2,2,36953,,,,,,1,1,7.504525506,18726,8963,8662,301,10,291
17669,10125,10902,0,5,35113,,,,,,1,1,7.254787336,18364,8206,7869,337,12,325
17669,9320,9425,2,0,34765,,,,,,1,1,7.098044673,18378,8060,7793,267,2,265
17669,9772,9768,2,0,35876,,,,,,1,1,7.233504024,18841,8386,8123,263,2,261
17669,8577,10229,2,2,37769,,,,,,1,1,7.876675717,19290,9097,8812,285,10,275
17669,11125,8668,2,2,36248,,,,,,1,1,7.429001479,18836,8563,8277,286,3,283
17669,11319,9249,0,2,35642,,,,,,1,1,7.397126737,18509,8418,8121,297,3,294
17669,11068,10104,2,0,8218,,,,,,1,1,1.655637094,3916,2045,1833,212,1,211
17669,8840,10701,0,0,37152,,,,,,1,1,7.670799447,19105,8867,8554,313,1,312
17669,10692,10509,0,0,2984,,,,,,1,1,0.615037407,1311,758,601,157,1,156
17669,9952,11552,0,2,4184,,,,,,1,1,0.850299632,1986,1009,829,180,2,178
17669,9406,10325,0,0,34661,,,,,,1,1,7.182476587,18084,8145,7858,287,1,286
17669,9775,10021,0,0,34537,,,,,,1,1,7.100725942,18073,8088,7800,288,5,283
17669,10418,10233,2,2,36448,,,,,,1,1,7.512013226,18491,8832,8539,293,1,292
17669,10326,10844,2,2,10169,,,,,,1,1,2.052922429,4978,2485,2264,221,2,219
17669,10559,10831,0,4,9209,,,,,,1,1,1.8871683369999999,4457,2263,2037,226,2,224
17669,10979,10195,0,0,2910,,,,,,1,1,0.592637342,1300,719,547,172,0,172
17669,9765,10766,2,1,37587,,,,,,1,1,7.849197701,19071,9102,8790,312,6,306
17669,9081,9745,0,2,36043,,,,,,1,1,7.35278664,18436,8673,8412,261,2,259
17669,9900,10264,2,0,35883,,,,,,1,1,7.436283271,18335,8624,8324,300,0,300
17669,11348,10081,0,2,2920,,,,,,1,1,0.592155584,1262,754,604,150,0,150
17669,9274,10514,0,2,35885,,,,,,1,1,7.442739481,18426,8582,8287,295,2,293
17669,10792,9939,0,2,35723,,,,,,1,1,7.42052094,18907,8254,7946,308,0,308
17669,11031,8703,0,0,33996,,,,,,1,1,6.917764842,17905,7914,7651,263,1,262
17669,9421,10205,2,0,36856,,,,,,1,1,7.626131045,19006,8767,8451,316,3,313
17669,11191,10279,0,4,8557,,,,,,1,1,1.743443386,4205,2074,1870,204,6,198
17669,9813,9728,2,0,34105,,,,,,1,1,6.944666411,18054,7913,7688,225,3,222
17669,10050,8167,2,0,36752,,,,,,1,1,7.688424866,18944,8780,8532,248,12,236
17669,10522,9286,0,0,37259,,,,,,1,1,6.665740651,19186,8889,8594,295,1,294
17669,10349,10820,0,0,20025,,,,,,1,1,4.147065215,9982,4895,4642,253,0,253
17669,9960,10091,4,2,36865,,,,,,1,1,7.459831391,18770,8883,8554,329,3,326
17669,10534,9451,6,0,36334,,,,,,1,1,7.392229204,18903,8565,8264,301,1,300
17669,10293,9605,0,2,37803,,,,,,1,1,6.894135848,19310,9084,8759,325,17,308
17669,9576,10267,2,0,36004,,,,,,1,1,6.405022238,18836,8438,8146,292,5,287
17669,9738,11452,0,3,29665,,,,,,1,1,6.049323718,14941,7213,6915,298,2,296
17669,10662,10487,2,0,36989,,,,,,1,1,7.595928455,18393,9136,8812,324,3,321
17669,10084,9240,0,4,38902,,,,,,1,1,7.560313436,19346,9621,9307,314,4,310
17669,10550,9399,4,0,37754,,,,,,1,1,7.064117084,19259,9094,8787,307,4,303
17669,10381,10398,0,0,36016,,,,,,1,1,5.882152681,18591,8546,8213,333,1,332
17669,9259,10218,0,0,37601,,,,,,1,1,5.571564634,19441,8941,8663,278,3,275
17669,9040,11463,0,0,35034,,,,,,1,1,5.687589919,18480,8127,7827,300,8,292
17669,10158,10632,2,0,37139,,,,,,1,1,5.637629774,19027,8881,8531,350,2,348
17669,9436,9822,0,4,37520,,,,,,1,1,5.719018387,19270,8975,8675,300,4,296
17669,10073,10090,0,0,36854,,,,,,1,1,6.308072239,18864,8849,8557,292,0,292
17669,10488,10576,4,0,36352,,,,,,1,1,5.75932442,18516,8748,8408,340,9,331
17669,10266,10843,4,0,36341,,,,,,1,1,6.028259909,18477,8757,8407,350,9,341
