key_bits,recovered_zeros_x,recovered_zeros_y,wrong_zeros_x,wrong_zeros_y,queries,traces,calibration_traces,threshold,tpr,tnr,attack_tpr,attack_tnr,duration_seconds,test_outcomes_0_false,test_outcomes_0_true,test_outcomes_1_false,test_outcomes_1_true,test_outcomes_2_false,test_outcomes_2_true
17669,12423,11600,2,0,33380,,,,,,1,1,6.7663019989999995,16876,8065,7691,374,0,374
17669,11445,10340,0,0,34121,,,,,,1,1,6.934222454,17666,8069,7752,317,3,314
17669,10994,10330,0,0,33612,,,,,,1,1,6.959246712,17534,7886,7580,306,2,304
17669,10801,11796,6,4,33998,,,,,,1,1,6.998862083,17624,8041,7749,292,1,291
17669,11113,9767,3,0,34120,,,,,,1,1,7.034830633,18115,7869,7602,267,1,266
17669,9324,11229,4,0,33745,,,,,,1,1,7.067128391,17755,7840,7530,310,5,305
17669,9853,11346,2,2,34790,,,,,,1,1,7.125645395,18273,8086,7741,345,13,332
17669,10896,9351,1,1,35359,,,,,,1,1,7.196944686,18618,8242,7985,257,1,256
17669,11269,10957,0,0,35104,,,,,,1,1,7.213480286,18162,8302,7964,338,3,335
17669,11332,10269,2,0,35455,,,,,,1,1,7.243910199,18295,8416,8088,328,10,318
17669,10260,11553,0,0,35738,,,,,,1,1,7.322114886,18371,8510,8163,347,3,344
17669,11500,10477,2,0,36148,,,,,,1,1,7.325406492,18540,8635,8297,338,1,337
17669,10061,12227,2,2,34547,,,,,,1,1,7.326507837,17949,8132,7798,334,2,332
17669,9514,10878,2,0,36275,,,,,,1,1,7.33318998,18261,8857,8557,300,4,296
17669,9619,9271,2,2,35491,,,,,,1,1,7.341496125,18552,8328,8045,283,13,270
17669,10999,9018,3,0,36416,,,,,,1,1,7.463221557,19129,8486,8171,315,2,313
17669,10902,10424,4,0,36474,,,,,,1,1,7.47209961,18682,8728,8392,336,7,329
17669,10413,10261,2,0,36202,,,,,,1,1,7.5533742,18561,8663,8348,315,1,314
17669,10230,11263,0,1,37302,,,,,,1,1,7.592326962,18925,9025,8698,327,0,327
17669,11573,8990,0,1,37068,,,,,,1,1,7.617692594,18764,8990,8666,324,2,322
17669,10199,9012,2,0,37543,,,,,,1,1,7.626397505,19358,8946,8653,293,1,292
17669,11814,10124,3,0,37913,,,,,,1,1,7.802507053,18683,9435,9075,360,4,356
17669,12021,10527,0,2,37768,,,,,,1,1,7.834990314,18800,9295,8917,378,0,378
17669,9507,10574,0,2,38607,,,,,,1,1,7.919491659,19556,9382,9095,287,8,279
17669,11774,12086,4,2,25290,,,,,,1,1,5.157158836,13487,5745,5432,313,6,307
17669,10938,10694,0,2,34206,,,,,,1,1,6.992054724,17821,8045,7750,295,5,290
17669,10829,11754,2,2,34317,,,,,,1,1,7.232547606,17946,8010,7659,351,2,349
17669,11017,9763,1,2,35835,,,,,,1,1,7.30403394,18494,8511,8192,319,8,311
17669,11988,10910,2,2,34618,,,,,,1,1,7.111781148,18053,8121,7798,323,1,322
17669,10003,11079,0,0,35456,,,,,,1,1,7.226593213,18446,8355,8055,300,1,299
17669,10012,10814,6,2,35265,,,,,,1,1,7.193531963,18075,8435,8115,320,21,299
17669,10888,9079,0,0,37227,,,,,,1,1,7.516799166,18980,8961,8636,325,1,324
17669,9110,10144,0,0,38526,,,,,,1,1,7.810523219,19001,9617,9326,291,3,288
17669,9660,10907,0,0,35820,,,,,,1,1,7.34516569,18450,8518,8184,334,0,334
17669,10167,11640,0,0,36363,,,,,,1,1,7.45020308,18445,8799,8479,320,2,318
17669,10096,10070,0,2,36963,,,,,,1,1,7.537562664,18967,8856,8572,284,2,282
17669,10951,9302,1,0,35836,,,,,,1,1,7.2875917789999995,18221,8654,8347,307,2,305
17669,10490,9100,0,0,36110,,,,,,1,1,7.250094718,18444,8688,8398,290,3,287
17669,10820,10876,0,0,37615,,,,,,1,1,7.565137636,19038,9113,8762,351,3,348
17669,10377,10543,0,0,36299,,,,,,1,1,7.473713756,18750,8614,8293,321,4,317
17669,10736,9657,2,2,35659,,,,,,1,1,7.4533397820000005,18508,8430,8139,291,3,288
17669,10341,8234,0,0,36750,,,,,,1,1,7.698317268,18950,8775,8525,250,2,248
17669,10549,9468,2,4,36535,,,,,,1,1,7.424562993,19006,8618,8325,293,4,289
17669,10889,10304,5,0,37334,,,,,,1,1,7.525919521,19175,8916,8589,327,1,326
17669,9666,11616,2,0,38150,,,,,,1,1,7.975775183,19198,9308,8972,336,5,331
17669,10683,9508,0,2,35882,,,,,,1,1,7.474685848,18736,8417,8105,312,0,312
17669,10098,9364,0,2,36553,,,,,,1,1,7.576765817,19008,8634,8357,277,5,272
17669,11271,10780,0,0,36039,,,,,,1,1,7.557751882,18416,8628,8261,367,5,362
17669,10649,10812,0,2,36908,,,,,,1,1,7.444562864,18657,8960,8629,331,4,327
17669,9570,11076,2,0,34570,,,,,,1,1,7.112288671,18083,8086,7771,315,0,315
17669,9476,11230,0,2,34819,,,,,,1,1,7.089482794,18239,8150,7870,280,6,274
17669,10379,10400,2,0,32034,,,,,,1,1,6.521557752,16988,7398,7148,250,2,248
17669,11239,10795,2,0,34816,,,,,,1,1,7.257604279,18011,8244,7927,317,5,312
17669,9609,11629,2,0,32952,,,,,,1,1,6.973171426,17660,7496,7196,300,2,298
17669,10318,11897,0,0,36292,,,,,,1,1,7.435766374,18456,8760,8444,316,1,315
17669,12027,9539,0,0,34239,,,,,,1,1,7.094706024,17968,7979,7666,313,1,312
17669,10130,10455,2,2,37204,,,,,,1,1,7.578541078,19260,8823,8525,298,2,296
17669,11495,9126,3,2,35541,,,,,,1,1,7.148391859,18276,8486,8193,293,3,290
17669,10788,9178,0,3,36173,,,,,,1,1,7.308309121,18570,8642,8323,319,7,312
17669,11809,9792,0,2,37126,,,,,,1,1,7.564965978,19064,8840,8458,382,5,377
17669,9752,12383,0,0,37020,,,,,,1,1,7.584364778,18748,8964,8620,344,1,343
17669,11156,11303,0,3,32847,,,,,,1,1,6.780124772,17165,7691,7391,300,0,300
17669,10224,11254,3,0,35877,,,,,,1,1,7.247262804,18429,8565,8247,318,10,308
17669,10702,10720,4,1,36992,,,,,,1,1,7.679976026,18670,8986,8636,350,18,332
17669,11656,11235,1,0,36447,,,,,,1,1,7.452945931,18568,8767,8422,345,1,344
17669,9812,10591,0,0,35744,,,,,,1,1,7.3731280120000005,18791,8321,8010,311,2,309
17669,9207,10964,0,2,35132,,,,,,1,1,7.112079974,18239,8306,8025,281,3,278
17669,10324,10933,1,2,36904,,,,,,1,1,7.476072702,18985,8803,8490,313,3,310
17669,10454,9687,4,1,38629,,,,,,1,1,7.826942937,19800,9233,8870,363,17,346
17669,8550,9701,0,2,36495,,,,,,1,1,7.452317561,19208,8505,8228,277,7,270
17669,11168,9780,4,0,38292,,,,,,1,1,7.687726882,19221,9365,9024,341,13,328
17669,10521,11357,4,0,35666,,,,,,1,1,7.5127462000000005,18242,8555,8241,314,2,312
17669,11260,11071,0,1,35710,,,,,,1,1,7.442673942,18359,8522,8215,307,4,303
17669,10796,11392,2,0,36241,,,,,,1,1,7.330706121,18518,8710,8407,303,3,300
17669,8455,9958,2,2,36889,,,,,,1,1,7.622502104,19039,8792,8526,266,2,264
17669,9712,10758,1,2,36827,,,,,,1,1,7.481923521,18973,8793,8525,268,4,264
17669,12068,10275,2,2,34385,,,,,,1,1,7.180304851,17937,8058,7726,332,1,331
17669,10623,10684,2,1,37566,,,,,,1,1,7.747393398,19060,9085,8749,336,8,328
17669,10382,10026,0,0,37214,,,,,,1,1,7.551282733,18866,9013,8691,322,2,320
17669,10801,10537,4,1,34857,,,,,,1,1,7.147025737,18276,8124,7791,333,7,326
17669,10355,10827,2,4,35490,,,,,,1,1,7.224733426,18473,8352,8039,313,6,307
17669,10826,9259,0,4,36701,,,,,,1,1,7.544732122,18606,8892,8581,311,3,308
17669,11712,10535,3,2,33474,,,,,,1,1,7.050414605,17735,7709,7388,321,1,320
17669,10876,9332,0,0,35006,,,,,,1,1,7.262177476,18286,8220,7940,280,1,279
17669,10765,11042,0,2,36884,,,,,,1,1,7.467578549,18685,8942,8627,315,2,313
17669,7964,10771,0,0,37176,,,,,,1,1,7.800227679,19094,8895,8603,292,3,289
17669,9737,9330,0,0,37976,,,,,,1,1,7.669031107,19277,9185,8856,329,1,328
17669,11160,9551,3,0,35261,,,,,,1,1,7.345526622,18570,8202,7915,287,5,282
17669,9727,11423,0,2,35050,,,,,,1,1,7.217744767,18016,8357,8037,320,5,315
17669,9771,8009,0,0,38454,,,,,,1,1,7.770252322,19640,9277,9017,260,3,257
17669,10514,10369,0,2,38056,,,,,,1,1,8.133479448,19358,9196,8890,306,1,305
17669,10011,10511,0,0,36991,,,,,,1,1,7.696077782,18809,8939,8635,304,1,303
17669,9517,11718,0,0,37876,,,,,,1,1,7.69380989,18895,9325,8994,331,2,329
17669,11615,10714,0,0,37306,,,,,,1,1,7.831250549,18909,9015,8648,367,1,366
17669,10598,9873,2,0,34740,,,,,,1,1,7.298462198,18131,8155,7856,299,2,297
17669,10020,9149,2,0,37854,,,,,,1,1,7.660627698,19174,9187,8881,306,3,303
17669,10953,10056,0,2,36143,,,,,,1,1,7.383791449,18701,8566,8256,310,1,309
17669,12072,11951,2,2,26901,,,,,,1,1,5.735441742,14173,6204,5884,320,2,318
17669,9328,10888,0,4,36048,,,,,,1,1,7.318792741,18652,8554,8266,288,0,288
17669,9589,11362,0,4,35728,,,,,,1,1,7.237594513,18285,8556,8225,331,4,327
17669,10905,10413,2,0,36109,,,,,,1,1,7.498121601,18444,8673,8354,319,2,317
17669,10578,9485,4,2,36981,,,,,,1,1,7.497630394,19004,8839,8540,299,6,293
17669,10742,11036,2,0,34551,,,,,,1,1,7.202431594,18144,8042,7719,323,3,320
17669,11961,9656,3,0,34339,,,,,,1,1,7.053252361,17994,8030,7745,285,0,285
17669,11241,10997,2,4,36179,,,,,,1,1,7.36345027,18651,8606,8290,316,3,313
17669,8865,10287,0,0,37074,,,,,,1,1,7.500785227,19136,8822,8528,294,2,292
17669,10832,10742,0,2,36792,,,,,,1,1,7.568005269,18548,8955,8621,334,6,328
17669,10042,12784,2,0,32998,,,,,,1,1,7.026720251,17484,7602,7292,310,0,310
17669,8674,11416,0,2,37653,,,,,,1,1,7.711557323,19042,9149,8836,313,4,309
17669,8269,10987,0,2,36992,,,,,,1,1,7.574329937,19008,8855,8581,274,2,272
17669,9633,10889,2,0,34573,,,,,,1,1,7.036997053,18116,8088,7807,281,3,278
17669,9723,10928,2,0,34627,,,,,,1,1,7.126472377,17985,8160,7838,322,3,319
17669,9642,9345,0,0,36671,,,,,,1,1,7.718810192,19026,8688,8419,269,3,266
17669,9878,9736,7,2,35218,,,,,,1,1,7.102724506,18392,8278,8008,270,4,266
17669,10507,8899,0,2,37334,,,,,,1,1,7.625224053,19161,8936,8635,301,4,297
17669,9940,9956,0,0,36809,,,,,,1,1,7.502767412,18698,8907,8610,297,2,295
17669,11364,11093,2,3,36784,,,,,,1,1,7.712360522,18615,8920,8591,329,5,324
17669,11410,10390,0,0,36904,,,,,,1,1,7.635617975,18802,8872,8514,358,0,358
17669,9925,11312,0,1,36060,,,,,,1,1,7.54670343,18461,8643,8330,313,1,312
17669,10634,9222,2,0,39509,,,,,,1,1,7.976451208,19899,9657,9361,296,0,296
17669,11675,10708,2,2,35035,,,,,,1,1,7.187134253,18588,8072,7769,303,12,291
17669,10053,12397,4,2,34296,,,,,,1,1,7.094603335,17891,8029,7682,347,18,329
17669,12004,10408,2,2,33827,,,,,,1,1,6.947877607,17580,7957,7624,333,5,328
17669,11552,10221,4,6,36086,,,,,,1,1,7.263292915,18541,8598,8249,349,16,333
17669,11099,10691,6,0,33023,,,,,,1,1,6.972228483,17330,7691,7380,311,10,301
17669,9312,9402,0,4,36433,,,,,,1,1,7.485956126,19269,8448,8180,268,1,267
17669,8481,10554,0,0,37515,,,,,,1,1,7.726043719,18914,9156,8867,289,2,287
17669,11277,10224,2,2,35403,,,,,,1,1,7.446873603,18430,8338,8041,297,6,291
17669,10342,9789,3,0,36931,,,,,,1,1,7.877459321,18919,8849,8535,314,4,310
17669,10394,11395,0,0,34893,,,,,,1,1,7.296802768,18415,8080,7762,318,1,317
17669,9250,10740,0,2,37156,,,,,,1,1,7.676293446,18946,8954,8652,302,1,301
17669,8807,10608,0,0,35530,,,,,,1,1,7.258903101,18542,8363,8101,262,4,258
17669,10666,10952,0,6,37259,,,,,,1,1,7.562701619,18639,9132,8776,356,3,353
17669,10023,10985,0,0,36580,,,,,,1,1,7.554254631,18215,9038,8749,289,0,289
17669,10218,11621,2,2,36277,,,,,,1,1,7.553123265,18616,8670,8349,321,4,317
17669,8799,10213,0,0,37967,,,,,,1,1,7.6621847800000005,19188,9260,9001,259,0,259
17669,10561,10036,0,0,35795,,,,,,1,1,7.33308784,18305,8599,8307,292,2,290
17669,10328,9710,0,0,37728,,,,,,1,1,7.795171705,19095,9154,8829,325,5,320
17669,10581,10804,2,2,35733,,,,,,1,1,7.372500557,18518,8440,8105,335,12,323
17669,11090,10446,0,2,36636,,,,,,1,1,7.554925759,18801,8749,8412,337,2,335
17669,8980,9279,2,2,38369,,,,,,1,1,8.24431355,19088,9505,9234,271,5,266
17669,10357,10320,5,0,37675,,,,,,1,1,7.8906565,18900,9250,8975,275,5,270
17669,10569,10610,0,0,37026,,,,,,1,1,7.65671157,18982,8873,8575,298,2,296
17669,10481,10230,0,0,38508,,,,,,1,1,7.931753848,19191,9510,9213,297,1,296
17669,10974,9646,2,2,38351,,,,,,1,1,7.679728688,19589,9227,8919,308,3,305
17669,9856,11465,0,1,34665,,,,,,1,1,7.140205506,18204,8075,7764,311,2,309
17669,9572,10906,0,2,37205,,,,,,1,1,7.581112934,18959,8974,8676,298,3,295
17669,10576,9802,1,0,35343,,,,,,1,1,7.25314846,18502,8263,7948,315,1,314
17669,10575,10823,3,2,37822,,,,,,1,1,7.649100096,19400,9043,8707,336,0,336
17669,9126,12103,0,5,35220,,,,,,1,1,7.36993087,18497,8200,7877,323,11,312
17669,10574,11205,2,0,35040,,,,,,1,1,7.330777736,18321,8194,7863,331,4,327
17669,9591,11303,0,0,36700,,,,,,1,1,7.479539211,18512,8916,8560,356,1,355
17669,10164,10874,3,1,38373,,,,,,1,1,7.910359062,19479,9291,8979,312,14,298
17669,9387,11315,0,0,34657,,,,,,1,1,7.200964943,17775,8281,7961,320,2,318
17669,9539,9964,2,2,35538,,,,,,1,1,7.242807584,18482,8377,8075,302,4,298
17669,12346,11075,2,0,34542,,,,,,1,1,7.149984496,17869,8168,7831,337,6,331
17669,11332,10244,0,0,34059,,,,,,1,1,6.948322866,18118,7814,7501,313,6,307
17669,10361,10260,2,2,35291,,,,,,1,1,7.380364044,17970,8521,8242,279,9,270
17669,10258,10613,0,0,37600,,,,,,1,1,7.612718678,19061,9113,8800,313,1,312
17669,10766,10629,1,4,36903,,,,,,1,1,7.545103828,18828,8884,8577,307,8,299
17669,11578,11298,2,0,35109,,,,,,1,1,7.127222258,18428,8166,7817,349,10,339
17669,10425,9983,2,2,37187,,,,,,1,1,7.640878358,19170,8848,8527,321,3,318
17669,10716,9284,0,0,35974,,,,,,1,1,7.279314127,18643,8501,8172,329,3,326
17669,10078,9989,0,0,35177,,,,,,1,1,7.361230445,18451,8214,7916,298,1,297
17669,11778,11893,0,0,5836,,,,,,1,1,1.201665908,2722,1437,1197,240,0,240
17669,10826,9781,2,0,37700,,,,,,1,1,7.760362864,19089,9145,8824,321,2,319
17669,10431,11336,0,4,36435,,,,,,1,1,7.421208976,18552,8772,8433,339,4,335
17669,10374,9215,2,0,38062,,,,,,1,1,7.822633439,19550,9116,8836,280,2,278
17669,10369,10482,0,4,35914,,,,,,1,1,7.411595141,18754,8426,8118,308,1,307
17669,9453,9795,0,0,36362,,,,,,1,1,7.378187358,18925,8565,8258,307,4,303
17669,10030,11147,0,2,39157,,,,,,1,1,7.917057394,19458,9652,9257,395,5,390
17669,10500,11177,0,0,36026,,,,,,1,1,7.491636767,18305,8697,8370,327,3,324
17669,11522,10429,6,0,34760,,,,,,1,1,7.038454576,18179,8138,7833,305,10,295
17669,10183,10549,2,0,36499,,,,,,1,1,7.395928476,18886,8656,8355,301,4,297
17669,10521,9685,0,0,36511,,,,,,1,1,7.502184602,18476,8850,8515,335,4,331
17669,11219,12072,2,0,36611,,,,,,1,1,7.512330803,18431,8909,8547,362,2,360
17669,10289,9441,0,0,35497,,,,,,1,1,7.219557679,18788,8207,7912,295,5,290
17669,11681,10816,4,3,36023,,,,,,1,1,7.41998013,18245,8721,8385,336,15,321
17669,9104,9819,0,2,37251,,,,,,1,1,7.659356552,18938,9017,8738,279,1,278
17669,9137,10221,3,0,36290,,,,,,1,1,7.33139528,18672,8673,8401,272,4,268
17669,9560,9700,0,2,36961,,,,,,1,1,7.521147894,18979,8854,8580,274,4,270
17669,10797,9107,2,0,36030,,,,,,1,1,7.448425984,18644,8553,8273,280,2,278
17669,11026,10104,2,3,34708,,,,,,1,1,7.030686396,18141,8130,7823,307,3,304
17669,11475,10050,0,0,37170,,,,,,1,1,7.682207708,18980,8935,8615,320,1,319
17669,12297,10260,4,0,34137,,,,,,1,1,7.040070976,17975,7910,7568,342,9,333
17669,9938,10639,0,0,35649,,,,,,1,1,7.268318383,18511,8416,8110,306,3,303
17669,10848,11286,0,0,34322,,,,,,1,1,7.055358557,17591,8196,7857,339,2,337
17669,10797,10597,0,4,36083,,,,,,1,1,7.294390554,18242,8748,8403,345,7,338
17669,10423,10075,0,0,35525,,,,,,1,1,7.195590793,18040,8590,8285,305,0,305
17669,10386,10814,0,0,34338,,,,,,1,1,6.976989938,17873,8069,7742,327,3,324
17669,8813,10486,0,4,37030,,,,,,1,1,7.564976567,18954,8881,8567,314,8,306
17669,9976,10953,0,2,36339,,,,,,1,1,7.436543474,18715,8648,8320,328,12,316
17669,10008,10977,0,2,36475,,,,,,1,1,7.400346041,18399,8888,8588,300,1,299
17669,10102,10412,0,0,36746,,,,,,1,1,7.5853137870000005,19076,8682,8376,306,1,305
17669,10229,9893,2,0,35324,,,,,,1,1,7.5088332829999995,18406,8296,7970,326,2,324
17669,10819,10415,0,1,32993,,,,,,1,1,6.80463121,17615,7542,7248,294,3,291
17669,11081,10948,0,0,34824,,,,,,1,1,7.35011273,18038,8228,7898,330,2,328
17669,10193,12028,2,4,35975,,,,,,1,1,7.309478734,18163,8736,8396,340,2,338
17669,9519,11657,0,4,34667,,,,,,1,1,7.193964392,17660,8343,8022,321,17,304
17669,11326,11010,1,1,35626,,,,,,1,1,7.371404033,18258,8525,8207,318,0,318
17669,11228,9217,3,0,35682,,,,,,1,1,7.262610294,18773,8299,7988,311,0,311
17669,9906,9229,0,4,36075,,,,,,1,1,7.323291835,18847,8487,8233,254,3,251
17669,10571,10997,0,3,35447,,,,,,1,1,7.295096842,18371,8372,8040,332,10,322
17669,9633,10520,2,2,36210,,,,,,1,1,7.334279166,18875,8515,8210,305,11,294
17669,9690,10568,4,0,35492,,,,,,1,1,7.311747194,18442,8393,8129,264,1,263
17669,9507,11301,3,2,35905,,,,,,1,1,7.4595020739999995,18580,8508,8199,309,2,307
17669,10838,9737,0,2,35893,,,,,,1,1,7.427685402,18588,8496,8183,313,4,309
17669,9404,11104,0,0,35685,,,,,,1,1,7.315652197,18576,8410,8121,289,1,288
17669,10773,10762,0,0,36265,,,,,,1,1,7.532135881,18469,8714,8346,368,0,368
17669,9981,11955,0,0,35747,,,,,,1,1,7.416795379,18098,8654,8313,341,3,338
17669,8993,10510,0,3,38581,,,,,,1,1,7.968820429,19388,9445,9142,303,1,302
17669,10422,10382,2,0,35942,,,,,,1,1,7.257473948,18607,8517,8216,301,2,299
17669,10166,11523,4,0,36795,,,,,,1,1,7.57836014,18788,8833,8492,341,9,332
17669,10872,10859,0,0,37983,,,,,,1,1,7.766585521,19324,9162,8827,335,0,335
17669,11109,10922,0,4,36823,,,,,,1,1,7.680464655,18545,8972,8638,334,1,333
17669,11143,10930,2,5,38014,,,,,,1,1,7.860017695,19001,9337,8998,339,8,331
17669,10654,10291,0,2,37993,,,,,,1,1,7.62475284,19380,9137,8798,339,8,331
17669,10382,10766,2,2,35976,,,,,,1,1,7.601065751,18354,8658,8352,306,4,302
17669,10013,10479,0,2,35356,,,,,,1,1,7.377574388,18274,8389,8085,304,4,300
17669,10726,10317,2,2,35193,,,,,,1,1,7.202751893,18206,8342,8039,303,2,301
17669,10405,9700,0,0,36020,,,,,,1,1,7.374296912,18329,8694,8391,303,3,300
17669,10521,10477,1,0,35085,,,,,,1,1,7.107908245,18458,8166,7871,295,1,294
17669,10918,11675,0,0,37030,,,,,,1,1,7.732271275,18638,9014,8650,364,1,363
17669,11065,9689,6,2,37368,,,,,,1,1,7.819306903,19034,9014,8708,306,1,305
17669,11581,10289,0,2,35731,,,,,,1,1,7.656451603,18279,8555,8213,342,9,333
17669,10942,8966,2,0,37984,,,,,,1,1,7.653126957,19119,9271,8948,323,2,321
17669,10306,9920,0,0,35549,,,,,,1,1,7.431957099,18580,8325,8006,319,6,313
17669,10899,11419,0,3,34996,,,,,,1,1,7.171592816,18113,8274,7939,335,4,331
17669,7995,9070,4,2,37017,,,,,,1,1,7.516241228,18967,8906,8668,238,3,235
17669,9900,10264,2,0,35814,,,,,,1,1,7.279750576,18335,8601,8324,277,0,277
17669,10092,9487,3,0,35930,,,,,,1,1,7.438230054,18626,8524,8268,256,1,255
17669,11928,10346,0,0,35643,,,,,,1,1,7.212080287,18322,8487,8140,347,2,345
17669,10094,10775,4,0,35585,,,,,,1,1,7.383248311,18651,8334,8068,266,3,263
17669,9572,9736,0,0,38870,,,,,,1,1,7.882960773,19413,9568,9247,321,4,317
17669,9548,10312,0,0,35477,,,,,,1,1,7.42574313,18558,8311,8014,297,3,294
17669,9504,10335,0,0,35933,,,,,,1,1,7.575885732,18896,8373,8082,291,1,290
17669,9008,8830,0,0,37967,,,,,,1,1,7.855888114,19322,9180,8895,285,2,283
17669,10271,8485,0,0,38481,,,,,,1,1,7.870926821,19271,9462,9176,286,3,283
17669,9992,11027,0,4,36097,,,,,,1,1,7.485363014,18384,8700,8387,313,2,311
17669,10686,9868,0,0,36783,,,,,,1,1,7.4891541440000005,18952,8763,8458,305,3,302
17669,11226,10484,3,3,37636,,,,,,1,1,7.566990234,19182,9061,8729,332,2,330
17669,11089,11550,0,4,35510,,,,,,1,1,7.250697428,18471,8362,8047,315,7,308
17669,10496,10439,1,1,35701,,,,,,1,1,7.210904774,18611,8390,8080,310,4,306
17669,12050,11520,2,0,37128,,,,,,1,1,7.67362793,18940,8902,8518,384,3,381
17669,11125,10237,2,2,38273,,,,,,1,1,7.789336754,19098,9425,9100,325,3,322
17669,10196,11549,0,0,35024,,,,,,1,1,7.138110421,18321,8200,7897,303,4,299
17669,11338,11019,2,2,37181,,,,,,1,1,7.544037861,18934,8949,8600,349,4,345
17669,11168,10187,2,4,35529,,,,,,1,1,7.485109084,18021,8592,8268,324,9,315
17669,9362,11702,4,0,35850,,,,,,1,1,7.383503334,18172,8677,8353,324,9,315
17669,9775,10021,0,0,34519,,,,,,1,1,7.278813192,18073,8082,7800,282,5,277
17669,10144,11447,2,0,35735,,,,,,1,1,7.435331602,18188,8619,8310,309,3,306
17669,12093,9923,0,0,35332,,,,,,1,1,7.356354687,18343,8326,7989,337,2,335
17669,11511,9656,0,4,33714,,,,,,1,1,6.882628147,17688,7869,7581,288,4,284
17669,10364,9734,0,0,35236,,,,,,1,1,7.208605168,18372,8277,7967,310,3,307
17669,10708,10761,2,2,34936,,,,,,1,1,7.208486895,18062,8289,7993,296,2,294
17669,9960,10091,4,2,36821,,,,,,1,1,7.531032227,18760,8871,8552,319,3,316
17669,9571,10612,2,0,37023,,,,,,1,1,7.586558667,18744,8982,8667,315,7,308
17669,10281,10371,4,2,35819,,,,,,1,1,7.305333137,18669,8420,8110,310,5,305
17669,9377,11126,0,0,36458,,,,,,1,1,7.608457821,18628,8762,8456,306,2,304
17669,10653,9786,2,0,37803,,,,,,1,1,7.649263216,18977,9254,8936,318,5,313
17669,12200,10531,4,3,34500,,,,,,1,1,7.071747114,17747,8214,7889,325,12,313
17669,10280,11315,4,0,37094,,,,,,1,1,7.595894343,18967,8899,8570,329,10,319
17669,11101,10576,0,0,35450,,,,,,1,1,7.403447654,18162,8471,8125,346,3,343
17669,10866,11704,6,2,34943,,,,,,1,1,7.151683162,18136,8236,7901,335,6,329
17669,11376,11461,0,0,35065,,,,,,1,1,7.300888211,17796,8458,8105,353,0,353
17669,9047,10326,0,0,35847,,,,,,1,1,7.390737328,18396,8578,8283,295,0,295
17669,11092,10848,2,0,36451,,,,,,1,1,7.543668745,18894,8608,8267,341,1,340
17669,10436,10417,0,0,36755,,,,,,1,1,7.471761057,18516,8947,8602,345,1,344
17669,11273,10986,0,3,35006,,,,,,1,1,7.191303877,18180,8245,7909,336,2,334
17669,10687,9102,0,0,36430,,,,,,1,1,7.390025733,18543,8790,8483,307,3,304
17669,10565,9329,4,0,35869,,,,,,1,1,7.433556965,18366,8603,8306,297,4,293
17669,11214,9860,4,2,34848,,,,,,1,1,7.195677297,18207,8161,7842,319,12,307
17669,10423,11005,0,0,35109,,,,,,1,1,7.413979334,18145,8326,8014,312,2,310
17669,9576,10267,2,0,36062,,,,,,1,1,7.576324035,18837,8457,8146,311,7,304
17669,9154,10978,0,0,37638,,,,,,1,1,7.776431478,18995,9162,8843,319,2,317
17669,12091,10650,2,6,37551,,,,,,1,1,7.671103478,18557,9294,8888,406,20,386
17669,9294,9708,0,3,37112,,,,,,1,1,7.468458028,19158,8831,8539,292,5,287
17669,8927,8964,0,0,38747,,,,,,1,1,7.838559569,19877,9308,9054,254,1,253
17669,10767,12055,0,0,38493,,,,,,1,1,7.968159996,19041,9539,9165,374,3,371
17669,9228,10249,0,1,35935,,,,,,1,1,7.300966175,18731,8481,8239,242,0,242
17669,10333,10046,2,0,34817,,,,,,1,1,7.274810731,18249,8134,7834,300,9,291
17669,10084,9240,0,4,38871,,,,,,1,1,7.792085174,19349,9610,9308,302,4,298
17669,9201,8844,2,0,36830,,,,,,1,1,7.507981244,19134,8729,8491,238,4,234
17669,11498,9826,2,0,36103,,,,,,1,1,7.489590618,18380,8701,8380,321,2,319
17669,10869,10321,0,0,35299,,,,,,1,1,7.133534491,18391,8302,7998,304,5,299
17669,12277,9380,0,0,35766,,,,,,1,1,7.433763503,18646,8388,8044,344,3,341
17669,9456,10514,0,0,37694,,,,,,1,1,7.615091975,19189,9103,8804,299,4,295
17669,10379,10159,4,0,38112,,,,,,1,1,7.749185634,19477,9158,8839,319,0,319
17669,12095,9659,6,0,36221,,,,,,1,1,7.506894085,18009,8934,8590,344,6,338
17669,9628,9453,0,2,36847,,,,,,1,1,7.509706364,19021,8771,8487,284,2,282
17669,10663,10483,2,0,37834,,,,,,1,1,7.617826879,19223,9132,8785,347,4,343
17669,10410,12358,4,2,36601,,,,,,1,1,7.385085763,18777,8731,8369,362,9,353
17669,10779,9900,3,0,35777,,,,,,1,1,7.309649284,18533,8458,8130,328,1,327
17669,8687,10486,0,2,37955,,,,,,1,1,7.688108352,18999,9333,9043,290,2,288
17669,9848,11027,0,0,36475,,,,,,1,1,7.594022117,18605,8787,8491,296,1,295
17669,9803,8757,0,0,38773,,,,,,1,1,8.046804494,19362,9563,9278,285,1,284
17669,10678,10921,5,2,35648,,,,,,1,1,7.331765311,18247,8551,8252,299,2,297
17669,10412,9028,4,2,37550,,,,,,1,1,7.678753151,19241,9010,8721,289,2,287
17669,10612,11078,0,2,35139,,,,,,1,1,7.195521791,18147,8327,7989,338,0,338
17669,10916,9003,0,0,36596,,,,,,1,1,7.540413912,18837,8734,8443,291,2,289
17669,11353,10890,2,2,35048,,,,,,1,1,7.122210095,18145,8294,7979,315,3,312
17669,10082,9496,2,1,34751,,,,,,1,1,7.369286199,18221,8131,7863,268,11,257
17669,8946,9186,0,0,36714,,,,,,1,1,7.470801227,19040,8723,8495,228,2,226
17669,9274,10514,0,2,36177,,,,,,1,1,7.317331909,18552,8667,8376,291,2,289
17669,10016,10626,5,2,35662,,,,,,1,1,7.427250382,18667,8353,8064,289,9,280
17669,10941,10178,0,3,35244,,,,,,1,1,7.446257815,17954,8478,8144,334,1,333
17669,10991,11895,0,4,33874,,,,,,1,1,7.112308736,17627,7953,7612,341,4,337
17669,9466,9714,0,0,37748,,,,,,1,1,8.049155074,19164,9147,8857,290,0,290
17669,11528,10461,2,4,35146,,,,,,1,1,7.170825397,17822,8512,8212,300,6,294
17669,9830,10828,2,0,33801,,,,,,1,1,7.104246623,18211,7652,7366,286,3,283
17669,9494,10974,2,1,34332,,,,,,1,1,6.947070113,17923,8056,7759,297,5,292
17669,10730,10700,4,4,34941,,,,,,1,1,7.085503421,18147,8234,7908,326,4,322
17669,10903,9988,2,2,34323,,,,,,1,1,6.987706795,17811,8106,7806,300,6,294
17669,10203,11471,2,4,34946,,,,,,1,1,7.21592089,17938,8337,8003,334,5,329
17669,10733,10585,0,2,36458,,,,,,1,1,7.574720499,18661,8726,8381,345,8,337
17669,8555,10889,0,0,37419,,,,,,1,1,7.679837996,19068,9010,8679,331,10,321
17669,9920,11774,2,0,34825,,,,,,1,1,7.123078938,18246,8117,7772,345,1,344
17669,9748,9048,0,4,35735,,,,,,1,1,7.333779658,18900,8279,8002,277,5,272
17669,12096,10864,2,0,33741,,,,,,1,1,6.91330705,18039,7684,7350,334,1,333
17669,10715,9479,0,2,36660,,,,,,1,1,7.533619267,19092,8620,8292,328,6,322
17669,11297,10610,0,0,36190,,,,,,1,1,7.444510392,18500,8671,8323,348,3,345
17669,10708,9802,3,2,36657,,,,,,1,1,7.668714539,18487,8921,8593,328,3,325
17669,10290,8099,0,0,36582,,,,,,1,1,7.686789079,18740,8794,8540,254,0,254
17669,9969,10162,4,5,37696,,,,,,1,1,7.749550789,19348,9018,8706,312,12,300
17669,10680,10195,0,0,35190,,,,,,1,1,7.257988875,18438,8215,7893,322,0,322
17669,9869,10891,0,0,35473,,,,,,1,1,7.242152336,18299,8437,8137,300,5,295
17669,9913,11662,0,1,37723,,,,,,1,1,7.617545039,18924,9237,8912,325,2,323
17669,11051,10122,0,0,36237,,,,,,1,1,7.346682734,18397,8744,8392,352,5,347
17669,10878,10426,2,2,34213,,,,,,1,1,7.261396031,17738,8089,7792,297,8,289
17669,11046,11070,0,1,35333,,,,,,1,1,7.201673934,18179,8412,8082,330,1,329
17669,10126,12825,0,2,32219,,,,,,1,1,6.581112504,17533,7190,6884,306,1,305
17669,10970,10100,4,2,36496,,,,,,1,1,7.420141082,18479,8855,8548,307,3,304
17669,9259,10218,0,0,37604,,,,,,1,1,7.602114084,19441,8942,8663,279,3,276
17669,9344,8593,0,0,36998,,,,,,1,1,7.535627822,19219,8763,8510,253,3,250
17669,10836,11176,4,4,33485,,,,,,1,1,6.8722895170000005,17577,7804,7504,300,4,296
17669,8287,11605,0,2,36707,,,,,,1,1,7.441269453,18770,8827,8544,283,6,277
17669,10141,9952,3,0,36061,,,,,,1,1,7.450786333,18509,8621,8311,310,2,308
17669,11551,12118,0,0,16419,,,,,,1,1,3.426925485,8333,3880,3554,326,2,324
17669,10223,8637,0,0,38108,,,,,,1,1,7.614800756,19448,9184,8892,292,1,291
17669,10539,11483,0,0,34760,,,,,,1,1,7.237846429,18122,8155,7827,328,1,327
17669,10169,10384,0,1,36306,,,,,,1,1,7.6774084479999996,18746,8615,8285,330,0,330
17669,10534,9451,6,0,36231,,,,,,1,1,7.393449862,18812,8560,8261,299,1,298
17669,10987,12546,0,0,33741,,,,,,1,1,6.933310756,17644,7885,7558,327,3,324
17669,10297,10871,0,3,35397,,,,,,1,1,7.205445848,18429,8326,8010,316,10,306
17669,10852,9485,4,0,36162,,,,,,1,1,7.666135651,18687,8592,8301,291,3,288
17669,9668,10712,4,0,38662,,,,,,1,1,7.837648757,19152,9579,9227,352,14,338
17669,11476,9800,0,4,37621,,,,,,1,1,7.68564833,19132,9075,8736,339,9,330
17669,9280,10307,0,4,38390,,,,,,1,1,8.062884987,19244,9428,9138,290,3,287
17669,10672,11191,0,6,34609,,,,,,1,1,7.035958547,18054,8128,7829,299,3,296
17669,11088,10901,1,3,36219,,,,,,1,1,7.464003867,18357,8761,8421,340,0,340
17669,9968,8507,2,0,35589,,,,,,1,1,7.213611218,18321,8502,8238,264,4,260
17669,10680,9779,2,0,36409,,,,,,1,1,7.760609289,18531,8789,8489,300,2,298
17669,11003,8909,2,0,37178,,,,,,1,1,7.804510136,18990,8956,8680,276,2,274
17669,11529,11652,2,2,35427,,,,,,1,1,7.20869001,18328,8364,7993,371,4,367
17669,10812,12330,0,4,36671,,,,,,1,1,7.430040657,18718,8790,8417,373,7,366
17669,9510,11635,0,2,36538,,,,,,1,1,7.493882732,18889,8654,8313,341,3,338
17669,10796,10889,0,0,37496,,,,,,1,1,7.587812872,19175,8986,8637,349,2,347
17669,11147,11267,0,0,37259,,,,,,1,1,7.749564263,18731,9088,8736,352,1,351
17669,9916,10729,0,2,35877,,,,,,1,1,7.537521274,18650,8464,8165,299,3,296
17669,9838,9070,2,2,35681,,,,,,1,1,7.445474648,18677,8370,8106,264,13,251
17669,9177,10075,2,0,35414,,,,,,1,1,7.293869537,18373,8377,8090,287,6,281
17669,9544,11344,2,2,36266,,,,,,1,1,7.379068682,18939,8526,8251,275,1,274
17669,8604,10786,0,0,35074,,,,,,1,1,7.135797728,18299,8251,7978,273,2,271
17669,11958,11775,0,2,35430,,,,,,1,1,7.201365331,18201,8435,8076,359,1,358
17669,9393,7828,0,0,38346,,,,,,1,1,7.896490981,19363,9355,9082,273,3,270
17669,10999,9651,4,0,35849,,,,,,1,1,7.480180113,18179,8692,8406,286,14,272
17669,12108,11185,5,0,36314,,,,,,1,1,7.4268059730000004,18250,8864,8528,336,2,334
17669,11027,11095,0,0,32563,,,,,,1,1,6.74664523,17032,7607,7290,317,1,316
17669,11022,9888,0,0,33254,,,,,,1,1,6.974312264,17897,7535,7248,287,2,285
17669,12198,11023,4,2,36168,,,,,,1,1,7.322927523,18247,8783,8428,355,10,345
17669,10542,10384,0,0,35734,,,,,,1,1,7.503762709,18486,8473,8171,302,1,301
17669,9040,11463,0,0,34992,,,,,,1,1,7.298105918,18480,8113,7827,286,8,278
17669,8567,10821,2,0,38906,,,,,,1,1,7.86774363,19234,9675,9353,322,8,314
17669,9943,11656,0,1,36084,,,,,,1,1,7.440169187,18395,8691,8384,307,1,306
17669,11809,11276,0,2,34288,,,,,,1,1,7.240018213,17989,7986,7659,327,0,327
17669,11035,9978,0,0,34636,,,,,,1,1,7.224484908,17916,8203,7889,314,0,314
17669,10549,9811,0,2,35306,,,,,,1,1,7.243874477,18490,8260,7964,296,4,292
17669,9587,8730,0,0,37313,,,,,,1,1,7.635156488,19015,9005,8717,288,3,285
17669,9989,10379,0,0,36051,,,,,,1,1,7.487977618,18647,8531,8189,342,2,340
17669,10372,12261,0,2,36400,,,,,,1,1,7.653878556,18434,8803,8443,360,5,355
17669,10137,9631,0,0,35143,,,,,,1,1,7.192429482,18262,8301,8022,279,0,279
17669,10554,9409,2,2,38409,,,,,,1,1,7.807814448,19351,9365,9037,328,17,311
17669,10446,9804,2,0,37288,,,,,,1,1,7.6282410590000005,19090,8943,8631,312,5,307
17669,11250,10590,2,0,36149,,,,,,1,1,7.397473892,18593,8607,8265,342,3,339
17669,10845,8230,2,0,39052,,,,,,1,1,7.838299167,19694,9530,9232,298,13,285
17669,10285,10316,4,0,35576,,,,,,1,1,7.305458282,18619,8349,8090,259,5,254
17669,11167,10821,0,3,34123,,,,,,1,1,6.931110402,18132,7826,7487,339,0,339
17669,11924,11777,0,0,24838,,,,,,1,1,5.302384018,12901,5800,5463,337,1,336
17669,10488,10576,4,0,36313,,,,,,1,1,7.335034682,18519,8735,8411,324,14,310
17669,10785,11515,2,2,34720,,,,,,1,1,7.306450346,17679,8350,8009,341,0,341
17669,11065,10968,1,2,35165,,,,,,1,1,7.280463677,18171,8325,7981,344,4,340
17669,9120,9852,0,2,35528,,,,,,1,1,7.326551053,18653,8312,8061,251,1,250
17669,9888,11664,0,4,36038,,,,,,1,1,7.362289238,18539,8590,8271,319,19,300
17669,11314,10644,0,0,33720,,,,,,1,1,6.878011451,17712,7846,7530,316,1,315
17669,11460,12087,4,0,35302,,,,,,1,1,7.336194757,18246,8344,7976,368,1,367
17669,9429,9791,5,0,35213,,,,,,1,1,7.242038782,18194,8389,8148,241,2,239
17669,9946,9676,2,2,37627,,,,,,1,1,7.532337873,19253,9034,8728,306,9,297
17669,10703,12198,2,0,35984,,,,,,1,1,7.333824653,18363,8620,8239,381,6,375
17669,11405,11801,4,0,34707,,,,,,1,1,7.309521416,17868,8241,7884,357,4,353
17669,11002,10369,2,0,34607,,,,,,1,1,7.092980266,18041,8126,7812,314,7,307
17669,10613,10037,0,0,35542,,,,,,1,1,7.388290536,18417,8421,8138,283,1,282
17669,9070,9613,1,0,36593,,,,,,1,1,7.586959579,19149,8571,8269,302,4,298
17669,10349,11609,2,0,37047,,,,,,1,1,7.674955657,18660,9015,8658,357,0,357
17669,9380,9052,0,0,38801,,,,,,1,1,7.980731553,19572,9475,9196,279,1,278
17669,11393,10831,2,0,33416,,,,,,1,1,6.793912144,17427,7848,7555,293,0,293
17669,10751,10728,4,0,35751,,,,,,1,1,7.32364601,18229,8604,8290,314,10,304
17669,11837,11020,0,2,34746,,,,,,1,1,7.143792768,17963,8232,7913,319,5,314
17669,10394,10337,0,0,37795,,,,,,1,1,7.70999857,19184,9144,8821,323,2,321
17669,9158,10676,0,0,36568,,,,,,1,1,7.422051629,19037,8620,8329,291,1,290
17669,9991,11099,2,0,36937,,,,,,1,1,7.632082625,18629,8979,8629,350,2,348
17669,12590,9412,3,0,35276,,,,,,1,1,7.303207467,18099,8418,8077,341,1,340
17669,9667,9498,0,4,36446,,,,,,1,1,7.456611776,18974,8596,8316,280,0,280
17669,10570,9536,2,2,37881,,,,,,1,1,7.737515044,19114,9223,8902,321,2,319
17669,10951,10414,0,1,35709,,,,,,1,1,7.547720407,18528,8426,8097,329,2,327
17669,10334,11309,0,2,35298,,,,,,1,1,7.724634996,18306,8342,8034,308,7,301
17669,10493,10426,0,0,33970,,,,,,1,1,7.013561058,17925,7880,7595,285,1,284
17669,12439,10177,2,4,36031,,,,,,1,1,7.364060192,18797,8458,8140,318,2,316
17669,10792,9939,0,2,35651,,,,,,1,1,7.333757042,18907,8230,7946,284,0,284
17669,10932,10968,4,2,34818,,,,,,1,1,7.290746476,18257,8102,7745,357,7,350
17669,10464,11275,6,0,36774,,,,,,1,1,7.630481051,18818,8817,8495,322,6,316
17669,9785,11138,0,2,36555,,,,,,1,1,7.421347974,18824,8712,8405,307,2,305
17669,10085,11023,2,2,34921,,,,,,1,1,7.097927295,18294,8144,7805,339,4,335
17669,11457,11187,0,2,33558,,,,,,1,1,7.264670773,17254,7997,7687,310,7,303
17669,10463,10971,0,2,36252,,,,,,1,1,7.504685998,18545,8694,8375,319,7,312
17669,10249,10018,0,4,36662,,,,,,1,1,7.543430403,18635,8862,8559,303,2,301
17669,10361,8125,0,0,37651,,,,,,1,1,7.575792932,19179,9080,8768,312,2,310
17669,10923,9583,0,0,36944,,,,,,1,1,7.917090879,18890,8875,8571,304,0,304
17669,10127,10818,0,4,36508,,,,,,1,1,7.562624799,19068,8561,8243,318,2,316
17669,9081,9745,0,2,36062,,,,,,1,1,7.470602045,18438,8680,8416,264,3,261
17669,10708,9109,6,4,35360,,,,,,1,1,7.4750858860000005,18162,8472,8218,254,9,245
17669,8873,9408,1,2,37358,,,,,,1,1,8.046395056,19237,8927,8660,267,1,266
17669,11452,10623,2,2,34269,,,,,,1,1,7.358845645,17748,8102,7785,317,9,308
17669,8807,10122,0,2,35181,,,,,,1,1,7.239291069,18386,8261,7988,273,7,266
17669,10293,9605,0,2,37720,,,,,,1,1,7.725640737,19309,9056,8757,299,12,287
17669,10828,10044,2,0,36514,,,,,,1,1,7.5333836640000005,18655,8767,8442,325,3,322
17669,11808,11356,4,0,34978,,,,,,1,1,7.206281039,18011,8323,8002,321,3,318
17669,8175,11577,2,5,36548,,,,,,1,1,7.367388419,18825,8721,8440,281,3,278
17669,10204,10221,0,0,35385,,,,,,1,1,7.26488453,18365,8348,8024,324,4,320
17669,10556,10273,2,0,36532,,,,,,1,1,7.39858218,18642,8795,8495,300,1,299
17669,10544,8425,0,0,35880,,,,,,1,1,7.76342522,18326,8640,8366,274,8,266
17669,10970,10154,2,2,35734,,,,,,1,1,7.453413359,18275,8571,8254,317,9,308
17669,10952,10749,0,0,35307,,,,,,1,1,7.427178056,18123,8441,8139,302,4,298
17669,9379,9695,2,2,36832,,,,,,1,1,7.440622341,19017,8762,8471,291,10,281
17669,10791,10197,0,0,37484,,,,,,1,1,7.701613405,18961,9102,8783,319,1,318
17669,10306,10725,4,0,35600,,,,,,1,1,7.352551271,18493,8395,8078,317,3,314
17669,9218,10993,2,4,34434,,,,,,1,1,7.267196629,18248,7948,7658,290,5,285
17669,10892,12425,6,2,36057,,,,,,1,1,7.667139826,18140,8783,8432,351,6,345
17669,11588,10262,0,0,36119,,,,,,1,1,7.408407343,18629,8583,8259,324,0,324
17669,10796,9748,0,2,37291,,,,,,1,1,7.57575974,18788,9085,8752,333,2,331
17669,9334,9937,2,2,37017,,,,,,1,1,7.625326916,18945,8894,8610,284,1,283
17669,10560,11315,2,2,33211,,,,,,1,1,6.937844568,17574,7670,7373,297,21,276
17669,10422,10467,3,0,37074,,,,,,1,1,7.615397959,18810,8973,8655,318,1,317
17669,12246,9655,4,0,37471,,,,,,1,1,7.541950751,18894,9121,8786,335,4,331
17669,9421,10205,2,0,36937,,,,,,1,1,7.649145855,19099,8775,8487,288,3,285
17669,10280,9746,0,2,36634,,,,,,1,1,7.39311602,18713,8803,8488,315,2,313
17669,10341,10864,4,0,38541,,,,,,1,1,7.747450472,19554,9319,8970,349,2,347
17669,9136,9123,2,1,38795,,,,,,1,1,8.329013205,19769,9359,9051,308,5,303
17669,7951,9949,0,0,38856,,,,,,1,1,7.904186167,19806,9387,9111,276,1,275
17669,9774,11116,0,3,36463,,,,,,1,1,7.543820596,18640,8752,8433,319,5,314
17669,10196,10619,0,2,34216,,,,,,1,1,7.061628317,17988,7954,7634,320,3,317
17669,9853,11481,0,0,35184,,,,,,1,1,7.153404067,18346,8248,7906,342,3,339
17669,8963,10282,0,2,34615,,,,,,1,1,7.123997419,18569,7901,7657,244,1,243
17669,11103,11620,0,2,35726,,,,,,1,1,7.315598371,18141,8613,8254,359,1,358
17669,10450,12551,0,2,37070,,,,,,1,1,7.535780758,18726,8977,8587,390,0,390
17669,10496,9551,2,0,35810,,,,,,1,1,7.529969407,18628,8446,8156,290,8,282
17669,11202,10653,2,2,35206,,,,,,1,1,7.214692303,18030,8423,8093,330,8,322
17669,10024,8202,2,0,37936,,,,,,1,1,7.898437268,19356,9150,8870,280,6,274
17669,11716,9612,0,2,37163,,,,,,1,1,7.640105142,18316,9247,8894,353,3,350
17669,11742,10467,0,2,35245,,,,,,1,1,7.157007533,18009,8460,8144,316,4,312
17669,11407,12042,2,1,36384,,,,,,1,1,7.653601078,18429,8787,8406,381,14,367
17669,11486,9853,0,0,34681,,,,,,1,1,7.385533367,18013,8172,7848,324,1,323
17669,11128,9233,1,0,35495,,,,,,1,1,7.292968145,18528,8338,8047,291,6,285
17669,9877,10511,0,0,36371,,,,,,1,1,7.501842236,18866,8613,8334,279,1,278
17669,10359,11804,1,0,33363,,,,,,1,1,6.816316007,17631,7717,7419,298,1,297
17669,10008,10918,0,2,35555,,,,,,1,1,7.35261036,18634,8315,8024,291,1,290
17669,11580,9778,0,2,36647,,,,,,1,1,7.446638402,18354,8978,8641,337,15,322
17669,10090,10447,0,0,37597,,,,,,1,1,7.716219662,18918,9190,8891,299,4,295
17669,11361,11755,2,0,37095,,,,,,1,1,7.638247713,18629,9026,8612,414,2,412
17669,10173,9825,1,0,36835,,,,,,1,1,7.481321161,18722,8910,8617,293,4,289
17669,8891,12273,0,0,36187,,,,,,1,1,7.519528757,18447,8698,8354,344,2,342
17669,10017,10096,0,4,38457,,,,,,1,1,7.95910995,19690,9234,8935,299,0,299
17669,12444,11225,2,0,18848,,,,,,1,1,3.935901392,9352,4593,4283,310,2,308
17669,10607,11968,0,4,33702,,,,,,1,1,7.049482265,17466,7961,7647,314,6,308
17669,11324,9101,3,0,36945,,,,,,1,1,7.574597073,18994,8833,8548,285,0,285
17669,9743,11494,2,0,35978,,,,,,1,1,7.330679412,18495,8576,8245,331,4,327
17669,10516,10759,2,0,35867,,,,,,1,1,7.238391636,18470,8544,8235,309,1,308
17669,11379,11149,2,0,33910,,,,,,1,1,6.88624868,17610,7998,7694,304,1,303
17669,10598,9623,0,0,34847,,,,,,1,1,7.24765484,18411,8079,7801,278,2,276
17669,11707,11202,0,0,33944,,,,,,1,1,7.026259166,17890,7869,7553,316,3,313
17669,10611,9278,2,0,35363,,,,,,1,1,7.238220368,18625,8220,7922,298,4,294
17669,11049,10704,0,1,35741,,,,,,1,1,7.256737015,18479,8463,8127,336,5,331
17669,8962,10956,0,0,38104,,,,,,1,1,7.79751009,18913,9442,9135,307,1,306
17669,10800,10463,0,0,37642,,,,,,1,1,7.871704287,19103,9096,8749,347,1,346
17669,10617,10554,2,0,34731,,,,,,1,1,7.192881461,18207,8118,7830,288,4,284
17669,9998,9898,0,0,36054,,,,,,1,1,7.29835003,18724,8508,8194,314,4,310
17669,10476,10432,0,0,37561,,,,,,1,1,7.781107092,19051,9095,8775,320,4,316
17669,10567,9137,5,0,37641,,,,,,1,1,7.75648214,19152,9083,8760,323,14,309
17669,9829,10805,0,0,34327,,,,,,1,1,7.139696584,18118,7964,7683,281,0,281
17669,10338,11480,2,0,35212,,,,,,1,1,7.3340482940000005,18183,8342,7997,345,0,345
17669,11933,11525,2,1,36179,,,,,,1,1,7.437848649,18574,8614,8237,377,1,376
17669,12037,10502,2,4,37312,,,,,,1,1,7.684736917,18659,9158,8821,337,1,336
17669,11429,8548,3,0,36754,,,,,,1,1,7.536132128,18812,8818,8512,306,2,304
17669,10166,10800,0,4,37480,,,,,,1,1,8.006669241,18982,9096,8790,306,8,298
17669,12078,10376,0,2,35514,,,,,,1,1,7.324106053,18130,8535,8221,314,4,310
17669,10777,9572,0,0,35376,,,,,,1,1,7.172743235,18427,8329,8038,291,4,287
17669,8881,10197,0,0,39514,,,,,,1,1,8.277074627,19972,9614,9300,314,0,314
17669,11683,10765,2,0,34825,,,,,,1,1,7.148901752,17995,8259,7947,312,1,311
17669,9501,11105,1,2,38506,,,,,,1,1,8.187154318,19499,9339,9010,329,1,328
17669,10899,11023,2,2,34242,,,,,,1,1,6.970338557,18042,7947,7641,306,1,305
17669,10338,10408,1,1,36332,,,,,,1,1,7.617776495,18515,8741,8406,335,3,332
17669,11388,10192,0,0,37864,,,,,,1,1,7.650514127,18971,9280,8947,333,1,332
17669,9415,11981,0,6,34033,,,,,,1,1,6.955455378,17852,7947,7660,287,3,284
17669,11212,10479,2,2,33265,,,,,,1,1,6.788064921,17620,7675,7380,295,4,291
17669,9961,11595,3,2,35593,,,,,,1,1,7.266862736,18329,8488,8200,288,1,287
17669,10942,12410,0,3,34152,,,,,,1,1,6.954014267,17601,8113,7788,325,7,318
17669,9276,11403,0,0,37399,,,,,,1,1,7.83384618,18990,9031,8684,347,2,345
17669,11614,11069,4,0,35575,,,,,,1,1,7.326326678,18468,8390,8063,327,2,325
17669,11241,11245,0,2,35413,,,,,,1,1,7.227286178,18301,8372,8004,368,6,362
17669,10462,10129,4,2,37274,,,,,,1,1,7.509745406,18849,9057,8746,311,4,307
17669,10214,9978,0,0,37320,,,,,,1,1,7.593675217,19245,8871,8538,333,2,331
17669,9543,9257,0,0,36587,,,,,,1,1,7.4544615610000005,18765,8769,8485,284,2,282
17669,9510,10899,0,0,37192,,,,,,1,1,7.514615582,18874,9000,8682,318,2,316
17669,10726,10778,0,2,34963,,,,,,1,1,7.13433632,18172,8232,7905,327,3,324
17669,10448,9439,0,0,35511,,,,,,1,1,7.356093258,18427,8405,8131,274,0,274
17669,10298,9615,2,0,35608,,,,,,1,1,7.321938236,18351,8477,8174,303,2,301
17669,10628,10177,0,0,34776,,,,,,1,1,7.143815271,18196,8134,7822,312,0,312
17669,9622,11246,2,3,34788,,,,,,1,1,7.509674492,18123,8172,7851,321,2,319
17669,10609,10691,1,4,35908,,,,,,1,1,7.686021749,18564,8525,8231,294,2,292
17669,10463,9184,0,2,37151,,,,,,1,1,7.490795816,18887,8977,8667,310,0,310
17669,11075,9741,0,2,34711,,,,,,1,1,7.42242424,18249,8085,7793,292,4,288
17669,10358,10907,0,3,34593,,,,,,1,1,7.175196477,18190,8051,7750,301,1,300
17669,8085,10256,0,0,36686,,,,,,1,1,7.664301682,18876,8754,8452,302,0,302
17669,9068,10875,0,3,35379,,,,,,1,1,7.186760684,18635,8229,7943,286,3,283
17669,12029,9965,0,0,35412,,,,,,1,1,7.367574884,18328,8370,8026,344,2,342
17669,10485,10214,1,2,37993,,,,,,1,1,7.667303029,19198,9239,8922,317,0,317
17669,10592,9509,2,0,36479,,,,,,1,1,7.446902478,18731,8711,8385,326,5,321
17669,11095,10449,4,0,37100,,,,,,1,1,7.517647777,19061,8849,8508,341,3,338
17669,9667,11666,2,3,35145,,,,,,1,1,7.272928601,18457,8179,7849,330,9,321
17669,11071,8738,0,0,36966,,,,,,1,1,7.673954169,18760,8945,8629,316,3,313
17669,10182,9946,2,2,35777,,,,,,1,1,7.391806395,18415,8546,8276,270,7,263
17669,10803,9932,0,4,35776,,,,,,1,1,7.252999585,18769,8365,8088,277,2,275
17669,11312,11156,2,2,34448,,,,,,1,1,7.02204428,17831,8135,7788,347,2,345
17669,10234,10314,0,0,35699,,,,,,1,1,7.521816483,18505,8445,8141,304,7,297
17669,11785,11048,6,0,35895,,,,,,1,1,7.377821451,18192,8680,8337,343,2,341
17669,9541,11380,0,2,36848,,,,,,1,1,7.658436654,18869,8846,8559,287,1,286
17669,10382,9607,2,0,35741,,,,,,1,1,7.293209021,18633,8395,8077,318,2,316
17669,11433,11163,2,2,36838,,,,,,1,1,7.734472145,18796,8849,8505,344,5,339
17669,10736,11165,0,0,33831,,,,,,1,1,7.072642068,17779,7859,7525,334,1,333
17669,10786,10599,0,2,35713,,,,,,1,1,7.225832707,18547,8405,8049,356,2,354
17669,10629,10716,7,0,35960,,,,,,1,1,7.544241932,18489,8571,8242,329,6,323
17669,11604,8925,3,0,36342,,,,,,1,1,7.321764863,18343,8862,8587,275,0,275
17669,10588,9348,4,2,38398,,,,,,1,1,8.269107174,19465,9310,8997,313,5,308
17669,9944,8774,0,0,36630,,,,,,1,1,7.518790953,18875,8738,8459,279,5,274
17669,9845,11129,0,2,35899,,,,,,1,1,7.267161102,18474,8550,8225,325,4,321
17669,10848,10514,0,0,36644,,,,,,1,1,7.622508247,19000,8671,8369,302,2,300
17669,9734,10847,2,2,36612,,,,,,1,1,7.550587939,18780,8758,8442,316,4,312
17669,9251,8511,3,0,38549,,,,,,1,1,7.859003573,19662,9299,9010,289,1,288
17669,10154,10162,0,0,35022,,,,,,1,1,7.3578041800000005,18075,8330,8043,287,1,286
17669,10608,12107,2,2,33342,,,,,,1,1,6.850213897,17428,7789,7453,336,11,325
17669,9183,11118,2,0,36649,,,,,,1,1,7.417664006,18891,8732,8438,294,4,290
17669,10772,10447,0,0,34292,,,,,,1,1,7.054631323,17838,8072,7762,310,4,306
17669,10701,10785,0,2,34883,,,,,,1,1,7.309978665,18365,8103,7791,312,1,311
17669,11025,10810,2,0,34510,,,,,,1,1,7.211597134,17968,8121,7821,300,5,295
17669,11215,8866,2,0,36514,,,,,,1,1,7.521230515,18610,8810,8526,284,3,281
17669,10152,10133,0,2,36113,,,,,,1,1,7.399864277,18691,8561,8261,300,3,297
17669,10294,11128,0,2,33987,,,,,,1,1,7.267946572,17767,7950,7630,320,7,313
17669,10927,9017,1,0,36212,,,,,,1,1,7.427790394,18501,8700,8389,311,2,309
17669,9712,7907,0,0,38671,,,,,,1,1,7.828235393,19756,9325,9060,265,0,265
17669,10875,10663,0,0,35366,,,,,,1,1,7.236176353,18360,8361,8077,284,2,282
17669,9812,9487,0,2,36537,,,,,,1,1,7.750484247,18665,8797,8519,278,2,276
17669,10738,12214,2,0,35723,,,,,,1,1,7.339493852,18397,8496,8162,334,3,331
17669,9697,11280,2,2,35354,,,,,,1,1,7.399109057,18444,8294,7972,322,4,318
17669,8118,11337,0,3,38743,,,,,,1,1,7.947713544,19303,9570,9270,300,7,293
17669,10475,11145,0,2,35856,,,,,,1,1,7.386690254,18593,8470,8147,323,3,320
17669,9887,10698,0,0,36375,,,,,,1,1,7.360715534,18519,8777,8475,302,5,297
17669,10812,9583,2,0,36697,,,,,,1,1,7.392190262,18645,8870,8558,312,1,311
17669,11273,10484,0,2,34476,,,,,,1,1,7.097005111,18146,8007,7691,316,0,316
17669,9878,10271,0,0,36194,,,,,,1,1,7.808117476,18759,8577,8296,281,2,279
17669,10365,10221,0,2,36339,,,,,,1,1,7.347615746,18538,8756,8467,289,6,283
17669,12263,10516,2,2,34044,,,,,,1,1,7.007456328,17735,7973,7610,363,3,360
17669,10586,11291,0,4,36182,,,,,,1,1,7.431939246,18424,8704,8354,350,5,345
17669,9843,9819,7,0,35696,,,,,,1,1,7.387629474,18208,8608,8336,272,9,263
17669,8617,10954,0,0,36488,,,,,,1,1,7.499256996,18852,8677,8395,282,0,282
17669,11156,9635,0,2,35557,,,,,,1,1,7.291643834,18118,8578,8295,283,2,281
17669,10754,10608,4,0,33906,,,,,,1,1,6.855867816,17273,8168,7871,297,2,295
17669,10125,10902,0,5,34968,,,,,,1,1,7.274843711,18342,8160,7854,306,7,299
17669,11691,9550,0,0,34179,,,,,,1,1,7.214425775,17867,8006,7706,300,4,296
17669,10459,9714,0,0,35304,,,,,,1,1,7.409362261,18142,8427,8119,308,1,307
17669,10205,11107,2,4,35224,,,,,,1,1,7.277464956,17990,8462,8152,310,10,300
17669,10533,10043,3,2,36921,,,,,,1,1,7.448478101,18756,8930,8625,305,3,302
17669,12280,10227,2,0,34655,,,,,,1,1,7.151601865,18086,8111,7764,347,5,342
17669,11421,11684,5,0,35457,,,,,,1,1,7.420581645,18354,8382,8043,339,2,337
17669,11186,10163,0,0,37967,,,,,,1,1,7.684710407,19407,9102,8746,356,2,354
17669,10259,10149,3,2,35110,,,,,,1,1,7.28871666,18284,8272,7990,282,2,280
17669,10475,10664,0,0,36774,,,,,,1,1,7.697525984,18709,8855,8500,355,2,353
17669,11195,11020,0,4,36717,,,,,,1,1,7.589080144,19006,8675,8314,361,1,360
17669,11397,9582,0,2,37495,,,,,,1,1,7.805422705,18927,9131,8825,306,2,304
17669,10926,11310,0,4,37568,,,,,,1,1,7.630334114,19018,9090,8720,370,6,364
17669,11197,10184,0,6,35145,,,,,,1,1,7.407262969,17986,8427,8122,305,5,300
17669,11787,12096,0,0,4522,,,,,,1,1,0.925599868,2092,1108,894,214,0,214
17669,10053,11440,2,0,33551,,,,,,1,1,6.877180404,17208,8027,7738,289,1,288
17669,10219,9006,2,0,34690,,,,,,1,1,7.161199301,18271,8073,7800,273,5,268
17669,11043,11375,0,0,34787,,,,,,1,1,7.689654697,18175,8124,7760,364,2,362
17669,11025,11342,2,4,36007,,,,,,1,1,7.640630218,18479,8584,8224,360,0,360
17669,11629,9182,2,0,35952,,,,,,1,1,7.706287163,18572,8531,8213,318,6,312
17669,10013,10124,0,2,36483,,,,,,1,1,7.696765328,18675,8743,8421,322,2,320
17669,10001,10400,2,0,37369,,,,,,1,1,7.966593218,18917,9077,8779,298,0,298
17669,11083,9956,0,2,35567,,,,,,1,1,7.9495529529999995,18551,8351,8037,314,0,314
17669,11631,10702,0,3,35424,,,,,,1,1,7.477572856,18391,8346,8005,341,4,337
17669,8651,9773,0,0,37483,,,,,,1,1,8.045577649,19368,8921,8648,273,0,273
17669,11410,11224,2,2,35098,,,,,,1,1,7.605523615,18166,8289,7935,354,10,344
17669,10737,10401,0,0,37415,,,,,,1,1,7.644888088,18723,9188,8872,316,0,316
17669,10940,12190,0,0,33347,,,,,,1,1,7.357064519,17398,7799,7448,351,1,350
17669,10636,10744,1,4,37090,,,,,,1,1,7.706085894,18627,9063,8726,337,17,320
17669,10869,9971,0,0,31977,,,,,,1,1,6.735393812,16998,7351,7074,277,1,276
17669,10358,8884,0,2,37128,,,,,,1,1,7.940594227,18908,8962,8666,296,2,294
17669,10061,10387,0,3,37977,,,,,,1,1,7.929619034,19305,9175,8853,322,3,319
17669,8810,10726,0,3,37368,,,,,,1,1,8.193726086,19063,8992,8671,321,4,317
17669,11337,8526,2,1,37420,,,,,,1,1,7.790126095,18924,9101,8807,294,2,292
17669,10713,9239,0,0,35890,,,,,,1,1,7.592199268,18710,8444,8152,292,4,288
17669,10332,10332,4,4,37264,,,,,,1,1,7.770001556,19149,8919,8642,277,1,276
17669,10575,9688,0,0,35513,,,,,,1,1,7.715039956,18440,8397,8118,279,2,277
17669,9148,11160,0,0,36011,,,,,,1,1,7.922425881,18683,8514,8214,300,1,299
17669,11986,11687,2,0,4716,,,,,,1,1,1.053403483,2273,1118,911,207,5,202
17669,9485,9459,2,0,37194,,,,,,1,1,8.016413959,18849,9033,8754,279,2,277
17669,10949,11525,2,3,34773,,,,,,1,1,7.256307579,18113,8161,7823,338,2,336
17669,10798,10644,2,0,36077,,,,,,1,1,7.757122642,18511,8615,8279,336,5,331
17669,11099,8953,2,0,36350,,,,,,1,1,7.628495922,18864,8590,8284,306,1,305
17669,10566,9857,2,0,35411,,,,,,1,1,7.61968945,18330,8396,8107,289,2,287
17669,10816,11752,0,2,34399,,,,,,1,1,7.253484884,17915,8091,7789,302,0,302
17669,10134,10446,0,0,36220,,,,,,1,1,7.464174914,18693,8616,8321,295,0,295
17669,9258,11466,0,2,36238,,,,,,1,1,7.551996077,18449,8744,8443,301,7,294
17669,11986,11379,0,0,35098,,,,,,1,1,7.199906009,18330,8191,7805,386,4,382
17669,10236,10833,0,2,35987,,,,,,1,1,7.282202857,18718,8485,8186,299,7,292
17669,9929,11881,2,2,36249,,,,,,1,1,7.589724446,18234,8856,8553,303,0,303
17669,9995,10545,2,2,36352,,,,,,1,1,7.384995726,18755,8630,8293,337,6,331
17669,9329,10272,2,0,36858,,,,,,1,1,7.465886715,19177,8706,8437,269,4,265
17669,9706,10698,2,0,36686,,,,,,1,1,7.397001812,18697,8824,8483,341,9,332
17669,10418,10233,2,2,36362,,,,,,1,1,7.456935809,18459,8810,8527,283,1,282
17669,9106,11016,0,0,36837,,,,,,1,1,7.686716486,18977,8783,8489,294,1,293
17669,10826,10280,0,3,36117,,,,,,1,1,7.298015042,18545,8632,8324,308,2,306
17669,8779,9262,0,3,39030,,,,,,1,1,7.884815554,19634,9564,9296,268,1,267
17669,9898,9902,2,0,37970,,,,,,1,1,7.724413327,19128,9273,8977,296,2,294
17669,10918,11856,5,2,36802,,,,,,1,1,7.461704814,18324,9048,8666,382,8,374
17669,10084,10381,4,2,35939,,,,,,1,1,7.673663445,18518,8562,8265,297,4,293
17669,11275,10503,2,0,38144,,,,,,1,1,7.754636003,19232,9285,8943,342,0,342
17669,9557,10624,3,1,36626,,,,,,1,1,7.578747231,18728,8790,8472,318,13,305
17669,9738,11032,1,4,34888,,,,,,1,1,7.267793482,18370,8110,7812,298,2,296
17669,10738,9025,4,0,34766,,,,,,1,1,7.265362067,18433,8026,7745,281,6,275
17669,10639,9940,0,2,36786,,,,,,1,1,7.613771861,19034,8716,8396,320,3,317
17669,11172,8575,3,0,36791,,,,,,1,1,7.560554575,19019,8748,8472,276,4,272
17669,11049,11201,2,0,33800,,,,,,1,1,7.144968649,17822,7830,7512,318,2,316
17669,10703,9337,0,2,37171,,,,,,1,1,7.679981594,18915,8967,8645,322,9,313
17669,8738,10186,0,1,38010,,,,,,1,1,8.264428459,19390,9168,8884,284,3,281
17669,9694,10179,0,0,37788,,,,,,1,1,7.917285008,19294,9099,8803,296,2,294
17669,8957,10269,0,0,36429,,,,,,1,1,7.63824685,18870,8632,8337,295,2,293
17669,10378,9698,0,0,36871,,,,,,1,1,7.614173828,19079,8742,8434,308,0,308
17669,10759,11815,0,2,36171,,,,,,1,1,7.506954494,18131,8824,8432,392,2,390
17669,9489,11382,0,0,34109,,,,,,1,1,7.214748376,17940,7932,7627,305,2,303
17669,10374,10100,0,1,37034,,,,,,1,1,7.640712054,19014,8857,8551,306,2,304
17669,9549,11648,2,0,35416,,,,,,1,1,7.364335273,18355,8368,8043,325,8,317
17669,11571,10816,6,3,31855,,,,,,1,1,6.626442923,17282,7141,6850,291,1,290
17669,10689,8501,2,0,35912,,,,,,1,1,7.354619968,18753,8434,8143,291,2,289
17669,10899,8981,0,2,36895,,,,,,1,1,7.622164555,18669,8978,8708,270,0,270
17669,10530,9592,0,6,34551,,,,,,1,1,7.28251511,18346,7966,7693,273,3,270
17669,10010,10326,0,0,37482,,,,,,1,1,7.600279603,18725,9221,8906,315,0,315
17669,11125,8668,2,2,36627,,,,,,1,1,7.526253489,19058,8644,8363,281,4,277
17669,10316,11241,2,11,34816,,,,,,1,1,7.630660471,18047,8257,8002,255,4,251
17669,11008,10070,0,2,38824,,,,,,1,1,8.102637085,19296,9590,9242,348,4,344
17669,10050,8167,2,0,36749,,,,,,1,1,7.543573386,18938,8781,8532,249,10,239
17669,10717,10114,2,0,34303,,,,,,1,1,7.089286068,18060,7976,7685,291,2,289
17669,10589,10685,0,2,36448,,,,,,1,1,7.472454083,18802,8661,8337,324,4,320
17669,10258,11395,2,0,36426,,,,,,1,1,7.339861069,18800,8637,8285,352,0,352
17669,11016,9995,1,0,34880,,,,,,1,1,7.167593977,18187,8183,7856,327,4,323
17669,10046,10958,0,0,35048,,,,,,1,1,7.082813834,18333,8194,7867,327,2,325
17669,10063,11333,1,0,36988,,,,,,1,1,7.767233152,18873,8884,8537,347,1,346
17669,10733,10136,3,0,36935,,,,,,1,1,7.570815257,19010,8802,8481,321,5,316
17669,11478,10591,0,4,36445,,,,,,1,1,7.506022346,18287,8919,8599,320,3,317
17669,10204,11516,0,0,34714,,,,,,1,1,7.175158913,17977,8206,7881,325,6,319
17669,10407,9901,0,0,36646,,,,,,1,1,7.410348392,18883,8720,8397,323,1,322
17669,10826,10937,1,0,35442,,,,,,1,1,7.17149378,18726,8195,7869,326,2,324
17669,9687,11220,0,0,38743,,,,,,1,1,7.9406914010000005,19443,9483,9149,334,0,334
17669,11354,10366,2,0,35318,,,,,,1,1,7.229972618,18136,8435,8123,312,2,310
17669,9758,10627,0,2,35324,,,,,,1,1,7.347459342,18382,8330,8048,282,3,279
17669,10746,10684,0,2,34801,,,,,,1,1,7.238683529,18055,8223,7923,300,2,298
17669,10996,10983,1,0,36013,,,,,,1,1,7.499342272,18558,8552,8201,351,3,348
17669,9918,9533,0,0,34318,,,,,,1,1,7.201828419,18172,7939,7671,268,2,266
17669,10347,8033,0,0,38122,,,,,,1,1,7.923637953,19554,9149,8879,270,5,265
17669,11334,9706,0,0,36212,,,,,,1,1,7.4921397,18640,8619,8285,334,2,332
17669,10898,10531,4,2,36060,,,,,,1,1,7.494606404,18711,8521,8214,307,2,305
17669,10948,10738,2,2,35808,,,,,,1,1,7.281937854,18231,8622,8289,333,7,326
17669,9851,10557,2,0,35330,,,,,,1,1,7.277071966,18354,8344,8056,288,0,288
17669,8825,9915,2,4,37835,,,,,,1,1,7.905546772,19247,9151,8865,286,5,281
17669,11164,10203,2,0,35876,,,,,,1,1,7.348427692,18347,8606,8289,317,3,314
17669,9908,11025,0,2,36660,,,,,,1,1,7.584794399,18535,8900,8575,325,0,325
17669,10814,10015,0,2,36014,,,,,,1,1,7.338054837,18400,8665,8381,284,2,282
17669,10034,10955,3,2,34544,,,,,,1,1,7.2768675609999995,17885,8170,7851,319,6,313
17669,10713,10568,2,2,34668,,,,,,1,1,7.01925113,18102,8137,7845,292,8,284
17669,10194,11811,0,2,34676,,,,,,1,1,7.197428721,18207,8073,7750,323,6,317
17669,11600,12250,2,0,17247,,,,,,1,1,3.5432409270000003,8509,4221,3925,296,0,296
17669,10162,8765,2,0,35284,,,,,,1,1,7.334298481,18273,8369,8096,273,1,272
17669,10586,9600,0,0,35560,,,,,,1,1,7.443544649,18694,8267,7935,332,3,329
17669,9501,10378,1,0,39709,,,,,,1,1,8.043301762,19741,9821,9495,326,1,325
17669,11305,10271,0,1,36364,,,,,,1,1,7.419640834,18901,8575,8262,313,0,313
17669,12215,10297,1,0,35993,,,,,,1,1,7.474186186,18500,8568,8211,357,2,355
17669,9953,9421,0,0,36137,,,,,,1,1,7.34494094,18809,8526,8250,276,2,274
17669,9328,10015,0,1,36254,,,,,,1,1,7.4281216,18799,8585,8300,285,3,282
17669,9780,10578,1,0,36668,,,,,,1,1,7.57584011,18885,8732,8413,319,2,317
17669,10464,9024,2,0,35368,,,,,,1,1,7.480168838,18654,8213,7925,288,0,288
17669,8487,9844,0,3,38406,,,,,,1,1,7.732878379,19447,9340,9061,279,3,276
17669,11469,12221,2,4,31181,,,,,,1,1,6.466972228,16023,7407,7063,344,5,339
17669,10123,12149,0,2,34275,,,,,,1,1,7.251449237,18158,7898,7577,321,5,316
17669,10967,8778,0,0,36870,,,,,,1,1,7.480118996,18986,8786,8474,312,1,311
17669,10618,9900,2,4,36537,,,,,,1,1,7.377451048,18618,8813,8520,293,13,280
17669,10916,11040,5,0,35191,,,,,,1,1,7.380034872,18177,8342,8012,330,0,330
17669,10522,9286,0,0,37136,,,,,,1,1,7.70196285,19186,8848,8594,254,1,253
17669,8555,9775,0,0,36615,,,,,,1,1,7.60281843,18859,8745,8479,266,1,265
17669,9894,10428,0,0,36865,,,,,,1,1,7.552954741,18496,9044,8763,281,3,278
17669,10920,8913,0,0,36719,,,,,,1,1,7.44732724,18877,8776,8486,290,5,285
17669,11037,9563,0,0,37411,,,,,,1,1,7.667823226,19085,8997,8665,332,0,332
17669,10807,9805,2,2,35207,,,,,,1,1,7.407895055,18219,8332,8008,324,5,319
17669,10393,10172,5,0,37077,,,,,,1,1,7.499883814,18834,8956,8625,331,0,331
17669,11398,11997,0,0,34638,,,,,,1,1,7.160729708,17913,8179,7812,367,1,366
17669,12786,10884,7,0,16232,,,,,,1,1,3.3007999789999998,7831,4041,3722,319,5,314
17669,11192,9441,0,2,35781,,,,,,1,1,7.324487309,18438,8510,8187,323,2,321
17669,9961,11494,2,0,33615,,,,,,1,1,6.991689551,17321,7998,7700,298,1,297
17669,10808,9864,0,3,37046,,,,,,1,1,7.480440462,19338,8682,8338,344,2,342
17669,11405,12538,2,2,20408,,,,,,1,1,4.244740557,10254,4935,4651,284,6,278
17669,10406,10687,2,3,35870,,,,,,1,1,7.387450982,18291,8638,8335,303,8,295
17669,10210,9359,3,2,37368,,,,,,1,1,7.609000032,19005,9031,8730,301,5,296
17669,10937,9791,0,0,35407,,,,,,1,1,7.345744925,18463,8318,8010,308,0,308
17669,10932,10701,3,2,33882,,,,,,1,1,7.051064613,17835,7874,7575,299,4,295
17669,10744,9793,0,0,36256,,,,,,1,1,7.422113579,18706,8632,8346,286,0,286
17669,9813,9728,2,0,34189,,,,,,1,1,7.084715818,18054,7941,7688,253,3,250
17669,9109,10993,2,4,35567,,,,,,1,1,7.3049069,18376,8449,8156,293,2,291
17669,8455,9585,2,0,36549,,,,,,1,1,7.6479342280000004,18656,8827,8588,239,2,237
17669,11456,10795,0,0,35527,,,,,,1,1,7.327233046,18493,8342,7992,350,2,348
17669,8607,9613,1,2,37880,,,,,,1,1,7.8888324149999995,19515,9043,8764,279,3,276
17669,10379,10856,0,0,36072,,,,,,1,1,7.5576038180000005,18344,8707,8393,314,0,314
17669,8577,10229,2,2,37682,,,,,,1,1,7.734047635,19250,9074,8790,284,13,271
17669,7595,9782,0,1,39062,,,,,,1,1,7.944616284,19842,9478,9214,264,2,262
17669,10707,9147,0,0,35530,,,,,,1,1,7.283666492,18449,8404,8131,273,1,272
17669,12356,10849,0,0,34151,,,,,,1,1,7.241163955,17985,7904,7546,358,2,356
17669,10553,10568,0,0,37731,,,,,,1,1,7.8960335310000005,19388,8984,8609,375,3,372
17669,9572,10119,2,0,34768,,,,,,1,1,7.12654538,18258,8119,7847,272,2,270
17669,7844,10127,0,2,37741,,,,,,1,1,7.845485262,19272,9094,8813,281,1,280
17669,8734,11909,0,2,35782,,,,,,1,1,7.384858789,18495,8493,8192,301,1,300
17669,10107,10496,2,0,34628,,,,,,1,1,7.077672224,18078,8127,7831,296,9,287
17669,10085,11308,3,4,33684,,,,,,1,1,7.066710131,17500,7943,7645,298,7,291
17669,9471,10492,2,2,37021,,,,,,1,1,7.493358464,18866,8919,8602,317,1,316
17669,9717,9993,0,2,35257,,,,,,1,1,7.189396164,18335,8316,8026,290,2,288
17669,9721,9170,2,0,36865,,,,,,1,1,7.728377419,19083,8749,8465,284,10,274
17669,9823,10518,0,0,33590,,,,,,1,1,7.009334144,17883,7717,7444,273,1,272
17669,10927,10069,0,0,36203,,,,,,1,1,7.493190885,18590,8664,8379,285,2,283
17669,11304,10889,0,4,33654,,,,,,1,1,6.8842875249999995,17332,8007,7699,308,15,293
17669,9772,9768,2,0,35982,,,,,,1,1,7.275817432,18832,8423,8119,304,2,302
17669,10927,10416,0,4,36888,,,,,,1,1,7.504984036,18836,8873,8567,306,7,299
17669,9102,10464,0,2,37927,,,,,,1,1,7.785887786,19065,9271,8951,320,2,318
17669,10572,10050,0,2,35617,,,,,,1,1,7.425472798,18504,8399,8084,315,3,312
17669,11293,10990,0,0,33721,,,,,,1,1,7.10994294,17848,7777,7458,319,0,319
17669,11645,11221,2,0,34838,,,,,,1,1,7.161998968,17868,8322,7996,326,3,323
17669,10139,9310,0,0,36175,,,,,,1,1,7.617301525,18713,8577,8269,308,4,304
17669,10507,9415,2,2,35538,,,,,,1,1,7.334493458,18306,8484,8220,264,9,255
17669,8840,10701,0,0,37164,,,,,,1,1,7.657705762,19105,8871,8554,317,1,316
17669,11471,10134,5,0,36795,,,,,,1,1,7.610837734,18448,9015,8698,317,7,310
17669,9277,10223,2,2,36933,,,,,,1,1,7.522378432,18739,8947,8647,300,0,300
17669,11022,11960,0,2,33092,,,,,,1,1,6.899118123,17253,7760,7441,319,0,319
17669,10459,9882,0,3,36092,,,,,,1,1,7.384043841,18654,8571,8275,296,4,292
17669,8940,10684,2,2,37657,,,,,,1,1,7.854590921,19431,8970,8684,286,10,276
17669,11254,8956,2,3,37901,,,,,,1,1,7.650608672,19379,9093,8757,336,6,330
17669,10926,9892,0,0,34755,,,,,,1,1,7.130342616,18153,8149,7845,304,2,302
17669,11230,10017,0,0,35819,,,,,,1,1,7.238899464,18573,8463,8143,320,4,316
17669,10573,11548,0,2,38574,,,,,,1,1,8.018608973,19546,9342,8998,344,7,337
17669,10500,10598,0,2,37118,,,,,,1,1,7.62094343,18545,9113,8766,347,3,344
17669,11050,9175,1,0,34968,,,,,,1,1,7.237208658,18356,8178,7922,256,3,253
17669,11526,11197,0,0,34671,,,,,,1,1,7.282464083,17547,8401,8079,322,1,321
17669,10194,11753,0,0,36583,,,,,,1,1,7.423292124,18689,8792,8482,310,3,307
17669,10280,11542,0,4,36540,,,,,,1,1,7.415420853,18344,8930,8594,336,6,330
17669,9745,11230,2,2,36983,,,,,,1,1,7.585915078,18728,8971,8658,313,6,307
17669,10588,9139,0,2,35932,,,,,,1,1,7.303382546,18325,8667,8394,273,7,266
17669,11635,10319,0,0,33752,,,,,,1,1,7.044046175,17692,7873,7559,314,1,313
17669,9157,10237,0,0,36801,,,,,,1,1,7.499000228,18941,8780,8480,300,3,297
17669,10486,10477,0,0,37187,,,,,,1,1,7.4789085889999996,18638,9099,8748,351,1,350
17669,11913,8473,0,0,35502,,,,,,1,1,7.430026634,18234,8488,8196,292,2,290
17669,10149,10297,0,0,37556,,,,,,1,1,7.736192742,19116,9076,8788,288,5,283
17669,8646,9486,0,0,38063,,,,,,1,1,7.841348681,19463,9146,8838,308,2,306
17669,8934,9722,0,0,38470,,,,,,1,1,7.824174584,19554,9302,8990,312,1,311
17669,11190,10581,0,0,35492,,,,,,1,1,7.263228527,18581,8302,7995,307,3,304
17669,11492,11157,0,2,34590,,,,,,1,1,7.009217879,17949,8142,7785,357,8,349
17669,11319,9249,0,2,35711,,,,,,1,1,7.424685777,18509,8441,8121,320,3,317
17669,10299,11469,2,2,35261,,,,,,1,1,7.418251607,18258,8338,8011,327,5,322
17669,9658,10186,2,3,37569,,,,,,1,1,7.55100999,19034,9131,8858,273,1,272
17669,10548,10857,0,0,37860,,,,,,1,1,7.965093648,19319,9105,8774,331,1,330
17669,10944,12054,2,0,33100,,,,,,1,1,6.886966869,17631,7567,7232,335,0,335
17669,9479,9623,0,0,38745,,,,,,1,1,7.786955777,19023,9726,9456,270,3,267
17669,8569,10498,0,1,38420,,,,,,1,1,7.780306164,19512,9304,9004,300,7,293
17669,10434,10684,0,4,35172,,,,,,1,1,7.259518692,17994,8426,8100,326,20,306
17669,7620,11961,2,0,36454,,,,,,1,1,7.442707392,18883,8645,8364,281,3,278
17669,10152,9606,2,1,37081,,,,,,1,1,7.550852192,18917,8926,8614,312,2,310
17669,9319,10977,0,4,36540,,,,,,1,1,7.456980405,19013,8602,8279,323,3,320
17669,9860,11233,0,2,35505,,,,,,1,1,7.246382493,18405,8397,8091,306,2,304
17669,11006,10589,2,4,34209,,,,,,1,1,7.027551292,18152,7877,7574,303,4,299
17669,11031,8703,0,0,33939,,,,,,1,1,6.941151669,17905,7895,7651,244,1,243
17669,10817,11974,0,4,35656,,,,,,1,1,7.251357261,18059,8626,8281,345,7,338
17669,11215,8960,0,2,34651,,,,,,1,1,7.031931462,18217,8083,7815,268,1,267
17669,10662,10487,2,0,37014,,,,,,1,1,7.640768288,18397,9145,8818,327,5,322
17669,10937,9611,2,0,33987,,,,,,1,1,7.181261033,18026,7832,7535,297,0,297
17669,10383,11610,0,0,33578,,,,,,1,1,7.069751413,17747,7764,7461,303,0,303
17669,9916,10097,0,2,35358,,,,,,1,1,7.289263003,18382,8345,8059,286,1,285
17669,11346,11027,0,0,34813,,,,,,1,1,7.076098037,18176,8145,7798,347,3,344
17669,10281,9578,0,0,35975,,,,,,1,1,7.371475895,18813,8435,8143,292,3,289
17669,10294,10424,2,0,34557,,,,,,1,1,7.296262718,17943,8161,7869,292,0,292
17669,9701,10289,1,0,38479,,,,,,1,1,7.78754169,19255,9440,9096,344,9,335
17669,11892,8858,5,0,34360,,,,,,1,1,7.039206578,18195,7946,7673,273,3,270
17669,10963,9312,0,0,36792,,,,,,1,1,7.530312988,18802,8832,8506,326,1,325
17669,10300,9739,0,0,36984,,,,,,1,1,7.455026258,19004,8840,8540,300,1,299
17669,9781,10426,0,0,36291,,,,,,1,1,7.424534066,18594,8699,8400,299,0,299
17669,9973,9138,4,0,35565,,,,,,1,1,7.343045861,18348,8475,8208,267,2,265
17669,9145,9960,0,2,36765,,,,,,1,1,7.417877743,18973,8756,8476,280,5,275
17669,10439,9704,0,0,35075,,,,,,1,1,7.316831498,18292,8262,8003,259,2,257
17669,11461,10853,0,0,35080,,,,,,1,1,7.259958812,18049,8339,7986,353,1,352
17669,9947,9229,0,0,38421,,,,,,1,1,7.817558401,19207,9471,9199,272,2,270
17669,10063,10085,2,2,37431,,,,,,1,1,7.566801605,19162,8980,8671,309,6,303
17669,9768,10619,0,0,37744,,,,,,1,1,7.776776535,19168,9126,8802,324,3,321
17669,9211,10362,2,0,37758,,,,,,1,1,7.639314714,19108,9173,8869,304,2,302
17669,10122,10552,2,0,35205,,,,,,1,1,7.130741191,18020,8450,8165,285,0,285
17669,10722,10084,0,0,35346,,,,,,1,1,7.274269822,18339,8357,8064,293,2,291
17669,11037,10894,0,4,35538,,,,,,1,1,7.313881428,18254,8481,8159,322,1,321
17669,11205,10971,0,2,35611,,,,,,1,1,7.442461293,17780,8750,8419,331,6,325
17669,10553,11779,0,2,35445,,,,,,1,1,7.424447924,18436,8325,7966,359,8,351
17669,9335,8955,0,0,36277,,,,,,1,1,7.5627060010000005,18474,8775,8522,253,0,253
17669,10239,7962,0,0,36528,,,,,,1,1,7.781716586,19165,8554,8299,255,4,251
17669,9433,10467,0,0,35659,,,,,,1,1,7.490686687,18308,8527,8230,297,2,295
17669,9406,10325,0,0,34568,,,,,,1,1,7.179229525,18084,8114,7858,256,1,255
17669,9747,11460,0,3,36389,,,,,,1,1,7.461209098,18420,8807,8452,355,3,352
17669,8994,11409,0,2,35167,,,,,,1,1,7.209967159,18621,8113,7793,320,1,319
17669,9501,8826,2,0,35209,,,,,,1,1,7.218652428,18734,8107,7846,261,1,260
17669,10392,11073,2,0,36520,,,,,,1,1,7.493867917,18521,8843,8530,313,1,312
17669,7665,10535,0,0,37080,,,,,,1,1,7.672307031,19416,8699,8433,266,3,263
17669,10550,9399,4,0,37717,,,,,,1,1,7.776338307,19262,9083,8794,289,5,284
17669,9796,11342,0,2,34546,,,,,,1,1,7.135002502,18476,7886,7588,298,3,295
17669,9411,11974,0,0,35035,,,,,,1,1,7.181722568,18296,8213,7900,313,3,310
17669,10381,10398,0,0,35953,,,,,,1,1,7.401634882,18591,8525,8213,312,1,311
17669,10180,9897,0,2,37279,,,,,,1,1,7.719858254,18965,8991,8659,332,6,326
17669,9173,8282,0,0,36670,,,,,,1,1,7.479563036,19004,8705,8449,256,0,256
17669,10880,10394,0,0,37476,,,,,,1,1,7.74639818,19202,8973,8645,328,0,328
17669,10920,11024,2,0,35833,,,,,,1,1,7.389187866,18562,8474,8151,323,0,323
17669,9852,10981,2,8,38258,,,,,,1,1,7.742387201,19351,9288,8957,331,12,319
17669,9533,12035,0,0,34881,,,,,,1,1,7.055860872,18119,8219,7895,324,2,322
17669,8714,10986,0,0,36024,,,,,,1,1,7.387203855,18351,8685,8382,303,2,301
17669,9765,10766,2,1,37563,,,,,,1,1,7.713272955,19063,9096,8788,308,6,302
17669,8137,10095,2,0,36526,,,,,,1,1,7.391723327,19153,8552,8283,269,6,263
17669,10743,9053,2,0,37772,,,,,,1,1,7.586504006,18927,9256,8923,333,1,332
17669,11451,10750,2,3,35291,,,,,,1,1,7.240492459,17951,8505,8175,330,7,323
17669,10981,9751,2,0,35487,,,,,,1,1,7.387313175,18446,8366,8057,309,4,305
17669,10820,11442,4,4,36990,,,,,,1,1,7.537024891,18752,8948,8606,342,13,329
17669,10416,10307,3,0,36131,,,,,,1,1,7.582927963,18213,8800,8482,318,4,314
17669,10788,9304,4,2,35801,,,,,,1,1,7.313574345,18536,8491,8208,283,4,279
17669,10279,10201,0,2,35716,,,,,,1,1,7.333019292,18631,8392,8091,301,9,292
17669,10073,10090,0,0,36905,,,,,,1,1,7.57553212,18864,8866,8557,309,0,309
17669,9924,11765,2,3,36155,,,,,,1,1,7.39727801,18191,8820,8496,324,0,324
17669,8398,10527,0,0,36755,,,,,,1,1,7.589682895,19125,8671,8383,288,2,286
17669,9681,10881,0,0,36879,,,,,,1,1,7.683565081,18834,8872,8571,301,0,301
17669,10430,9831,2,8,35516,,,,,,1,1,7.317593378,18310,8462,8180,282,11,271
17669,9436,9822,0,4,37512,,,,,,1,1,7.649371328,19287,8973,8694,279,4,275
17669,10200,10546,0,0,37709,,,,,,1,1,7.670944154,19281,9046,8710,336,1,335
17669,11272,10900,2,1,34796,,,,,,1,1,7.325559886,18204,8113,7747,366,9,357
17669,11172,9025,0,0,35625,,,,,,1,1,7.206126588,18591,8355,8031,324,4,320
17669,10066,9591,4,0,36690,,,,,,1,1,7.432139468,18837,8788,8511,277,1,276
17669,11341,10426,0,0,36661,,,,,,1,1,7.626681111,19152,8567,8192,375,5,370
17669,11359,11058,0,2,35099,,,,,,1,1,7.287483628,17992,8377,8024,353,1,352
17669,10446,11174,0,0,35427,,,,,,1,1,7.257414831,18263,8419,8093,326,1,325
17669,9320,9425,2,0,34795,,,,,,1,1,7.102708565,18377,8070,7792,278,2,276
17669,11256,11836,0,2,35174,,,,,,1,1,7.13640208,18170,8327,7977,350,2,348
17669,12079,8918,3,2,33903,,,,,,1,1,6.991782233,17505,8052,7758,294,0,294
17669,10780,8820,2,0,36339,,,,,,1,1,7.38732192,18997,8524,8230,294,1,293
17669,9071,10515,2,0,35640,,,,,,1,1,7.411524945,18429,8466,8187,279,7,272
17669,11060,10286,0,0,37051,,,,,,1,1,7.462045803,18711,9007,8681,326,0,326
17669,10535,9986,0,2,37277,,,,,,1,1,7.528148452,19198,8882,8567,315,2,313
17669,11469,8684,4,2,36094,,,,,,1,1,7.328639449,18525,8623,8300,323,10,313
17669,9333,11033,0,2,37270,,,,,,1,1,7.590141248,18960,8986,8648,338,4,334
17669,11747,9324,2,0,35069,,,,,,1,1,7.119527001,18227,8264,7950,314,2,312
17669,9463,11441,0,2,35827,,,,,,1,1,7.278574165,18434,8552,8263,289,2,287
17669,8980,9920,4,1,36180,,,,,,1,1,7.523638598,18447,8745,8502,243,3,240
17669,11275,10457,4,2,36122,,,,,,1,1,7.391680066,18147,8828,8509,319,7,312
17669,10885,9478,0,0,38047,,,,,,1,1,7.69411181,18902,9409,9082,327,3,324
17669,8578,9491,0,2,38321,,,,,,1,1,7.78622572,19259,9392,9114,278,4,274
17669,9506,10009,2,2,37779,,,,,,1,1,7.754820566,19291,9093,8791,302,4,298
17669,10158,10632,2,0,37073,,,,,,1,1,7.542365444,19027,8859,8531,328,2,326
17669,11817,9592,0,2,35087,,,,,,1,1,7.1652020180000005,18240,8267,7954,313,2,311
17669,9886,11871,0,4,36153,,,,,,1,1,7.660965601,18627,8589,8241,348,2,346
17669,10600,9458,0,0,35655,,,,,,1,1,7.275132164,18719,8325,8039,286,2,284
17669,10442,10597,2,0,34564,,,,,,1,1,7.263753488,18031,8102,7773,329,1,328
17669,10123,11952,0,4,38166,,,,,,1,1,7.725358965,19244,9290,8948,342,14,328
17669,10122,11157,0,0,35522,,,,,,1,1,7.297091445,18113,8535,8196,339,1,338
17669,10716,10125,2,0,36265,,,,,,1,1,7.613431939,18850,8563,8274,289,2,287
17669,10266,10843,4,0,36307,,,,,,1,1,7.51290441,18476,8745,8404,341,9,332
17669,12001,11674,3,4,30897,,,,,,1,1,6.449074659,15820,7358,6997,361,4,357
17669,9322,8946,2,0,38129,,,,,,1,1,7.766241935,19078,9380,9089,291,5,286
17669,9817,9269,2,2,36043,,,,,,1,1,7.660274574,18725,8523,8251,272,5,267
17669,11770,9486,4,0,34032,,,,,,1,1,7.010790609,17972,7877,7571,306,5,301
17669,10039,10231,4,0,36567,,,,,,1,1,7.414317177,18898,8695,8416,279,0,279
17669,9562,10626,0,3,35799,,,,,,1,1,7.305386493,18492,8506,8211,295,3,292
17669,8504,9854,0,0,36422,,,,,,1,1,7.418344842,18973,8596,8339,257,4,253
17669,11353,10041,6,2,34600,,,,,,1,1,7.143351006,18291,7994,7673,321,15,306
17669,9056,12194,2,2,38807,,,,,,1,1,8.074971231,19141,9646,9272,374,9,365
17669,9597,12135,0,4,35398,,,,,,1,1,7.488910442,18278,8395,8065,330,6,324
17669,11142,10261,2,0,36775,,,,,,1,1,7.630195232,18968,8735,8398,337,1,336
17669,11306,11583,0,2,35865,,,,,,1,1,7.421235018,18495,8513,8169,344,2,342
17669,10301,10924,1,2,34522,,,,,,1,1,7.260837155,18294,7971,7685,286,2,284
17669,9739,10838,0,0,37074,,,,,,1,1,7.623699091,18669,9041,8718,323,3,320
17669,11195,9372,0,2,34490,,,,,,1,1,7.164747667,18091,8057,7772,285,12,273
17669,10080,10268,0,0,36480,,,,,,1,1,7.65991718,18973,8591,8266,325,2,323
17669,10330,11368,0,0,36900,,,,,,1,1,7.727649905,18916,8830,8506,324,1,323
17669,10486,8254,2,0,37193,,,,,,1,1,7.758948986,19028,8944,8667,277,10,267
17669,9881,10883,2,0,37217,,,,,,1,1,7.671007472,18836,9044,8751,293,4,289
17669,10744,9572,2,0,38776,,,,,,1,1,7.890426218,19148,9639,9289,350,8,342
17669,11297,11555,0,0,34075,,,,,,1,1,6.952926591,17854,7956,7647,309,2,307
17669,8791,9914,0,2,37454,,,,,,1,1,7.869275893,19149,9011,8728,283,3,280
17669,7981,8355,0,0,39474,,,,,,1,1,8.372386585,19977,9617,9354,263,2,261
17669,10326,8851,2,0,37775,,,,,,1,1,7.864280952,19378,9040,8723,317,3,314
17669,10867,11288,0,2,35064,,,,,,1,1,7.303432284,18292,8224,7900,324,3,321
17669,10632,9032,4,0,35806,,,,,,1,1,7.480201512,18594,8466,8186,280,9,271
17669,9258,9858,0,2,35761,,,,,,1,1,7.344346467,18165,8663,8393,270,0,270
17669,10137,11235,0,3,37539,,,,,,1,1,7.90110787,19093,9048,8698,350,2,348
17669,11478,8803,2,0,35280,,,,,,1,1,7.336699412,18222,8373,8061,312,0,312
17669,9553,11011,2,0,35322,,,,,,1,1,7.300948157,18235,8396,8101,295,3,292
17669,12896,9970,6,0,36830,,,,,,1,1,7.830487042,18417,9024,8659,365,5,360
17669,8639,9996,0,11,37384,,,,,,1,1,7.79997079,19134,9003,8759,244,4,240
17669,10485,11156,0,0,35259,,,,,,1,1,7.30798064,18286,8339,8044,295,1,294
17669,11437,11097,4,2,34904,,,,,,1,1,7.4025479149999995,18341,8115,7782,333,3,330
17669,9756,11060,0,0,38967,,,,,,1,1,7.96463051,19431,9596,9252,344,0,344
17669,9253,10352,1,3,37811,,,,,,1,1,8.049294417,19020,9250,8959,291,0,291
17669,10154,11544,0,2,38253,,,,,,1,1,7.940543817,19279,9299,8923,376,12,364
17669,10473,10888,0,2,35957,,,,,,1,1,7.425924206,18385,8621,8291,330,3,327
17669,10366,10640,0,0,36086,,,,,,1,1,7.507279748,18806,8477,8151,326,4,322
17669,10589,10751,0,2,35928,,,,,,1,1,7.223849426,18410,8594,8264,330,0,330
17669,10402,10012,0,4,36327,,,,,,1,1,7.450607685,18965,8527,8219,308,4,304
17669,10385,9376,2,0,37835,,,,,,1,1,7.97147028,19362,9093,8806,287,1,286
17669,10224,10596,2,0,36005,,,,,,1,1,7.325330517,18868,8407,8084,323,4,319
17669,9866,10448,2,2,38759,,,,,,1,1,8.262380564,19365,9547,9247,300,4,296
17669,9268,8487,0,0,36871,,,,,,1,1,7.502063222,18998,8801,8530,271,3,268
17669,9339,10759,0,0,35227,,,,,,1,1,7.272958291,18386,8265,7954,311,2,309
17669,10193,10555,0,0,34718,,,,,,1,1,7.18515657,18367,8017,7700,317,3,314
17669,10175,8937,3,2,34576,,,,,,1,1,7.204004728,17959,8179,7920,259,5,254
17669,9840,8900,0,2,37057,,,,,,1,1,7.646905627,19163,8806,8524,282,2,280
17669,10977,10956,0,0,36533,,,,,,1,1,7.458975923,18805,8703,8381,322,2,320
17669,9045,11048,0,0,36268,,,,,,1,1,7.550288324,18816,8580,8288,292,4,288
17669,10700,9860,4,2,38223,,,,,,1,1,7.713755248,19150,9378,9061,317,7,310
17669,9018,10203,4,0,38394,,,,,,1,1,7.856473375,19384,9359,9067,292,2,290
17669,10542,9894,0,0,35101,,,,,,1,1,7.363554385,18581,8106,7798,308,3,305
17669,10913,10543,6,2,37083,,,,,,1,1,7.74895356,18941,8913,8597,316,0,316
17669,10469,11156,0,2,37821,,,,,,1,1,7.862209332,19022,9227,8882,345,8,337
17669,11286,8778,4,0,38227,,,,,,1,1,7.710935825,19281,9304,8966,338,5,333
17669,10320,12406,0,0,36404,,,,,,1,1,7.567779129,18205,8922,8567,355,1,354
17669,10883,9671,0,0,36408,,,,,,1,1,7.566804275,18516,8802,8514,288,0,288
17669,9764,9431,0,2,34890,,,,,,1,1,7.203696316,18389,8125,7874,251,2,249
17669,11405,10917,0,2,35895,,,,,,1,1,7.45407712,18078,8741,8406,335,4,331
17669,11859,9603,2,0,35371,,,,,,1,1,7.253309679,18029,8524,8230,294,2,292
17669,9444,10991,5,0,34670,,,,,,1,1,7.106362173,18502,7939,7649,290,2,288
17669,9352,10099,2,0,36135,,,,,,1,1,7.56074897,18717,8571,8295,276,5,271
17669,11081,9198,4,0,36173,,,,,,1,1,7.3570053,18746,8560,8253,307,2,305
17669,12272,10171,2,0,33709,,,,,,1,1,6.982701005,17586,7899,7574,325,11,314
17669,11499,11340,3,4,34068,,,,,,1,1,7.152389675,17668,8023,7669,354,6,348
17669,9953,10013,0,5,37703,,,,,,1,1,7.673658056,19297,9052,8750,302,9,293
17669,11965,10908,2,0,33343,,,,,,1,1,6.871318167,17617,7698,7368,330,4,326
17669,10160,8955,2,0,36736,,,,,,1,1,7.456807052,18738,8859,8579,280,3,277
17669,10887,10116,1,0,37360,,,,,,1,1,7.735229142,18953,9031,8686,345,3,342
17669,9624,10810,1,2,35849,,,,,,1,1,7.235412586,18582,8483,8182,301,3,298
17669,11056,10325,5,0,33706,,,,,,1,1,6.9202901489999995,18079,7664,7365,299,3,296
17669,10591,10064,0,2,36121,,,,,,1,1,7.289665894,18680,8563,8248,315,1,314
17669,8640,10402,0,2,36892,,,,,,1,1,7.857914522,18907,8857,8586,271,3,268
17669,9282,10863,1,0,36921,,,,,,1,1,7.495311559,18922,8840,8521,319,1,318
17669,9493,10626,0,0,35159,,,,,,1,1,7.133735602,18361,8250,7952,298,3,295
17669,10423,10768,0,0,36798,,,,,,1,1,7.672180018,18510,8979,8649,330,0,330
17669,10869,9571,0,0,35297,,,,,,1,1,7.238370733,18370,8311,8006,305,2,303
17669,11803,9660,2,0,33992,,,,,,1,1,6.927641495,17863,7923,7640,283,3,280
17669,11969,11381,3,0,34811,,,,,,1,1,7.115133351,18070,8186,7817,369,3,366
17669,10242,10528,0,0,36468,,,,,,1,1,7.676061309,18805,8685,8392,293,0,293
17669,10825,8353,2,0,37965,,,,,,1,1,7.674025039,18966,9350,9051,299,6,293
17669,10893,10449,4,2,35803,,,,,,1,1,7.436537052,18318,8587,8276,311,3,308
17669,10124,10589,2,2,36963,,,,,,1,1,7.711198721,18665,8980,8642,338,5,333
17669,9770,9921,2,0,37750,,,,,,1,1,7.35884416,19040,9195,8875,320,7,313
17669,10431,9543,0,0,37649,,,,,,1,1,7.857103342,19326,8996,8665,331,2,329
17669,10037,10265,2,2,35681,,,,,,1,1,7.311416385,18704,8344,8055,289,1,288
17669,10234,9841,2,0,37525,,,,,,1,1,7.5400387989999995,19207,9004,8694,310,5,305
17669,10601,10893,0,0,37186,,,,,,1,1,7.420632331,19029,8916,8591,325,2,323
17669,10241,10951,2,4,37861,,,,,,1,1,7.788977092,18906,9312,8981,331,4,327
17669,10622,9636,2,2,37643,,,,,,1,1,7.367895023,19338,9007,8716,291,9,282
17669,9588,12606,0,1,35363,,,,,,1,1,6.332798877,18190,8422,8093,329,4,325
17669,12003,10895,4,4,35595,,,,,,1,1,6.404433324,18288,8490,8163,327,0,327
17669,10655,9181,2,2,36400,,,,,,1,1,7.402011573,18725,8687,8386,301,1,300
17669,11081,10379,0,2,34631,,,,,,1,1,5.662899127,17779,8276,7976,300,4,296
17669,12670,8726,4,0,37177,,,,,,1,1,5.882808509,18523,9159,8823,336,1,335
17669,10444,9955,0,2,37970,,,,,,1,1,6.994724884,18973,9331,8996,335,5,330
17669,9714,9893,0,2,36545,,,,,,1,1,5.809143892,18738,8760,8473,287,0,287
17669,9873,10546,1,2,34272,,,,,,1,1,7.068526759,18004,7996,7720,276,2,274
17669,10529,10973,0,2,34008,,,,,,1,1,6.90839159,17728,7986,7678,308,3,305
17669,8942,8023,0,0,37847,,,,,,1,1,7.599493191,19561,9014,8756,258,4,254
17669,10291,10005,1,4,34574,,,,,,1,1,6.496203605,18213,8036,7747,289,2,287
