key_bits,recovered_zeros_x,recovered_zeros_y,wrong_zeros_x,wrong_zeros_y,queries,traces,calibration_traces,threshold,tpr,tnr,attack_tpr,attack_tnr,duration_seconds,test_outcomes_0_false,test_outcomes_0_true,test_outcomes_1_false,test_outcomes_1_true,test_outcomes_2_false,test_outcomes_2_true
17669,10666,9882,0,0,1417,,,,,,1,1,0.297288418,593,354,238,116,0,116
17669,9185,11361,0,0,2559,,,,,,1,1,0.527388719,1146,631,480,151,0,151
17669,10419,10131,0,0,3232,,,,,,1,1,0.668759152,1427,823,664,159,1,158
17669,9908,10637,0,0,3319,,,,,,1,1,0.671439666,1522,817,654,163,0,163
17669,10713,9837,2,0,3531,,,,,,1,1,0.715468721,1581,887,711,176,1,175
17669,10430,10132,0,0,3551,,,,,,1,1,0.729390117,1654,868,707,161,2,159
17669,10609,9935,0,0,3908,,,,,,1,1,0.795097275,1751,984,795,189,2,187
17669,9521,11035,2,2,4187,,,,,,1,1,0.872884046,1974,1007,808,199,0,199
17669,10077,10487,0,0,4947,,,,,,1,1,1.001479848,2266,1242,1045,197,0,197
17669,9811,10990,0,0,5240,,,,,,1,1,1.08017379,2467,1297,1118,179,0,179
17669,10846,10001,0,0,5796,,,,,,1,1,1.268802918,2691,1448,1239,209,0,209
17669,9714,10846,0,0,2610,,,,,,1,1,0.533876972,1152,658,516,142,0,142
17669,10177,10641,0,0,5251,,,,,,1,1,1.070027592,2377,1337,1137,200,1,199
17669,9869,10676,0,0,7160,,,,,,1,1,1.468817251,3536,1707,1497,210,1,209
17669,11665,8888,0,0,3496,,,,,,1,1,0.718929796,1646,848,694,154,0,154
17669,10211,10348,0,2,8068,,,,,,1,1,1.627258809,3928,1961,1743,218,2,216
17669,9907,10933,0,0,7472,,,,,,1,1,1.544412844,3712,1782,1586,196,0,196
17669,10809,9735,0,0,13048,,,,,,1,1,2.6766749020000002,6750,3039,2819,220,1,219
17669,11119,9428,0,0,4058,,,,,,1,1,0.824623429,1852,1010,824,186,0,186
17669,10262,10317,2,0,7460,,,,,,1,1,1.659064011,3772,1748,1556,192,4,188
17669,10702,9934,0,0,7801,,,,,,1,1,1.6163962920000001,3700,1944,1731,213,0,213
17669,11017,9814,0,0,16150,,,,,,1,1,3.397370259,7862,4004,3724,280,0,280
17669,10168,10695,0,0,4595,,,,,,1,1,0.924333416,2184,1121,952,169,0,169
17669,9449,11096,0,4,6360,,,,,,1,1,1.288739311,3010,1570,1360,210,3,207
17669,10284,10271,2,0,17171,,,,,,1,1,3.509490534,8590,4155,3884,271,2,269
17669,10599,9967,0,2,5100,,,,,,1,1,1.027190412,2366,1276,1094,182,4,178
17669,10839,9912,2,2,1793,,,,,,1,1,0.370511221,768,450,325,125,0,125
17669,10295,10258,0,0,4740,,,,,,1,1,1.009383248,2106,1227,1047,180,2,178
17669,10114,10430,2,2,22621,,,,,,1,1,4.607018375,11505,5426,5162,264,1,263
17669,10368,10536,0,0,30399,,,,,,1,1,6.339178547,15624,7217,6876,341,4,337
17669,10815,9730,2,0,13516,,,,,,1,1,2.914555994,6614,3322,3064,258,6,252
17669,10896,9351,1,1,35485,,,,,,1,1,7.319956474,18612,8286,7985,301,1,300
17669,8807,10122,0,2,35270,,,,,,1,1,7.325326892,18388,8291,7991,300,10,290
17669,10496,9551,2,0,35837,,,,,,1,1,7.392035134,18632,8454,8157,297,6,291
17669,8963,10282,0,2,34537,,,,,,1,1,7.433362485,18519,7886,7640,246,0,246
17669,9514,10878,2,0,36240,,,,,,1,1,7.509572666,18266,8844,8558,286,2,284
17669,10405,9700,0,0,35999,,,,,,1,1,7.584163976,18329,8687,8391,296,3,293
17669,10470,10433,0,0,2568,,,,,,1,1,0.525215834,1114,652,502,150,0,150
17669,10290,8099,0,0,36627,,,,,,1,1,7.71447465,18740,8809,8540,269,0,269
17669,9470,11142,0,2,3711,,,,,,1,1,0.755020231,1737,910,756,154,2,152
17669,10020,9149,2,0,37837,,,,,,1,1,7.882299446,19176,9181,8882,299,3,296
17669,10199,9012,2,0,37631,,,,,,1,1,8.083475283,19394,8971,8676,295,1,294
17669,10845,8230,2,0,38970,,,,,,1,1,8.139109345,19680,9504,9222,282,5,277
17669,10098,9364,0,2,36603,,,,,,1,1,7.427923578,19009,8651,8359,292,3,289
17669,11000,9746,0,2,2842,,,,,,1,1,0.585430854,1224,727,563,164,0,164
17669,11116,9440,0,0,3859,,,,,,1,1,0.812274594,1793,951,787,164,0,164
17669,10341,8234,0,0,36717,,,,,,1,1,7.725291038,18950,8764,8525,239,2,237
17669,9206,11338,0,0,3360,,,,,,1,1,0.690235095,1527,838,681,157,0,157
17669,9655,10893,0,0,3373,,,,,,1,1,0.701029312,1528,846,693,153,0,153
17669,9986,10593,0,0,2338,,,,,,1,1,0.478560055,993,594,437,157,0,157
17669,10298,9615,2,0,35578,,,,,,1,1,7.362293401,18351,8467,8174,293,2,291
17669,9593,10952,0,0,1827,,,,,,1,1,0.373293898,730,483,352,131,0,131
17669,9106,11445,0,0,6255,,,,,,1,1,1.269564631,2886,1580,1371,209,1,208
17669,10370,10234,0,2,8929,,,,,,1,1,1.7970044920000001,4285,2220,2016,204,0,204
17669,10667,9881,0,0,7011,,,,,,1,1,1.435517024,3331,1725,1495,230,0,230
17669,10379,10159,4,0,37870,,,,,,1,1,7.756620084,19349,9087,8740,347,0,347
17669,9881,10721,2,0,7463,,,,,,1,1,1.516355263,3532,1853,1628,225,2,223
17669,10768,10035,0,1,3925,,,,,,1,1,0.792045678,1783,979,795,184,0,184
17669,9803,8757,0,0,38833,,,,,,1,1,8.076242914,19362,9583,9278,305,1,304
17669,10468,10085,0,0,2202,,,,,,1,1,0.451670226,947,560,425,135,0,135
17669,11257,9423,0,0,2352,,,,,,1,1,0.4844716,1021,596,457,139,1,138
17669,9898,10684,2,0,1119,,,,,,1,1,0.232612093,438,286,177,109,1,108
17669,10652,9988,2,0,3797,,,,,,1,1,0.766436006,1738,937,752,185,1,184
17669,10465,10082,0,0,7369,,,,,,1,1,1.499140547,3527,1820,1618,202,0,202
17669,9158,10676,0,0,36535,,,,,,1,1,7.398062944,19037,8609,8329,280,1,279
17669,10249,10486,0,2,5383,,,,,,1,1,1.096489259,2609,1290,1096,194,0,194
17669,9849,10806,0,2,9115,,,,,,1,1,1.8395050990000001,4473,2199,1955,244,2,242
17669,10387,10158,0,2,4063,,,,,,1,1,0.820475627,1875,1007,833,174,0,174
17669,10577,9979,0,2,2946,,,,,,1,1,0.596380521,1266,753,579,174,0,174
17669,10888,9079,0,0,37185,,,,,,1,1,7.703524507,18980,8947,8636,311,1,310
17669,9989,10706,0,4,8357,,,,,,1,1,1.695725425,4063,2041,1829,212,0,212
17669,10204,10466,0,0,4327,,,,,,1,1,0.884015059,1967,1093,919,174,3,171
17669,10716,10180,0,0,5327,,,,,,1,1,1.090747407,2523,1301,1099,202,0,202
17669,8755,11805,0,0,1980,,,,,,1,1,0.410650679,835,506,373,133,0,133
17669,10218,10458,0,0,3369,,,,,,1,1,0.68582086,1541,837,683,154,1,153
17669,10271,8485,0,0,38424,,,,,,1,1,7.886731998,19271,9443,9176,267,3,264
17669,10081,10587,0,2,2096,,,,,,1,1,0.42974262,885,532,385,147,1,146
17669,10543,10009,0,0,3656,,,,,,1,1,0.749584384,1638,928,766,162,1,161
17669,10441,10123,0,0,1972,,,,,,1,1,0.422886933,838,500,366,134,0,134
17669,10354,10206,2,1,3189,,,,,,1,1,0.670048841,1437,797,639,158,1,157
17669,10440,10315,0,2,11092,,,,,,1,1,2.266198931,5541,2650,2399,251,0,251
17669,9356,11198,0,0,7406,,,,,,1,1,1.486796411,3414,1890,1678,212,0,212
17669,10826,10027,2,0,2212,,,,,,1,1,0.530903306,942,561,413,148,1,147
17669,10565,9329,4,0,35775,,,,,,1,1,7.334072472,18332,8582,8303,279,4,275
17669,10862,9767,0,0,1219,,,,,,1,1,0.256128151,494,308,199,109,1,108
17669,11723,9091,0,0,6876,,,,,,1,1,1.393291492,3204,1728,1512,216,1,215
17669,10495,10132,0,0,2586,,,,,,1,1,0.53676435,1164,636,486,150,0,150
17669,9572,10906,0,2,37215,,,,,,1,1,7.694526078,18935,8979,8657,322,3,319
17669,9974,10587,0,0,1159,,,,,,1,1,0.240775817,467,293,187,106,0,106
17669,10952,9605,0,2,5881,,,,,,1,1,1.196326429,2642,1526,1339,187,2,185
17669,10342,9789,3,0,36925,,,,,,1,1,7.520818078,18919,8847,8535,312,4,308
17669,10192,10356,0,0,2206,,,,,,1,1,0.450582493,932,558,400,158,0,158
17669,10459,10093,2,0,6043,,,,,,1,1,1.22736769,2862,1497,1310,187,2,185
17669,10292,10558,2,2,4961,,,,,,1,1,1.083329034,2348,1212,1023,189,6,183
17669,10340,10536,0,2,8517,,,,,,1,1,1.7683014620000002,4067,2127,1931,196,3,193
17669,9600,10948,0,0,3688,,,,,,1,1,0.756582052,1750,881,705,176,0,176
17669,9715,10918,2,0,26532,,,,,,1,1,5.447757397,13749,6257,5988,269,2,267
17669,9733,10971,0,2,2375,,,,,,1,1,0.48602243,1018,607,464,143,1,142
17669,9831,10716,0,0,2415,,,,,,1,1,0.49078388,1016,625,476,149,0,149
17669,10388,10159,0,0,3513,,,,,,1,1,0.709095664,1522,908,733,175,0,175
17669,9155,11541,0,2,10518,,,,,,1,1,2.151421155,5172,2561,2337,224,1,223
17669,10096,10070,0,2,36945,,,,,,1,1,7.46267047,18926,8861,8564,297,3,294
17669,10011,10511,0,0,36988,,,,,,1,1,7.545756128,18809,8938,8635,303,1,302
17669,10280,10313,4,0,32411,,,,,,1,1,6.68089248,16900,7623,7358,265,5,260
17669,10490,9100,0,0,36125,,,,,,1,1,7.309816012,18444,8693,8398,295,3,292
17669,10459,10121,4,2,32512,,,,,,1,1,6.551698033,16412,7903,7609,294,2,292
17669,10797,9107,2,0,35955,,,,,,1,1,7.334040839,18644,8528,8273,255,2,253
17669,8550,9701,0,2,36542,,,,,,1,1,7.391037078,19212,8522,8236,286,10,276
17669,10942,9661,0,0,26759,,,,,,1,1,5.409050102,13880,6306,6039,267,1,266
17669,9330,11218,0,0,11307,,,,,,1,1,2.300898701,5611,2733,2503,230,0,230
17669,9737,9330,0,0,37898,,,,,,1,1,7.713525756,19277,9159,8856,303,1,302
17669,10168,10385,0,0,975,,,,,,1,1,0.20293592,337,268,166,102,0,102
17669,9633,10520,2,2,36180,,,,,,1,1,7.609803438,18867,8506,8205,301,6,295
17669,8813,10486,0,4,36967,,,,,,1,1,7.476521107,18954,8860,8567,293,8,285
17669,10791,9753,2,0,17467,,,,,,1,1,3.534248028,8618,4296,4039,257,1,256
17669,10432,10228,0,2,3054,,,,,,1,1,0.620880072,1436,733,581,152,0,152
17669,9090,11460,0,2,7697,,,,,,1,1,1.555278937,3852,1815,1600,215,3,212
17669,10141,9952,3,0,35943,,,,,,1,1,7.236959008,18457,8596,8302,294,2,292
17669,10727,9817,0,0,3357,,,,,,1,1,0.680884268,1510,849,700,149,0,149
17669,10078,9989,0,0,35051,,,,,,1,1,7.099836639,18451,8172,7916,256,1,255
17669,9538,11007,0,0,10972,,,,,,1,1,2.237356791,5355,2681,2426,255,1,254
17669,9429,11195,3,2,10681,,,,,,1,1,2.237485643,5299,2577,2349,228,1,227
17669,10379,10272,0,2,4357,,,,,,1,1,0.88157048,1949,1109,919,190,0,190
17669,11448,9096,3,2,14762,,,,,,1,1,2.98962417,7498,3518,3290,228,2,226
17669,9801,10743,0,0,3758,,,,,,1,1,0.77457937,1671,950,763,187,0,187
17669,10239,10656,0,0,9428,,,,,,1,1,1.898993574,4550,2327,2103,224,1,223
17669,11431,9120,0,0,1512,,,,,,1,1,0.313672197,627,380,255,125,0,125
17669,9218,10993,2,4,34595,,,,,,1,1,7.137346605,18287,7997,7683,314,3,311
17669,9507,10574,0,2,38653,,,,,,1,1,7.780282774,19557,9397,9095,302,7,295
17669,10582,10278,0,0,3090,,,,,,1,1,0.637121737,1412,762,608,154,0,154
17669,10412,9028,4,2,37612,,,,,,1,1,7.576362913,19243,9030,8721,309,4,305
17669,11031,9542,0,0,2446,,,,,,1,1,0.512410604,1060,621,477,144,0,144
17669,10391,10175,0,0,2455,,,,,,1,1,0.503913676,1050,629,482,147,0,147
17669,9936,10611,0,0,13280,,,,,,1,1,2.7017809699999997,6468,3265,2983,282,1,281
17669,10038,10754,2,0,2484,,,,,,1,1,0.515847187,1113,609,456,153,0,153
17669,9904,10998,2,2,3349,,,,,,1,1,0.688825639,1580,812,667,145,2,143
17669,9110,10144,0,0,38565,,,,,,1,1,7.967198024,19001,9630,9326,304,3,301
17669,8807,10608,0,0,35605,,,,,,1,1,7.241560382,18542,8388,8101,287,4,283
17669,10370,10334,2,0,11831,,,,,,1,1,2.412547732,5945,2832,2610,222,0,222
17669,8865,10287,0,0,37104,,,,,,1,1,7.6149365719999995,19136,8832,8528,304,2,302
17669,10563,10019,2,0,1901,,,,,,1,1,0.410932503,814,476,341,135,1,134
17669,11309,9506,2,3,3432,,,,,,1,1,0.681757181,1563,852,687,165,0,165
17669,9104,9819,0,2,37313,,,,,,1,1,7.63691158,18954,9036,8749,287,1,286
17669,10950,9613,2,2,19902,,,,,,1,1,4.17941887,10064,4792,4538,254,1,253
17669,10082,9496,2,1,34740,,,,,,1,1,7.255662951,18221,8127,7862,265,10,255
17669,10103,10449,2,1,4346,,,,,,1,1,0.878656114,2008,1078,896,182,3,179
17669,10825,9721,0,0,4118,,,,,,1,1,0.897421651,1931,998,807,191,0,191
17669,11071,8738,0,0,36960,,,,,,1,1,7.561258466,18760,8943,8629,314,3,311
17669,9891,10655,0,2,5022,,,,,,1,1,1.042587762,2434,1203,1021,182,1,181
17669,10343,10220,0,0,2736,,,,,,1,1,0.562600437,1206,687,531,156,0,156
17669,9633,10889,2,0,34644,,,,,,1,1,7.233498684,18116,8113,7811,302,4,298
17669,10454,9687,4,1,38593,,,,,,1,1,7.929150289,19797,9222,8870,352,22,330
17669,10322,10224,2,2,14583,,,,,,1,1,3.037294385,7227,3559,3321,238,6,232
17669,10549,9811,0,2,35282,,,,,,1,1,7.409982763,18490,8252,7964,288,4,284
17669,10619,10156,0,0,12125,,,,,,1,1,2.564089716,6133,2874,2630,244,0,244
17669,10423,10075,0,0,35462,,,,,,1,1,7.302360956,18040,8569,8285,284,0,284
17669,7995,9070,4,2,37057,,,,,,1,1,7.452637981,18993,8914,8678,236,3,233
17669,10507,8899,0,2,37564,,,,,,1,1,7.6384863450000005,19317,8983,8702,281,4,277
17669,9592,10964,0,0,2108,,,,,,1,1,0.436914302,905,535,402,133,1,132
17669,9177,10075,2,0,35327,,,,,,1,1,7.271948393,18367,8351,8093,258,3,255
17669,11215,8866,2,0,36529,,,,,,1,1,7.549927579,18611,8813,8521,292,4,288
17669,9659,10891,0,0,5164,,,,,,1,1,1.094304915,2411,1285,1102,183,1,182
17669,11100,9502,3,0,12098,,,,,,1,1,2.476064257,6166,2859,2645,214,2,212
17669,9946,9676,2,2,37639,,,,,,1,1,7.936049732,19249,9040,8730,310,9,301
17669,10360,10468,0,2,7408,,,,,,1,1,1.536067139,3519,1837,1622,215,4,211
17669,9371,11196,0,0,1897,,,,,,1,1,0.397290033,809,472,328,144,1,143
17669,7964,10771,0,0,37128,,,,,,1,1,7.719824245,19094,8879,8603,276,3,273
17669,10186,10361,0,0,3033,,,,,,1,1,0.618926318,1410,736,585,151,0,151
17669,9858,10952,0,4,7993,,,,,,1,1,1.6204399139999999,3858,1969,1772,197,1,196
17669,10268,10276,0,0,4192,,,,,,1,1,0.865914914,2039,990,817,173,0,173
17669,10842,9880,0,0,1219,,,,,,1,1,0.253010792,482,317,214,103,0,103
17669,9068,10875,0,3,35380,,,,,,1,1,7.293654461,18619,8233,7938,295,5,290
17669,10999,9018,3,0,36468,,,,,,1,1,7.836515519,19194,8488,8190,298,2,296
17669,8988,11560,2,2,2214,,,,,,1,1,0.458785868,959,556,413,143,5,138
17669,9969,10162,4,5,37606,,,,,,1,1,7.787652103,19293,8996,8675,321,10,311
17669,10598,9873,2,0,34690,,,,,,1,1,7.103114759,18102,8142,7838,304,1,303
17669,10428,10116,1,2,5785,,,,,,1,1,1.162766779,2624,1481,1282,199,4,195
17669,10521,10023,0,0,18196,,,,,,1,1,3.725896496,9136,4403,4149,254,1,253
17669,10102,10442,0,0,8564,,,,,,1,1,1.7235221250000001,4086,2127,1903,224,0,224
17669,9548,10312,0,0,35489,,,,,,1,1,7.372784791,18558,8315,8014,301,3,298
17669,11228,9217,3,0,35667,,,,,,1,1,7.417922091,18773,8294,7988,306,0,306
17669,9320,11224,4,0,28259,,,,,,1,1,5.939220768,14807,6588,6312,276,4,272
17669,9752,10859,0,0,5998,,,,,,1,1,1.252514282,2961,1420,1223,197,0,197
17669,9250,10740,0,2,37147,,,,,,1,1,7.658893251,18946,8951,8652,299,1,298
17669,10581,9972,0,0,2804,,,,,,1,1,0.570771582,1377,641,496,145,0,145
17669,9453,9795,0,0,36320,,,,,,1,1,7.400717224,18925,8551,8258,293,4,289
17669,10407,10174,0,2,2034,,,,,,1,1,0.426327139,862,522,394,128,0,128
17669,10876,9332,0,0,35015,,,,,,1,1,7.487860955,18286,8223,7940,283,1,282
17669,10251,10294,0,0,1828,,,,,,1,1,0.369281409,703,494,357,137,0,137
17669,11184,9734,0,0,3501,,,,,,1,1,0.725990919,1592,866,689,177,0,177
17669,11295,9258,0,0,1979,,,,,,1,1,0.420129321,814,519,392,127,0,127
17669,10414,10138,2,2,2812,,,,,,1,1,0.575425199,1329,668,521,147,4,143
17669,9380,9052,0,0,38852,,,,,,1,1,7.930770333,19572,9492,9196,296,1,295
17669,9906,9229,0,4,36055,,,,,,1,1,7.7593428620000005,18817,8486,8220,266,3,263
17669,10095,10463,0,2,1111,,,,,,1,1,0.240123059,429,288,182,106,0,106
17669,9211,11344,0,0,2303,,,,,,1,1,0.479145985,980,591,450,141,0,141
17669,9924,10623,0,2,9603,,,,,,1,1,1.988306296,4508,2429,2192,237,4,233
17669,8980,9279,2,2,38349,,,,,,1,1,7.990818744,19064,9502,9221,281,6,275
17669,9539,9964,2,2,35457,,,,,,1,1,7.328617129,18482,8350,8075,275,4,271
17669,10230,10314,4,2,12981,,,,,,1,1,2.98965483,6614,3071,2846,225,0,225
17669,9527,11020,2,0,12927,,,,,,1,1,2.758561685,6585,3052,2814,238,0,238
17669,10364,9734,0,0,35242,,,,,,1,1,7.410931999,18372,8279,7967,312,3,309
17669,10793,9752,0,2,10750,,,,,,1,1,2.43155767,5457,2536,2315,221,5,216
17669,11003,8909,2,0,37247,,,,,,1,1,8.00789027,18990,8979,8680,299,2,297
17669,9989,10379,0,0,36027,,,,,,1,1,7.485530312,18647,8523,8189,334,2,332
17669,10178,10368,0,0,11137,,,,,,1,1,2.317873145,5717,2604,2392,212,1,211
17669,9934,10760,0,0,4013,,,,,,1,1,0.893703387,1880,977,798,179,0,179
17669,9008,8830,0,0,37874,,,,,,1,1,7.936466372,19322,9149,8895,254,2,252
17669,9459,11089,0,0,5623,,,,,,1,1,1.147713181,2630,1398,1201,197,0,197
17669,10830,9720,0,0,1849,,,,,,1,1,0.405395345,746,488,361,127,0,127
17669,10738,9825,2,0,5842,,,,,,1,1,1.387334705,2769,1426,1205,221,5,216
17669,9334,9937,2,2,36948,,,,,,1,1,7.794157418,18943,8871,8608,263,1,262
17669,10324,10224,0,0,6168,,,,,,1,1,1.4015058329999999,3015,1476,1275,201,2,199
17669,10854,9856,4,0,4758,,,,,,1,1,0.971135653,2300,1137,953,184,4,180
17669,9120,9852,0,2,35644,,,,,,1,1,7.626030229,18685,8346,8079,267,1,266
17669,10951,9302,1,0,35719,,,,,,1,1,7.435707298,18221,8615,8347,268,2,266
17669,9651,10926,0,0,3089,,,,,,1,1,0.62448818,1308,798,613,185,0,185
17669,10558,9993,2,0,5136,,,,,,1,1,1.120133424,2521,1220,1045,175,2,173
17669,9368,11177,0,0,8539,,,,,,1,1,1.755079806,4122,2085,1838,247,1,246
17669,10940,9604,0,4,7450,,,,,,1,1,1.5358431700000001,3586,1830,1626,204,3,201
17669,10680,9779,2,0,36299,,,,,,1,1,7.489054731,18449,8766,8448,318,1,317
17669,9251,8511,3,0,38429,,,,,,1,1,8.217508742,19662,9259,9010,249,1,248
17669,9869,10979,0,0,2068,,,,,,1,1,0.421136344,848,540,400,140,0,140
17669,9878,9736,7,2,35327,,,,,,1,1,7.640034206,18450,8300,8023,277,3,274
17669,10523,10055,0,0,1719,,,,,,1,1,0.354665955,737,427,299,128,0,128
17669,11475,9073,0,0,2992,,,,,,1,1,0.605982406,1359,735,572,163,0,163
17669,9706,10698,2,0,36674,,,,,,1,1,7.738845834,18697,8820,8483,337,9,328
17669,10824,9731,0,2,30405,,,,,,1,1,6.531791886,15722,7197,6908,289,2,287
17669,9137,10221,3,0,36266,,,,,,1,1,7.78444072,18672,8665,8401,264,4,260
17669,9899,10773,0,2,4738,,,,,,1,1,1.016955222,2153,1196,1003,193,0,193
17669,9619,9271,2,2,35404,,,,,,1,1,7.623501751,18496,8304,8004,300,20,280
17669,10980,9565,2,0,5725,,,,,,1,1,1.188065712,2637,1442,1238,204,3,201
17669,10297,10251,0,0,10224,,,,,,1,1,2.12626903,4977,2504,2265,239,0,239
17669,10942,8966,2,0,37987,,,,,,1,1,8.093965067,19119,9272,8948,324,2,322
17669,9551,11021,2,0,1734,,,,,,1,1,0.330814024,715,444,313,131,1,130
17669,9617,11141,0,0,3820,,,,,,1,1,0.781649643,1739,958,793,165,0,165
17669,10796,9748,0,2,36941,,,,,,1,1,7.801610551,18644,8991,8676,315,2,313
17669,10229,9893,2,0,35311,,,,,,1,1,7.522763092,18412,8292,7977,315,2,313
17669,9674,10916,0,2,5900,,,,,,1,1,1.252792639,2764,1472,1280,192,2,190
17669,10826,9259,0,4,36703,,,,,,1,1,7.8113451640000005,18626,8888,8587,301,3,298
17669,10716,9284,0,0,35908,,,,,,1,1,7.774419418,18643,8479,8172,307,3,304
17669,9228,10249,0,1,36108,,,,,,1,1,7.385170908,18785,8527,8258,269,0,269
17669,10132,10437,0,0,1037,,,,,,1,1,0.215834404,363,285,181,104,0,104
17669,10289,9441,0,0,35455,,,,,,1,1,7.512812568,18788,8193,7912,281,5,276
17669,10503,10150,0,2,4002,,,,,,1,1,0.812662955,1849,992,823,169,3,166
17669,8455,9958,2,2,36433,,,,,,1,1,7.4172508839999995,18896,8647,8404,243,3,240
17669,10385,10427,0,1,21288,,,,,,1,1,4.38151435,10960,5037,4783,254,3,251
17669,9072,11489,0,0,2726,,,,,,1,1,0.552316479,1142,713,555,158,0,158
17669,11126,9612,4,0,10155,,,,,,1,1,2.063980205,5107,2405,2167,238,3,235
17669,10306,10250,0,2,6542,,,,,,1,1,1.336778358,3187,1585,1400,185,1,184
17669,10107,10448,4,0,2473,,,,,,1,1,0.507364812,1092,619,476,143,3,140
17669,8927,8964,0,0,38834,,,,,,1,1,8.054746779,19877,9337,9054,283,1,282
17669,10010,10543,0,0,3179,,,,,,1,1,0.670089616,1436,796,645,151,0,151
17669,10133,10412,0,0,7588,,,,,,1,1,1.6004529870000002,3775,1806,1605,201,1,200
17669,10473,10077,0,4,3954,,,,,,1,1,0.835017208,1716,1033,861,172,4,168
17669,11128,9233,1,0,35563,,,,,,1,1,7.443142824,18507,8365,8039,326,5,321
17669,9756,10927,0,0,8741,,,,,,1,1,1.852990954,4300,2118,1913,205,1,204
17669,9652,10892,0,0,24221,,,,,,1,1,5.014049363,12327,5801,5509,292,0,292
17669,10249,10018,0,4,36896,,,,,,1,1,7.913221037,18746,8927,8631,296,2,294
17669,9281,11282,0,0,1861,,,,,,1,1,0.421112884,814,461,336,125,0,125
17669,10788,9178,0,3,36172,,,,,,1,1,7.470980737,18567,8642,8321,321,9,312
17669,9437,11198,0,0,7617,,,,,,1,1,1.782561416,3579,1916,1710,206,0,206
17669,11280,9568,0,0,3189,,,,,,1,1,0.642992765,1412,810,653,157,0,157
17669,10848,9741,0,0,1149,,,,,,1,1,0.24007885,438,301,192,109,0,109
17669,9830,10828,2,0,33968,,,,,,1,1,6.991976033,18292,7694,7406,288,4,284
17669,9587,8730,0,0,37319,,,,,,1,1,7.695916056,19015,9007,8717,290,3,287
17669,9738,10834,2,1,16663,,,,,,1,1,3.421436418,8203,4101,3843,258,6,252
17669,10137,10419,2,2,3757,,,,,,1,1,0.781756856,1740,928,767,161,0,161
17669,10689,8501,2,0,35976,,,,,,1,1,7.377739262,18824,8444,8180,264,2,262
17669,10295,10299,0,0,4074,,,,,,1,1,0.840160403,1848,1030,864,166,1,165
17669,9070,9613,1,0,36581,,,,,,1,1,7.727903211,19131,8572,8266,306,4,302
17669,10328,9710,0,0,37668,,,,,,1,1,7.764064397,19095,9134,8829,305,5,300
17669,10357,10398,2,3,3263,,,,,,1,1,0.669854654,1497,807,655,152,0,152
17669,9831,10774,2,0,1948,,,,,,1,1,0.404160111,838,489,357,132,0,132
17669,10407,10170,0,0,3764,,,,,,1,1,0.767681088,1749,931,778,153,0,153
17669,10850,9739,0,0,1059,,,,,,1,1,0.241470698,413,277,185,92,0,92
17669,10044,10635,2,0,985,,,,,,1,1,0.207250866,362,264,169,95,0,95
17669,9154,10978,0,0,37599,,,,,,1,1,7.587967067,18995,9149,8843,306,2,304
17669,10299,10253,0,0,5335,,,,,,1,1,1.085923675,2518,1309,1110,199,0,199
17669,8993,10510,0,3,38497,,,,,,1,1,7.927554232,19354,9423,9126,297,1,296
17669,10001,10400,2,0,37639,,,,,,1,1,7.919330509,19007,9157,8839,318,0,318
17669,10092,9487,3,0,36069,,,,,,1,1,8.304132664,18679,8559,8287,272,1,271
17669,11244,9642,0,0,3759,,,,,,1,1,0.765194807,1677,949,765,184,0,184
17669,10499,10299,0,2,5341,,,,,,1,1,1.094113609,2527,1315,1131,184,2,182
17669,10013,10479,0,2,35787,,,,,,1,1,7.489298615,18417,8522,8196,326,4,322
17669,9925,10627,0,0,1894,,,,,,1,1,0.390395647,810,478,350,128,0,128
17669,10687,10116,0,0,1445,,,,,,1,1,0.311032295,576,373,250,123,0,123
17669,10090,10447,0,0,37714,,,,,,1,1,7.9505670859999995,18918,9229,8891,338,4,334
17669,9167,11379,0,2,9371,,,,,,1,1,1.8905943010000001,4459,2337,2099,238,4,234
17669,10102,10412,0,0,36674,,,,,,1,1,7.550106704,19076,8658,8376,282,1,281
17669,9504,10335,0,0,36065,,,,,,1,1,7.304381724,18896,8417,8082,335,1,334
17669,9465,11079,0,0,3817,,,,,,1,1,0.791018003,1716,957,770,187,0,187
17669,10578,9485,4,2,36989,,,,,,1,1,7.658454541,18996,8843,8536,307,5,302
17669,9294,9708,0,3,37104,,,,,,1,1,7.6741869000000005,19169,8828,8549,279,5,274
17669,10787,10002,0,2,16841,,,,,,1,1,3.568956322,8588,3987,3708,279,2,277
17669,11154,9390,0,2,16175,,,,,,1,1,3.308722339,8146,3887,3632,255,0,255
17669,8946,9186,0,0,36735,,,,,,1,1,7.699578172,19040,8730,8495,235,2,233
17669,10975,9570,2,2,3817,,,,,,1,1,0.775761481,1693,974,798,176,2,174
17669,10296,10256,0,0,8182,,,,,,1,1,1.716867969,3908,2026,1804,222,0,222
17669,9223,11321,0,0,1966,,,,,,1,1,0.418693285,824,508,382,126,2,124
17669,9693,11006,0,2,24348,,,,,,1,1,4.94258171,12633,5716,5433,283,4,279
17669,9412,11405,2,0,1845,,,,,,1,1,0.376392731,740,482,341,141,1,140
17669,9998,9898,0,0,35967,,,,,,1,1,7.315425396,18724,8479,8194,285,4,281
17669,10569,10069,0,0,7383,,,,,,1,1,1.496488898,3617,1781,1577,204,1,203
17669,9466,9714,0,0,37871,,,,,,1,1,7.74914955,19164,9188,8857,331,0,331
17669,9917,10627,0,0,10958,,,,,,1,1,2.219602564,5383,2675,2450,225,2,223
17669,10708,9802,3,2,36481,,,,,,1,1,7.411949994,18430,8874,8571,303,7,296
17669,10766,10079,0,0,1014,,,,,,1,1,0.211242047,418,251,157,94,0,94
17669,10431,10124,0,0,1841,,,,,,1,1,0.376747704,740,484,351,133,0,133
17669,9782,10763,0,0,7195,,,,,,1,1,1.5182672130000001,3535,1737,1551,186,1,185
17669,9996,10640,0,2,7668,,,,,,1,1,1.618572439,3729,1853,1620,233,0,233
17669,9210,11338,0,0,1104,,,,,,1,1,0.241233404,446,277,173,104,0,104
17669,10536,10008,2,2,3245,,,,,,1,1,0.701486294,1484,799,636,163,1,162
17669,10382,10026,0,0,37202,,,,,,1,1,7.550196461,18866,9009,8691,318,2,316
17669,9836,10897,2,0,1269,,,,,,1,1,0.261299117,496,328,211,117,0,117
17669,10385,10336,0,2,3375,,,,,,1,1,0.793784779,1557,834,684,150,0,150
17669,10741,10071,0,0,2457,,,,,,1,1,0.523770961,1016,650,509,141,0,141
17669,8287,11605,0,2,36770,,,,,,1,1,7.549087717,18766,8849,8543,306,7,299
17669,9780,10778,0,0,4117,,,,,,1,1,0.838194919,1890,1018,827,191,0,191
17669,10570,9536,2,2,37947,,,,,,1,1,7.6176764729999995,19131,9245,8919,326,2,324
17669,10916,9003,0,0,36569,,,,,,1,1,7.5092267150000005,18837,8725,8443,282,2,280
17669,9563,11298,0,4,4043,,,,,,1,1,0.817546199,1832,1018,843,175,10,165
17669,10231,10371,0,3,7146,,,,,,1,1,1.491151131,3561,1686,1473,213,0,213
17669,11103,9504,0,0,1112,,,,,,1,1,0.233418106,469,267,158,109,0,109
17669,8674,11416,0,2,37690,,,,,,1,1,7.744482815,19053,9160,8843,317,6,311
17669,11192,9383,0,0,2190,,,,,,1,1,0.444524191,997,529,394,135,0,135
17669,11503,9270,0,2,29226,,,,,,1,1,5.9586132769999995,15302,6836,6584,252,4,248
17669,10354,10191,0,0,5976,,,,,,1,1,1.357516075,2908,1447,1273,174,0,174
17669,9441,11135,0,0,10213,,,,,,1,1,2.090633759,5067,2458,2228,230,1,229
17669,9560,9700,0,2,37094,,,,,,1,1,7.6458659220000005,18993,8900,8599,301,13,288
17669,9690,10568,4,0,35287,,,,,,1,1,7.289322642,18298,8349,8058,291,1,290
17669,10225,10356,0,0,2231,,,,,,1,1,0.493118634,969,553,397,156,0,156
17669,10611,9278,2,0,35267,,,,,,1,1,7.73598611,18625,8188,7922,266,4,262
17669,9504,11221,2,0,15429,,,,,,1,1,3.130510144,7952,3626,3401,225,0,225
17669,10338,10359,2,0,2193,,,,,,1,1,0.461721539,968,538,389,149,0,149
17669,11036,9511,0,0,3720,,,,,,1,1,0.826635414,1640,959,797,162,0,162
17669,10194,10353,0,0,2678,,,,,,1,1,0.550463388,1207,665,524,141,0,141
17669,9843,10708,2,0,3066,,,,,,1,1,0.665676403,1362,779,633,146,1,145
17669,9393,7828,0,0,38346,,,,,,1,1,8.002215754,19363,9355,9082,273,3,270
17669,8957,10269,0,0,36471,,,,,,1,1,7.56614817,18870,8646,8337,309,2,307
17669,9801,10748,0,0,2012,,,,,,1,1,0.413353027,827,522,381,141,0,141
17669,9539,11017,0,0,2138,,,,,,1,1,0.452285769,952,522,380,142,0,142
17669,10838,9708,0,2,14113,,,,,,1,1,3.409240404,7011,3425,3173,252,5,247
17669,10448,9439,0,0,35478,,,,,,1,1,7.438483069,18427,8394,8131,263,0,263
17669,9816,10912,0,0,16854,,,,,,1,1,3.783834501,8468,4066,3812,254,3,251
17669,10904,9645,0,2,7500,,,,,,1,1,1.549939965,3628,1823,1597,226,2,224
17669,9614,10931,0,0,17062,,,,,,1,1,3.682007447,8358,4232,3992,240,0,240
17669,10038,10538,0,2,1368,,,,,,1,1,0.308169411,507,373,258,115,0,115
17669,10653,9786,2,0,37835,,,,,,1,1,7.789628882,18985,9264,8942,322,8,314
17669,10931,9615,0,0,3412,,,,,,1,1,0.723869387,1579,832,663,169,0,169
17669,9471,10492,2,2,36947,,,,,,1,1,7.60638231,18829,8905,8597,308,1,307
17669,9686,11210,0,0,4104,,,,,,1,1,0.89278545,1962,976,786,190,1,189
17669,10180,10603,0,2,20730,,,,,,1,1,4.443792113,10772,4847,4583,264,2,262
17669,8118,11337,0,3,39158,,,,,,1,1,8.135386627,19435,9701,9380,321,6,315
17669,10983,9669,0,0,4938,,,,,,1,1,1.020851456,2293,1229,1042,187,2,185
17669,10548,9996,0,0,13854,,,,,,1,1,2.899235567,7015,3297,3052,245,0,245
17669,9383,11363,0,2,16139,,,,,,1,1,3.835710748,8269,3811,3563,248,2,246
17669,10775,9769,0,0,6758,,,,,,1,1,1.7424317550000001,3241,1660,1463,197,0,197
17669,10097,10449,0,0,1836,,,,,,1,1,0.377589167,782,463,335,128,0,128
17669,9845,10711,0,0,3262,,,,,,1,1,0.659395644,1461,816,647,169,1,168
17669,9877,10511,0,0,36359,,,,,,1,1,7.473974951,18866,8609,8334,275,1,274
17669,11088,9458,0,0,5625,,,,,,1,1,1.13121117,2685,1373,1179,194,0,194
17669,10030,10514,0,0,705,,,,,,1,1,0.150481449,232,194,109,85,0,85
17669,9405,11141,0,2,8762,,,,,,1,1,1.878698606,4398,2085,1891,194,2,192
17669,8555,10889,0,0,37428,,,,,,1,1,8.176330236,19068,9013,8679,334,10,324
17669,10459,9714,0,0,35229,,,,,,1,1,7.585712632,18142,8402,8119,283,1,282
17669,9359,11202,2,0,4914,,,,,,1,1,0.99263995,2261,1235,1052,183,0,183
17669,9597,11174,0,0,1308,,,,,,1,1,0.272241716,575,306,185,121,0,121
17669,10302,10248,2,2,7935,,,,,,1,1,1.62632148,3851,1943,1745,198,2,196
17669,10349,10222,2,0,3820,,,,,,1,1,0.775892925,1814,928,778,150,0,150
17669,9912,10667,2,0,13764,,,,,,1,1,2.917731652,6829,3337,3076,261,1,260
17669,9047,10326,0,0,35832,,,,,,1,1,7.610253483,18396,8573,8283,290,0,290
17669,10847,9700,0,0,9227,,,,,,1,1,1.873271177,4649,2178,1956,222,0,222
17669,9890,10674,0,2,2117,,,,,,1,1,0.432278087,906,537,400,137,0,137
17669,9838,9070,2,2,35735,,,,,,1,1,7.3668333409999995,18687,8388,8116,272,13,259
17669,8175,11577,2,5,35947,,,,,,1,1,7.452204089,18539,8563,8281,282,7,275
17669,9312,9402,0,4,36307,,,,,,1,1,7.735505075,19225,8416,8166,250,1,249
17669,10748,9999,2,2,10062,,,,,,1,1,2.044331067,4867,2481,2248,233,0,233
17669,10216,10330,0,0,9172,,,,,,1,1,1.833589277,4424,2264,2044,220,0,220
17669,10267,10312,0,0,2356,,,,,,1,1,0.480405265,1036,581,423,158,0,158
17669,9668,10712,4,0,38612,,,,,,1,1,7.891592557,19158,9562,9232,330,12,318
17669,11685,8869,0,0,1621,,,,,,1,1,0.329573391,666,415,290,125,0,125
17669,10729,9826,4,0,1356,,,,,,1,1,0.278654938,531,349,222,127,0,127
17669,10296,10494,0,0,3363,,,,,,1,1,0.74221652,1497,860,714,146,0,146
17669,10306,9920,0,0,35507,,,,,,1,1,7.602044503,18580,8311,8006,305,6,299
17669,10341,10203,0,2,22914,,,,,,1,1,4.871599707,11620,5520,5266,254,2,252
17669,10683,9508,0,2,35992,,,,,,1,1,7.4755339769999996,18799,8445,8142,303,0,303
17669,10401,10144,0,0,10387,,,,,,1,1,2.299944124,5069,2534,2284,250,0,250
17669,9572,9736,0,0,38843,,,,,,1,1,8.278137679,19413,9559,9247,312,4,308
17669,9020,11525,0,4,8722,,,,,,1,1,1.9885664840000001,4329,2080,1847,233,6,227
17669,10338,10302,0,2,3429,,,,,,1,1,0.74854625,1569,847,681,166,1,165
17669,10201,10721,0,2,7947,,,,,,1,1,1.680354983,3928,1901,1684,217,0,217
17669,10322,10394,1,1,24349,,,,,,1,1,5.322551723,12313,5884,5616,268,2,266
17669,10934,9624,0,0,2465,,,,,,1,1,0.49744408,1050,630,475,155,0,155
17669,10280,9746,0,2,36670,,,,,,1,1,7.826497562,18802,8792,8508,284,2,282
17669,10113,10489,2,0,11908,,,,,,1,1,2.763964844,6011,2828,2587,241,1,240
17669,9712,11122,0,0,2753,,,,,,1,1,0.570933167,1292,655,504,151,0,151
17669,10163,10381,0,1,31716,,,,,,1,1,6.857839166,16368,7509,7179,330,0,330
17669,10364,10212,0,0,3445,,,,,,1,1,0.753718776,1492,894,729,165,0,165
17669,10592,9509,2,0,36399,,,,,,1,1,7.795556664,18727,8685,8383,302,5,297
17669,10544,8425,0,0,35856,,,,,,1,1,7.76746234,18326,8632,8366,266,8,258
17669,9553,11038,0,2,900,,,,,,1,1,0.191206234,310,244,142,102,0,102
17669,10824,9727,0,2,1478,,,,,,1,1,0.338689106,605,381,270,111,1,110
17669,9823,10518,0,0,33620,,,,,,1,1,7.373185453,17883,7727,7444,283,1,282
17669,9485,9459,2,0,37102,,,,,,1,1,7.762767651,18830,9006,8746,260,2,258
17669,9712,10758,1,2,36854,,,,,,1,1,7.792517666,18973,8802,8525,277,4,273
17669,10361,8125,0,0,37477,,,,,,1,1,8.37507139,19179,9022,8768,254,2,252
17669,9973,9138,4,0,35571,,,,,,1,1,7.763190337,18348,8477,8208,269,2,267
17669,9741,10908,0,0,1540,,,,,,1,1,0.382772903,663,388,287,101,0,101
17669,10817,10032,2,0,29490,,,,,,1,1,6.014954718,14931,7123,6810,313,2,311
17669,10057,10487,4,0,4636,,,,,,1,1,1.026540161,2143,1153,966,187,2,185
17669,9782,10858,4,0,3281,,,,,,1,1,0.750115491,1520,802,645,157,1,156
17669,9543,9257,0,0,36617,,,,,,1,1,7.977464603,18765,8779,8485,294,2,292
17669,9583,10977,0,0,3553,,,,,,1,1,0.906758769,1603,887,711,176,0,176
17669,9152,11611,0,0,3720,,,,,,1,1,0.833660835,1746,899,723,176,1,175
17669,10259,10149,3,2,34984,,,,,,1,1,7.542019937,18248,8237,7975,262,2,260
17669,9628,9453,0,2,37042,,,,,,1,1,8.000768868,19110,8824,8540,284,2,282
17669,10351,10193,2,0,10359,,,,,,1,1,2.429439892,5082,2528,2307,221,0,221
17669,9102,10464,0,2,37840,,,,,,1,1,8.66303282,19065,9242,8951,291,2,289
17669,9601,10946,0,3,5876,,,,,,1,1,1.3622170279999999,2760,1465,1279,186,1,185
17669,9329,10272,2,0,36943,,,,,,1,1,8.03094446,19180,8735,8442,293,1,292
17669,8578,9491,0,2,37955,,,,,,1,1,7.813686928,19047,9313,9031,282,3,279
17669,10066,10478,2,2,6115,,,,,,1,1,1.4166391759999999,2853,1518,1292,226,6,220
17669,11151,9556,0,0,2747,,,,,,1,1,0.750564206,1247,678,534,144,0,144
17669,10446,9804,2,0,37261,,,,,,1,1,7.970917873,19092,8934,8633,301,5,296
17669,9568,10977,0,0,4753,,,,,,1,1,1.069002297,2248,1159,972,187,0,187
17669,9775,10021,0,0,34519,,,,,,1,1,7.894389589,18073,8082,7800,282,5,277
17669,9965,10662,0,0,1947,,,,,,1,1,0.444473322,781,511,367,144,2,142
17669,10703,9869,2,0,1468,,,,,,1,1,0.367019044,635,362,253,109,0,109
17669,10113,10431,0,0,10498,,,,,,1,1,2.199580032,5078,2585,2335,250,0,250
17669,9291,11253,0,0,4689,,,,,,1,1,1.071235386,2264,1119,932,187,0,187
17669,9797,11127,0,2,10769,,,,,,1,1,2.469003313,5291,2623,2391,232,0,232
17669,10316,10228,0,0,2092,,,,,,1,1,0.481501519,890,529,385,144,0,144
17669,9207,10964,0,2,35215,,,,,,1,1,7.80968893,18266,8329,8038,291,3,288
17669,9377,11126,0,0,36380,,,,,,1,1,7.887822027,18628,8736,8456,280,2,278
17669,9580,11172,0,2,3877,,,,,,1,1,0.775973667,1802,948,769,179,0,179
17669,10569,9991,0,0,1672,,,,,,1,1,0.374867623,704,428,316,112,0,112
17669,10756,9789,0,0,17306,,,,,,1,1,3.505219296,8602,4216,3944,272,0,272
17669,10708,9109,6,4,35223,,,,,,1,1,7.797061422,18067,8443,8173,270,7,263
17669,9932,10621,2,0,2149,,,,,,1,1,0.474754444,898,558,423,135,1,134
17669,9712,7907,0,0,38635,,,,,,1,1,8.722945433,19756,9313,9060,253,0,253
17669,9713,10946,0,0,1523,,,,,,1,1,0.406521603,616,395,278,117,0,117
17669,9662,10962,0,0,712,,,,,,1,1,0.157923164,240,191,101,90,0,90
17669,10154,10162,0,0,35034,,,,,,1,1,8.512113585,18075,8334,8043,291,1,290
17669,10024,8202,2,0,37938,,,,,,1,1,8.419301893,19356,9152,8874,278,8,270
17669,8617,10954,0,0,36548,,,,,,1,1,8.170748667,18852,8697,8395,302,0,302
17669,10327,10325,4,4,31679,,,,,,1,1,7.091396591,16226,7585,7302,283,1,282
17669,9328,10888,0,4,35840,,,,,,1,1,8.601289234,18544,8509,8231,278,0,278
17669,11483,9075,0,0,6413,,,,,,1,1,1.321310515,2946,1628,1417,211,1,210
17669,10331,10245,0,0,2033,,,,,,1,1,0.46171994,826,533,392,141,0,141
17669,10801,9932,0,4,34847,,,,,,1,1,8.052638568,18254,8164,7899,265,2,263
17669,9720,10825,0,0,27361,,,,,,1,1,6.3424940450000005,13599,6732,6434,298,2,296
17669,9484,11080,1,2,25850,,,,,,1,1,5.891437981,13075,6246,5963,283,0,283
17669,10738,9025,4,0,34824,,,,,,1,1,9.010892946,18448,8041,7747,294,6,288
17669,10687,9102,0,0,36373,,,,,,1,1,8.807007452,18543,8771,8483,288,3,285
17669,9379,9695,2,2,36941,,,,,,1,1,8.427967757,19051,8798,8504,294,9,285
17669,10736,9657,2,2,35470,,,,,,1,1,7.967646326,18370,8400,8100,300,3,297
17669,10986,9771,0,0,9057,,,,,,1,1,1.843325467,4535,2144,1910,234,0,234
17669,9532,11027,0,0,3705,,,,,,1,1,0.775306961,1778,881,716,165,0,165
17669,11187,9357,0,2,26595,,,,,,1,1,5.839423035,13869,6221,5937,284,8,276
17669,10642,10216,0,0,1559,,,,,,1,1,0.361750068,671,385,267,118,0,118
17669,9747,10801,0,0,6318,,,,,,1,1,1.347331724,3056,1531,1331,200,0,200
17669,9717,11057,2,0,4906,,,,,,1,1,1.017518129,2261,1227,1036,191,0,191
17669,9576,10267,2,0,35983,,,,,,1,1,7.645028065,18836,8431,8146,285,5,280
17669,10223,8637,0,0,38198,,,,,,1,1,8.401617198,19448,9214,8892,322,1,321
17669,8873,9408,1,2,37335,,,,,,1,1,7.900368519,19244,8917,8660,257,1,256
17669,9807,10785,1,2,7253,,,,,,1,1,1.506708977,3590,1744,1569,175,4,171
17669,9211,10362,2,0,37856,,,,,,1,1,8.083924098,19163,9199,8904,295,2,293
17669,10016,10530,0,0,7062,,,,,,1,1,1.432218376,3369,1741,1530,211,0,211
17669,10007,10547,2,0,5496,,,,,,1,1,1.112823953,2650,1334,1156,178,4,174
17669,9642,9345,0,0,36689,,,,,,1,1,7.806642947,19026,8694,8419,275,3,272
17669,10333,10046,2,0,34867,,,,,,1,1,7.96364894,18243,8153,7835,318,10,308
17669,10347,8033,0,0,38104,,,,,,1,1,8.666574005,19554,9143,8879,264,5,259
17669,10598,9623,0,0,34943,,,,,,1,1,7.344212879,18411,8111,7801,310,2,308
17669,9667,9498,0,4,36513,,,,,,1,1,7.676681207,18995,8614,8324,290,0,290
17669,8137,10095,2,0,36544,,,,,,1,1,8.647068219,19153,8558,8283,275,6,269
17669,9166,11393,0,0,1909,,,,,,1,1,0.390867345,802,480,333,147,0,147
17669,10310,10585,0,0,12694,,,,,,1,1,2.578039096,6318,3062,2810,252,2,250
17669,9784,10964,0,2,3069,,,,,,1,1,0.621695731,1379,774,632,142,0,142
17669,10216,10549,2,0,2961,,,,,,1,1,0.599685523,1320,736,567,169,1,168
17669,10991,9575,4,0,6464,,,,,,1,1,1.331535385,3196,1534,1334,200,3,197
17669,10872,9909,2,2,1616,,,,,,1,1,0.332954155,686,403,279,124,1,123
17669,10565,10119,0,2,7691,,,,,,1,1,1.600169878,3711,1886,1678,208,2,206
17669,9222,11323,0,0,10749,,,,,,1,1,2.181012503,5205,2638,2370,268,1,267
17669,9859,10696,0,0,5893,,,,,,1,1,1.20919784,2824,1447,1272,175,2,173
17669,9843,9819,7,0,35862,,,,,,1,1,7.53958469,18274,8656,8380,276,7,269
17669,8779,9262,0,3,38852,,,,,,1,1,8.205171414,19527,9531,9268,263,1,262
17669,11099,8953,2,0,36305,,,,,,1,1,7.446046542,18864,8575,8284,291,1,290
17669,8481,10554,0,0,37539,,,,,,1,1,7.791206781,18914,9164,8867,297,2,295
17669,10588,9348,4,2,38620,,,,,,1,1,7.822691289,19546,9369,9033,336,5,331
17669,10152,10133,0,2,36143,,,,,,1,1,7.7798932579999995,18684,8573,8260,313,3,310
17669,10780,9792,2,2,26184,,,,,,1,1,5.406641679,13457,6224,5945,279,4,275
17669,10567,9137,5,0,37638,,,,,,1,1,7.759109326,19179,9077,8772,305,12,293
17669,8687,10486,0,2,37972,,,,,,1,1,7.690881195,18991,9341,9042,299,3,296
17669,10009,10612,5,2,23860,,,,,,1,1,4.960434484,12339,5631,5372,259,7,252
17669,10514,10063,0,2,2046,,,,,,1,1,0.416074715,897,509,378,131,0,131
17669,8567,10821,2,0,38832,,,,,,1,1,7.957227299,19235,9650,9353,297,5,292
17669,10745,9820,0,0,3509,,,,,,1,1,0.718081349,1577,880,708,172,1,171
17669,10378,9698,0,0,36868,,,,,,1,1,7.596889659,19079,8741,8434,307,0,307
17669,10943,9899,0,0,5291,,,,,,1,1,1.069340206,2534,1281,1086,195,0,195
17669,10444,10387,0,0,17730,,,,,,1,1,3.635546025,8880,4299,4047,252,1,251
17669,8604,10786,0,0,35077,,,,,,1,1,7.41150857,18299,8252,7978,274,2,272
17669,9771,8009,0,0,38454,,,,,,1,1,7.887561581,19640,9277,9017,260,3,257
17669,9830,10720,0,0,6699,,,,,,1,1,1.360096048,3168,1652,1425,227,0,227
17669,9136,9123,2,1,38772,,,,,,1,1,7.973783851,19806,9343,9063,280,5,275
17669,9721,9170,2,0,36840,,,,,,1,1,7.683952272,19080,8742,8466,276,10,266
17669,10534,9451,6,0,35967,,,,,,1,1,7.248547574,18714,8494,8229,265,1,264
17669,10967,8778,0,0,36846,,,,,,1,1,7.605119456,18986,8778,8474,304,1,303
17669,9926,10618,0,0,26980,,,,,,1,1,5.618037223,13849,6415,6114,301,3,298
17669,9298,11490,0,2,873,,,,,,1,1,0.184309198,320,232,143,89,0,89
17669,10476,10106,0,0,3131,,,,,,1,1,0.636989935,1406,784,627,157,0,157
17669,9352,10099,2,0,36199,,,,,,1,1,7.329995533,18720,8594,8303,291,5,286
17669,10628,9925,0,0,1754,,,,,,1,1,0.360721827,689,470,345,125,1,124
17669,10780,8820,2,0,36378,,,,,,1,1,7.846530556,18997,8537,8230,307,1,306
17669,10204,10221,0,0,35241,,,,,,1,1,7.320471223,18365,8300,8024,276,4,272
17669,10197,10371,4,0,5420,,,,,,1,1,1.101337789,2569,1328,1133,195,5,190
17669,10079,10478,0,0,2700,,,,,,1,1,0.551924102,1235,659,512,147,1,146
17669,9881,10751,0,2,2286,,,,,,1,1,0.466011336,1007,568,425,143,2,141
17669,11324,9101,3,0,36963,,,,,,1,1,7.658021069,18994,8839,8548,291,0,291
17669,10013,10124,0,2,36985,,,,,,1,1,7.579826862,18941,8870,8566,304,2,302
17669,10744,9572,2,0,38728,,,,,,1,1,7.89556729,19145,9623,9286,337,9,328
17669,10555,10334,0,0,2206,,,,,,1,1,0.450666521,972,548,410,138,0,138
17669,10823,9793,0,0,6805,,,,,,1,1,1.3894977,3355,1635,1455,180,0,180
17669,10701,10152,0,0,1543,,,,,,1,1,0.337798847,608,408,289,119,0,119
17669,10784,9777,0,0,1594,,,,,,1,1,0.330275922,635,413,280,133,0,133
17669,10726,10133,3,0,30579,,,,,,1,1,6.209919702,15750,7269,6978,291,7,284
17669,10576,9802,1,0,35067,,,,,,1,1,7.139458193,18365,8206,7916,290,1,289
17669,10703,9337,0,2,37167,,,,,,1,1,7.610618363,18918,8966,8649,317,8,309
17669,10473,10149,2,0,11616,,,,,,1,1,2.37354985,5766,2810,2580,230,0,230
17669,9878,10271,0,0,36230,,,,,,1,1,7.333784677,18759,8589,8296,293,2,291
17669,9748,9048,0,4,35842,,,,,,1,1,7.309073446,18941,8308,8023,285,13,272
17669,7844,10127,0,2,37693,,,,,,1,1,7.618341342,19272,9078,8813,265,1,264
17669,9505,11389,0,0,2545,,,,,,1,1,0.517667609,1104,642,485,157,0,157
17669,9429,9791,5,0,35163,,,,,,1,1,7.335635141,18110,8392,8123,269,1,268
17669,10341,10446,2,0,3768,,,,,,1,1,0.764270893,1725,933,756,177,0,177
17669,9776,10805,0,0,1636,,,,,,1,1,0.356883768,688,418,306,112,0,112
17669,10159,10508,2,0,12615,,,,,,1,1,2.630118231,6328,3020,2773,247,2,245
17669,10407,9901,0,0,36604,,,,,,1,1,7.604259685,18883,8706,8397,309,1,308
17669,11337,8526,2,1,37396,,,,,,1,1,7.669906186,18919,9094,8805,289,2,287
17669,10293,10586,0,0,4064,,,,,,1,1,0.824753158,1877,1004,825,179,0,179
17669,9510,10899,0,0,37126,,,,,,1,1,7.560918,18874,8978,8682,296,2,294
17669,9812,9487,0,2,36529,,,,,,1,1,7.464175608,18661,8795,8517,278,2,276
17669,11002,9677,0,0,2364,,,,,,1,1,0.566354374,1076,573,431,142,0,142
17669,10117,10427,0,0,19680,,,,,,1,1,4.154233403,9947,4742,4493,249,0,249
17669,9940,9956,0,0,36872,,,,,,1,1,7.719489483,18698,8928,8610,318,2,316
17669,10554,9409,2,2,38314,,,,,,1,1,7.754568927,19350,9332,9032,300,12,288
17669,10017,10096,0,4,38424,,,,,,1,1,7.8165629800000005,19690,9223,8935,288,0,288
17669,9717,9993,0,2,35348,,,,,,1,1,7.175893029,18370,8344,8054,290,2,288
17669,9404,11104,0,0,35790,,,,,,1,1,7.317840421,18576,8445,8121,324,1,323
17669,9319,10977,0,4,36482,,,,,,1,1,7.421830565,19012,8583,8279,304,3,301
17669,9943,10603,0,4,2838,,,,,,1,1,0.578364506,1292,700,554,146,2,144
17669,10356,10543,0,0,6963,,,,,,1,1,1.401600305,3297,1725,1509,216,1,215
17669,10039,10231,4,0,36573,,,,,,1,1,7.393819383,18898,8697,8416,281,0,281
17669,10234,9841,2,0,37569,,,,,,1,1,7.81962013,19215,9019,8703,316,9,307
17669,10750,9836,0,3,11032,,,,,,1,1,2.329295173,5505,2653,2432,221,1,220
17669,11247,9480,0,2,6957,,,,,,1,1,1.4325505459999999,3243,1746,1524,222,1,221
17669,10792,9939,0,2,34739,,,,,,1,1,7.146726804,18366,8031,7720,311,0,311
17669,10777,9572,0,0,35430,,,,,,1,1,7.356838399,18427,8347,8038,309,4,305
17669,10904,9642,0,0,13164,,,,,,1,1,2.775526991,6298,3306,3052,254,3,251
17669,10586,9600,0,0,35512,,,,,,1,1,7.341607768,18694,8251,7935,316,3,313
17669,10825,9891,0,0,10421,,,,,,1,1,2.158430127,5343,2428,2206,222,1,221
17669,10521,9685,0,0,36418,,,,,,1,1,7.586759365,18476,8819,8515,304,4,300
17669,11125,8668,2,2,36412,,,,,,1,1,7.471353437,18916,8596,8292,304,4,300
17669,10566,9857,2,0,35542,,,,,,1,1,7.371769702,18384,8428,8126,302,2,300
17669,9280,10307,0,4,38360,,,,,,1,1,7.916124067,19244,9418,9138,280,3,277
17669,9261,11414,0,4,4353,,,,,,1,1,1.033195223,2007,1087,915,172,6,166
17669,8962,10956,0,0,38095,,,,,,1,1,7.942922516,18913,9439,9135,304,1,303
17669,9947,10614,0,0,1504,,,,,,1,1,0.311722848,633,379,266,113,0,113
17669,9274,10514,0,2,35952,,,,,,1,1,7.613158541,18463,8604,8323,281,2,279
17669,10923,9583,0,0,36983,,,,,,1,1,7.943885798,18890,8888,8571,317,0,317
17669,10743,9988,0,0,6321,,,,,,1,1,1.345329716,3141,1495,1305,190,0,190
17669,10382,9607,2,0,35835,,,,,,1,1,7.4308464690000005,18714,8405,8094,311,2,309
17669,9781,10426,0,0,36324,,,,,,1,1,7.657321251,18594,8710,8400,310,0,310
17669,10352,10312,5,0,33879,,,,,,1,1,7.08801616,16981,8300,8002,298,5,293
17669,9389,11163,0,0,5998,,,,,,1,1,1.207520065,2854,1467,1257,210,0,210
17669,9894,10428,0,0,36928,,,,,,1,1,7.845866663,18496,9065,8763,302,3,299
17669,9694,10179,0,0,37779,,,,,,1,1,8.013841405,19294,9096,8803,293,2,291
17669,10140,10405,0,0,2266,,,,,,1,1,0.5334886,984,575,443,132,0,132
17669,10321,10308,3,0,7679,,,,,,1,1,1.5981953899999999,3711,1881,1675,206,0,206
17669,10253,10297,0,0,5357,,,,,,1,1,1.178170505,2521,1317,1115,202,0,202
17669,11050,9175,1,0,35011,,,,,,1,1,7.323375984,18330,8199,7916,283,3,280
17669,9641,10930,0,0,1838,,,,,,1,1,0.389595742,769,468,335,133,0,133
17669,9040,11463,0,0,35055,,,,,,1,1,7.287009745,18480,8134,7827,307,8,299
17669,9900,10264,2,0,35853,,,,,,1,1,7.744797698,18335,8614,8324,290,0,290
17669,10713,9239,0,0,35905,,,,,,1,1,7.492015445,18710,8449,8152,297,4,293
17669,8881,10197,0,0,39463,,,,,,1,1,8.185825169,19972,9597,9300,297,0,297
17669,10063,10085,2,2,37547,,,,,,1,1,7.900882319,19175,9018,8682,336,9,327
17669,10234,10325,0,0,2803,,,,,,1,1,0.632730574,1254,699,548,151,0,151
17669,9717,11017,0,0,2997,,,,,,1,1,0.619338414,1233,800,636,164,2,162
17669,9518,11029,0,0,6863,,,,,,1,1,1.496373975,3184,1736,1529,207,0,207
17669,9953,10013,0,5,37692,,,,,,1,1,8.050802844,19270,9046,8716,330,5,325
17669,10443,10116,0,0,2936,,,,,,1,1,0.633791177,1372,713,575,138,0,138
17669,10480,10148,0,2,6366,,,,,,1,1,1.289045185,3019,1575,1378,197,4,193
17669,10170,10385,2,2,1916,,,,,,1,1,0.431236238,822,483,355,128,0,128
17669,11096,9449,2,0,4962,,,,,,1,1,1.145088978,2241,1265,1074,191,0,191
17669,10977,9567,0,0,10913,,,,,,1,1,2.329071716,5541,2577,2359,218,1,217
17669,11559,8985,0,1,26976,,,,,,1,1,5.63739109,13480,6583,6253,330,1,329
17669,9851,10557,2,0,35264,,,,,,1,1,7.229844969,18354,8322,8056,266,0,266
17669,10162,8765,2,0,35297,,,,,,1,1,7.496507327,18280,8373,8102,271,4,267
17669,10293,9605,0,2,37752,,,,,,1,1,8.380812179,19309,9067,8758,309,14,295
17669,7981,8355,0,0,39459,,,,,,1,1,8.256272065,19977,9612,9354,258,2,256
17669,10628,9922,0,0,4546,,,,,,1,1,0.931849983,2103,1135,962,173,2,171
17669,10242,10390,0,0,11689,,,,,,1,1,2.594058574,5800,2830,2601,229,1,228
17669,10515,10029,3,2,20520,,,,,,1,1,4.205712265,10216,5010,4726,284,1,283
17669,9538,11295,0,2,2390,,,,,,1,1,0.496164969,1011,622,487,135,0,135
17669,10613,9941,2,0,1626,,,,,,1,1,0.333600435,688,406,280,126,2,124
17669,10703,9951,0,0,2757,,,,,,1,1,0.564536243,1297,651,493,158,0,158
17669,10022,10527,0,0,5333,,,,,,1,1,1.07800947,2525,1304,1104,200,0,200
17669,9293,11264,2,0,3472,,,,,,1,1,0.707573389,1551,881,722,159,2,157
17669,9106,11016,0,0,36909,,,,,,1,1,7.941516911,18977,8807,8489,318,1,317
17669,10199,10360,2,0,2344,,,,,,1,1,0.485122899,1022,587,439,148,3,145
17669,10219,9006,2,0,34619,,,,,,1,1,7.303064977,18274,8048,7799,249,5,244
17669,10214,9978,0,0,37338,,,,,,1,1,7.798356814,19245,8877,8538,339,2,337
17669,11065,9689,6,2,37129,,,,,,1,1,7.943971654,18960,8942,8657,285,1,284
17669,9259,10218,0,0,37625,,,,,,1,1,7.978300748,19441,8949,8663,286,3,283
17669,10727,9837,0,0,1763,,,,,,1,1,0.362312018,713,458,324,134,0,134
17669,9433,10467,0,0,35686,,,,,,1,1,7.496206497,18308,8536,8230,306,2,304
17669,10393,10501,0,0,4897,,,,,,1,1,1.005514814,2304,1202,1013,189,2,187
17669,9845,10970,2,8,29506,,,,,,1,1,6.049007635,14833,7188,6891,297,10,287
17669,11478,8803,2,0,35222,,,,,,1,1,7.423561191,18210,8354,8050,304,0,304
17669,10374,9215,2,0,38134,,,,,,1,1,7.910179449,19550,9140,8836,304,2,302
17669,9422,11127,2,0,6280,,,,,,1,1,1.273219197,3075,1496,1283,213,0,213
17669,8487,9844,0,3,38556,,,,,,1,1,7.887776627,19492,9380,9076,304,7,297
17669,9182,11590,2,0,8693,,,,,,1,1,1.7595003519999999,4250,2112,1893,219,9,210
17669,11495,9049,2,0,7585,,,,,,1,1,1.532222489,3687,1844,1634,210,2,208
17669,10152,9606,2,1,37095,,,,,,1,1,7.753213068,18930,8926,8613,313,2,311
17669,10068,10476,0,3,30858,,,,,,1,1,6.323205132,15573,7483,7164,319,2,317
17669,9783,10762,0,2,5398,,,,,,1,1,1.094698002,2558,1318,1114,204,3,201
17669,9960,10091,4,2,36528,,,,,,1,1,7.544671243,18670,8790,8512,278,3,275
17669,11248,9326,2,0,2019,,,,,,1,1,0.415616342,861,513,381,132,2,130
17669,10047,10499,0,0,2103,,,,,,1,1,0.429368255,903,531,393,138,0,138
17669,9887,10676,0,0,1198,,,,,,1,1,0.248948855,460,315,207,108,0,108
17669,9920,10975,0,0,2194,,,,,,1,1,0.450100708,947,558,427,131,0,131
17669,9780,10578,1,0,36586,,,,,,1,1,7.578735245,18880,8706,8412,294,2,292
17669,10622,9636,2,2,37579,,,,,,1,1,7.659227192,19342,8978,8697,281,6,275
17669,10547,10002,0,2,5098,,,,,,1,1,1.036596308,2297,1304,1111,193,3,190
17669,11475,9410,4,0,5415,,,,,,1,1,1.148757605,2545,1342,1156,186,2,184
17669,10631,10132,2,0,4744,,,,,,1,1,1.067886093,2317,1125,948,177,1,176
17669,9953,9421,0,0,36122,,,,,,1,1,7.499294713,18809,8521,8250,271,2,269
17669,10111,10436,2,0,11369,,,,,,1,1,2.334852102,5430,2851,2614,237,2,235
17669,10543,10028,0,4,3303,,,,,,1,1,0.841549834,1479,834,678,156,1,155
17669,10945,9599,0,0,9644,,,,,,1,1,1.9610192180000001,4821,2299,2074,225,0,225
17669,10549,9468,2,4,36430,,,,,,1,1,7.611284969,18930,8599,8297,302,4,298
17669,10382,10289,3,0,22263,,,,,,1,1,4.737863585,11047,5464,5176,288,2,286
17669,11429,8548,3,0,36786,,,,,,1,1,7.484226574,18841,8820,8515,305,2,303
17669,11137,9617,0,2,20302,,,,,,1,1,4.136934453,10229,4907,4648,259,1,258
17669,10753,9879,3,0,17271,,,,,,1,1,3.6009033,8740,4125,3844,281,0,281
17669,9339,10759,0,0,35146,,,,,,1,1,7.218149064,18386,8238,7954,284,2,282
17669,12059,8486,0,0,5306,,,,,,1,1,1.109094074,2375,1376,1197,179,0,179
17669,9995,10545,2,2,35759,,,,,,1,1,7.656628915,18552,8455,8158,297,6,291
17669,8085,10256,0,0,36629,,,,,,1,1,7.559960343,18876,8735,8452,283,0,283
17669,10663,9924,0,2,13850,,,,,,1,1,2.910381896,7004,3309,3081,228,2,226
17669,10271,10306,0,0,7627,,,,,,1,1,1.5704864349999998,3750,1832,1619,213,0,213
17669,7951,9949,0,0,38856,,,,,,1,1,8.296383448,19806,9387,9111,276,1,275
17669,10010,10326,0,0,37407,,,,,,1,1,7.766315741,18725,9196,8906,290,0,290
17669,9081,9745,0,2,36084,,,,,,1,1,7.646229714,18436,8687,8413,274,3,271
17669,7595,9782,0,1,39041,,,,,,1,1,8.02111083,19842,9471,9214,257,2,255
17669,9384,11174,0,0,2375,,,,,,1,1,0.484202698,1058,586,441,145,1,144
17669,10624,9935,0,2,29222,,,,,,1,1,6.091739233,14995,6966,6671,295,2,293
17669,10473,10100,0,0,6853,,,,,,1,1,1.3999830100000001,3319,1662,1452,210,0,210
17669,10470,10098,0,0,3326,,,,,,1,1,0.677646434,1523,821,660,161,0,161
17669,9953,10613,0,0,2151,,,,,,1,1,0.441314116,948,527,378,149,0,149
17669,10645,9899,5,0,3764,,,,,,1,1,0.770141322,1691,953,786,167,3,164
17669,9938,10611,2,4,6434,,,,,,1,1,1.351336316,3105,1561,1354,207,6,201
17669,11002,9542,0,0,3509,,,,,,1,1,0.710970914,1550,903,750,153,1,152
17669,10804,9824,0,0,5787,,,,,,1,1,1.171649346,2756,1422,1235,187,2,185
17669,10438,10193,0,0,2729,,,,,,1,1,0.566405008,1247,668,522,146,0,146
17669,8791,11753,0,0,8800,,,,,,1,1,1.805629447,4303,2137,1914,223,2,221
17669,10788,9304,4,2,35488,,,,,,1,1,7.357520639,18424,8397,8127,270,4,266
17669,9833,10711,4,2,9349,,,,,,1,1,1.893186093,4503,2300,2054,246,8,238
17669,11284,9339,0,2,2976,,,,,,1,1,0.623911664,1295,762,605,157,1,156
17669,9018,10203,4,0,38301,,,,,,1,1,8.007254039,19351,9338,9064,274,2,272
17669,10680,9864,0,0,27525,,,,,,1,1,5.876440096,14084,6583,6308,275,2,273
17669,9344,11202,0,2,9060,,,,,,1,1,1.8627786990000001,4420,2212,1996,216,0,216
17669,10175,10394,2,2,6921,,,,,,1,1,1.422729459,3325,1713,1543,170,3,167
17669,11089,9477,0,2,4373,,,,,,1,1,0.891089981,2012,1086,897,189,2,187
17669,9768,10619,0,0,37822,,,,,,1,1,7.7656913880000005,19168,9152,8802,350,3,347
17669,9912,10634,4,0,4048,,,,,,1,1,0.855714804,1815,1030,857,173,1,172
17669,10084,9240,0,4,38853,,,,,,1,1,8.04114376,19348,9604,9307,297,4,293
17669,9864,10680,0,2,12185,,,,,,1,1,2.544013518,6241,2868,2660,208,0,208
17669,8738,10186,0,1,37953,,,,,,1,1,7.9248565,19390,9149,8884,265,3,262
17669,10285,10303,0,0,3095,,,,,,1,1,0.630047761,1436,757,612,145,0,145
17669,10277,10268,0,0,6927,,,,,,1,1,1.421546935,3206,1746,1517,229,0,229
17669,10560,9989,0,0,2177,,,,,,1,1,0.446560563,976,527,380,147,0,147
17669,10213,10505,0,0,6908,,,,,,1,1,1.4096039839999999,3225,1739,1534,205,0,205
17669,8953,11611,0,0,3106,,,,,,1,1,0.633875671,1388,782,628,154,0,154
17669,11208,9682,0,2,5215,,,,,,1,1,1.056132207,2409,1307,1115,192,2,190
17669,9803,10760,0,0,2988,,,,,,1,1,0.610425304,1270,771,595,176,0,176
17669,9557,10624,3,1,36437,,,,,,1,1,7.716189147,18665,8738,8442,296,9,287
17669,10431,9543,0,0,37634,,,,,,1,1,7.830231558,19326,8991,8665,326,2,324
17669,9812,10591,0,0,35687,,,,,,1,1,7.371159168,18791,8302,8010,292,2,290
17669,10655,10111,0,0,1983,,,,,,1,1,0.408754246,865,494,364,130,0,130
17669,9333,11033,0,2,37234,,,,,,1,1,7.65454411,18963,8973,8648,325,4,321
17669,10312,10280,0,2,5003,,,,,,1,1,1.002308937,2320,1238,1031,207,0,207
17669,10599,10173,0,0,9041,,,,,,1,1,1.852515161,4481,2170,1950,220,0,220
17669,10715,9479,0,2,36702,,,,,,1,1,7.436642617,19092,8634,8292,342,6,336
17669,9733,10843,2,2,34204,,,,,,1,1,6.992247771,17476,8207,7893,314,4,310
17669,8651,9773,0,0,37465,,,,,,1,1,7.884847571,19368,8915,8648,267,0,267
17669,9493,10626,0,0,35114,,,,,,1,1,7.338924002,18361,8235,7952,283,3,280
17669,8639,9996,0,11,37081,,,,,,1,1,7.719796325,18936,8936,8663,273,2,271
17669,11203,9345,2,0,5506,,,,,,1,1,1.125431144,2734,1287,1089,198,0,198
17669,9966,10590,0,2,3818,,,,,,1,1,0.774748471,1833,920,775,145,0,145
17669,9421,10205,2,0,36674,,,,,,1,1,7.635460391,18936,8718,8416,302,3,299
17669,11358,9320,2,0,29049,,,,,,1,1,6.046168398,15052,6847,6544,303,2,301
17669,9597,10948,0,0,5862,,,,,,1,1,1.254006178,2837,1425,1250,175,0,175
17669,8825,9915,2,4,37825,,,,,,1,1,7.995241517,19243,9148,8862,286,5,281
17669,10224,10391,0,4,7862,,,,,,1,1,1.656110579,3939,1856,1645,211,0,211
17669,10019,10633,2,0,1984,,,,,,1,1,0.420427964,853,492,345,147,2,145
17669,10722,9824,0,0,10711,,,,,,1,1,2.20360848,5248,2616,2385,231,0,231
17669,10479,10214,1,2,35555,,,,,,1,1,7.702222897,17934,8649,8326,323,0,323
17669,8569,10498,0,1,38423,,,,,,1,1,8.254260374,19513,9305,9005,300,7,293
17669,10173,9825,1,0,36767,,,,,,1,1,7.553341277,18645,8909,8605,304,3,301
17669,10390,10166,5,0,33898,,,,,,1,1,7.243686714,17123,8212,7861,351,0,351
17669,9912,10848,0,2,8972,,,,,,1,1,1.908265867,4301,2227,2010,217,0,217
17669,11604,8925,3,0,36160,,,,,,1,1,7.538316048,18258,8802,8504,298,0,298
17669,9848,10698,0,2,4389,,,,,,1,1,0.91544907,2133,1043,873,170,0,170
17669,9624,10810,1,2,35732,,,,,,1,1,7.317910553,18582,8444,8182,262,3,259
17669,9456,10514,0,0,37703,,,,,,1,1,7.842082568,19189,9106,8804,302,4,298
17669,10137,9631,0,0,35104,,,,,,1,1,7.718739858,18262,8288,8022,266,0,266
17669,10203,10343,0,0,2685,,,,,,1,1,0.556489734,1155,694,552,142,0,142
17669,10655,9181,2,2,36179,,,,,,1,1,7.459732177,18677,8615,8343,272,1,271
17669,8269,10987,0,2,36992,,,,,,1,1,7.726707501,19022,8854,8592,262,2,260
17669,10030,10526,0,4,7316,,,,,,1,1,1.505238194,3428,1845,1647,198,9,189
17669,10163,10424,0,0,1916,,,,,,1,1,0.398100562,859,468,347,121,1,120
17669,11158,9714,2,2,2686,,,,,,1,1,0.552167069,1208,664,514,150,0,150
17669,9501,10378,1,0,39724,,,,,,1,1,8.289512245,19741,9826,9495,331,1,330
17669,10291,10005,1,4,34834,,,,,,1,1,7.268234489,18400,8079,7803,276,3,273
17669,9962,10603,4,0,7498,,,,,,1,1,1.550437496,3663,1821,1628,193,0,193
17669,10852,9485,4,0,36057,,,,,,1,1,7.314769889,18657,8562,8286,276,3,273
17669,11812,8733,0,0,7186,,,,,,1,1,1.484896118,3524,1735,1543,192,1,191
17669,10634,9222,2,0,39596,,,,,,1,1,8.343420579,19899,9686,9361,325,0,325
17669,9253,10352,1,3,37859,,,,,,1,1,7.774397148,19020,9266,8959,307,0,307
17669,11913,8473,0,0,35574,,,,,,1,1,7.412643937,18234,8512,8196,316,2,314
17669,9866,10678,0,0,22513,,,,,,1,1,4.609719923,11265,5483,5201,282,1,281
17669,9714,9893,0,2,36545,,,,,,1,1,7.934508633,18738,8760,8473,287,0,287
17669,10374,10100,0,1,36964,,,,,,1,1,7.506811778,18958,8847,8535,312,2,310
17669,9173,8282,0,0,36676,,,,,,1,1,7.451437628,19004,8707,8449,258,0,258
17669,11286,8778,4,0,37982,,,,,,1,1,7.654708897,19133,9255,8916,339,3,336
17669,10825,8353,2,0,37929,,,,,,1,1,7.950438425,18966,9338,9051,287,6,281
17669,10680,9866,0,2,3964,,,,,,1,1,0.798519473,1813,994,831,163,0,163
17669,9973,10573,0,0,3056,,,,,,1,1,0.863315801,1404,751,601,150,0,150
17669,8607,9613,1,2,37850,,,,,,1,1,7.833147153,19510,9033,8759,274,3,271
17669,9183,11118,2,0,36751,,,,,,1,1,7.415156541,18961,8756,8478,278,5,273
17669,10920,8913,0,0,36761,,,,,,1,1,7.758317288,18877,8790,8486,304,5,299
17669,9644,10909,0,0,8956,,,,,,1,1,1.8840013930000001,4231,2254,2037,217,0,217
17669,10401,10144,0,0,10951,,,,,,1,1,2.209557638,5189,2762,2524,238,0,238
17669,9494,10974,2,1,34300,,,,,,1,1,7.127182233,17899,8056,7767,289,6,283
17669,9572,10119,2,0,34738,,,,,,1,1,7.408884474,18241,8111,7836,275,2,273
17669,10025,10625,2,0,2846,,,,,,1,1,0.681484793,1301,691,528,163,2,161
17669,8977,11582,0,0,1160,,,,,,1,1,0.264474813,431,307,192,115,0,115
17669,9947,9229,0,0,38397,,,,,,1,1,8.191518026,19207,9463,9199,264,2,262
17669,11144,9755,0,4,14417,,,,,,1,1,3.071562825,7112,3538,3309,229,4,225
17669,9615,11240,2,3,27599,,,,,,1,1,5.74776915,14329,6495,6215,280,3,277
17669,10844,9802,0,0,2558,,,,,,1,1,0.547306769,1093,657,506,151,0,151
17669,10488,10114,0,0,3462,,,,,,1,1,0.766340477,1552,875,715,160,0,160
17669,10444,9955,0,2,37979,,,,,,1,1,7.974029489,18965,9334,8988,346,1,345
17669,10507,9415,2,2,35621,,,,,,1,1,7.617199389,18337,8508,8240,268,12,256
17669,10845,9901,0,0,2132,,,,,,1,1,0.44147511,927,535,400,135,0,135
17669,8799,10213,0,0,38021,,,,,,1,1,7.769673447,19188,9278,9001,277,0,277
17669,10387,10217,2,2,5069,,,,,,1,1,1.038895653,2325,1273,1075,198,2,196
17669,10106,10568,2,2,22060,,,,,,1,1,4.679719623,11026,5389,5133,256,5,251
17669,8942,8023,0,0,37877,,,,,,1,1,7.810256442,19561,9024,8756,268,4,264
17669,10210,9359,3,2,37079,,,,,,1,1,7.766293386,18838,8980,8699,281,4,277
17669,10927,9674,0,2,4819,,,,,,1,1,1.027386496,2189,1225,1045,180,0,180
17669,9571,10612,2,0,37060,,,,,,1,1,7.752947197,18749,8996,8677,319,7,312
17669,10361,10200,0,0,1331,,,,,,1,1,0.27846441,494,354,225,129,0,129
17669,9533,11029,0,4,3433,,,,,,1,1,0.705285395,1475,899,739,160,1,159
17669,10730,9814,0,0,3511,,,,,,1,1,0.726033958,1611,874,722,152,0,152
17669,10182,9946,2,2,35855,,,,,,1,1,7.481425187,18416,8572,8277,295,10,285
17669,10275,10336,0,0,1061,,,,,,1,1,0.245874408,411,270,160,110,0,110
17669,10073,10472,2,0,16022,,,,,,1,1,3.360995525,8169,3798,3541,257,3,254
17669,10750,9815,2,0,3398,,,,,,1,1,0.69295881,1565,831,660,171,0,171
17669,9817,9269,2,2,36085,,,,,,1,1,7.598991474,18727,8537,8253,284,5,279
17669,10531,10013,0,2,14995,,,,,,1,1,3.078491705,7657,3551,3315,236,0,236
17669,9502,11208,0,0,4380,,,,,,1,1,0.896963718,2065,1070,895,175,0,175
17669,11172,9025,0,0,35601,,,,,,1,1,7.308062297,18591,8347,8031,316,4,312
17669,10203,10343,2,0,3954,,,,,,1,1,0.85441385,1849,962,781,181,2,179
17669,9758,10627,0,2,35261,,,,,,1,1,7.598416918,18382,8309,8048,261,3,258
17669,9908,10651,0,0,2232,,,,,,1,1,0.463776673,943,570,421,149,0,149
17669,11245,9303,0,2,3607,,,,,,1,1,0.7372656,1604,912,733,179,2,177
17669,10229,10315,0,0,5093,,,,,,1,1,1.130968667,2296,1304,1115,189,0,189
17669,9335,8955,0,0,36400,,,,,,1,1,7.669412975,18474,8816,8522,294,0,294
17669,9282,10863,1,0,36992,,,,,,1,1,7.956881249,18954,8856,8530,326,1,325
17669,9840,10736,0,2,6339,,,,,,1,1,1.375086853,2983,1570,1354,216,2,214
17669,9344,8593,0,0,37001,,,,,,1,1,8.000938757,19219,8764,8510,254,3,251
17669,10139,9310,0,0,36151,,,,,,1,1,7.63964364,18713,8569,8269,300,4,296
17669,10707,9147,0,0,35611,,,,,,1,1,7.727717994,18449,8431,8131,300,1,299
17669,10812,9583,2,0,36711,,,,,,1,1,8.098095246,18649,8874,8560,314,6,308
17669,10620,10008,0,0,10935,,,,,,1,1,2.597150952,5380,2669,2452,217,1,216
17669,10017,10528,0,0,9493,,,,,,1,1,2.380366092,4610,2326,2095,231,0,231
17669,9866,10448,2,2,38657,,,,,,1,1,8.130647809,19253,9537,9207,330,4,326
17669,10951,9624,4,0,16769,,,,,,1,1,3.771913792,8272,4125,3878,247,12,235
17669,10575,9688,0,0,35567,,,,,,1,1,7.56981704,18440,8415,8118,297,2,295
17669,9968,8507,2,0,35650,,,,,,1,1,7.470998231,18342,8519,8249,270,4,266
17669,10927,9017,1,0,36188,,,,,,1,1,7.6978023570000005,18493,8693,8384,309,2,307
17669,9148,11160,0,0,36005,,,,,,1,1,7.568923279,18683,8512,8214,298,1,297
17669,10935,9716,2,0,15943,,,,,,1,1,3.308504766,8103,3801,3563,238,1,237
17669,8934,9722,0,0,38422,,,,,,1,1,8.445589034,19554,9286,8990,296,1,295
17669,10693,10108,2,0,21330,,,,,,1,1,4.590080016,10891,5096,4849,247,1,246
17669,11089,9649,0,0,11977,,,,,,1,1,2.527651444,5813,2953,2695,258,0,258
17669,10425,9983,2,2,37477,,,,,,1,1,8.045495256,19349,8912,8608,304,2,302
17669,10432,10450,2,2,11522,,,,,,1,1,2.394670153,5811,2742,2515,227,3,224
17669,10476,10084,0,0,1830,,,,,,1,1,0.378002449,795,453,324,129,0,129
17669,9459,11436,0,2,32384,,,,,,1,1,7.03074396,16659,7717,7426,291,5,286
17669,10121,10526,0,0,13510,,,,,,1,1,2.993296651,6672,3303,3071,232,2,230
17669,9794,10750,0,0,13966,,,,,,1,1,3.103615816,7282,3226,2994,232,0,232
17669,11088,9461,2,0,1709,,,,,,1,1,0.359886109,749,418,294,124,0,124
17669,9666,11041,0,2,1081,,,,,,1,1,0.225414109,414,284,185,99,1,98
17669,11066,9489,0,0,2195,,,,,,1,1,0.448716433,969,545,409,136,0,136
17669,10139,10547,0,0,2018,,,,,,1,1,0.43667812,885,503,376,127,0,127
17669,9201,8844,2,0,36806,,,,,,1,1,8.421985058,19134,8721,8491,230,4,226
17669,9596,11177,0,4,6682,,,,,,1,1,1.374064542,3129,1675,1472,203,8,195
17669,10459,9882,0,3,36045,,,,,,1,1,7.759900661,18671,8549,8273,276,4,272
17669,9304,11242,0,0,6229,,,,,,1,1,1.27746345,2842,1589,1380,209,0,209
17669,10934,9610,2,0,31817,,,,,,1,1,6.937810979,16835,7342,7044,298,0,298
17669,10263,10617,0,0,2337,,,,,,1,1,0.492127652,976,607,460,147,0,147
17669,9444,10991,5,0,34743,,,,,,1,1,7.222983424,18532,7957,7660,297,2,295
17669,9328,10015,0,1,36227,,,,,,1,1,7.864332162,18799,8577,8303,274,1,273
17669,11469,8684,4,2,36323,,,,,,1,1,7.446527061,18599,8696,8364,332,5,327
17669,10073,10471,0,0,10779,,,,,,1,1,2.190838279,5568,2499,2286,213,2,211
17669,10104,10645,0,0,2756,,,,,,1,1,0.572955024,1197,700,541,159,1,158
17669,10486,8254,2,0,37191,,,,,,1,1,7.825018755,19032,8943,8670,273,19,254
17669,8504,9854,0,0,36500,,,,,,1,1,8.053648746,18973,8622,8339,283,4,279
17669,9277,10223,2,2,37322,,,,,,1,1,7.892823093,18928,9039,8723,316,2,314
17669,10195,10513,0,2,4677,,,,,,1,1,0.964365911,2127,1180,990,190,2,188
17669,8940,10684,2,2,37550,,,,,,1,1,7.758500844,19364,8946,8652,294,10,284
17669,8714,10986,0,0,35994,,,,,,1,1,7.375545023,18351,8675,8382,293,2,291
17669,10463,9184,0,2,37097,,,,,,1,1,7.647237178,18887,8959,8667,292,0,292
17669,9552,11011,2,0,34106,,,,,,1,1,7.32064847,17572,8106,7784,322,3,319
17669,9812,10735,2,0,1893,,,,,,1,1,0.392364351,808,478,349,129,0,129
17669,10790,9824,0,0,1657,,,,,,1,1,0.344267582,714,409,284,125,0,125
17669,11172,8575,3,0,36483,,,,,,1,1,7.53261041,18914,8650,8381,269,5,264
17669,10221,10359,0,0,7670,,,,,,1,1,1.594028102,3640,1910,1700,210,0,210
17669,9905,10648,0,0,1351,,,,,,1,1,0.279840118,537,349,233,116,0,116
17669,8903,11650,2,2,6770,,,,,,1,1,1.430252892,3085,1729,1502,227,4,223
17669,10239,7962,0,0,36474,,,,,,1,1,7.448046231,19165,8536,8299,237,4,233
17669,9827,10826,0,2,3742,,,,,,1,1,0.8439326,1724,936,790,146,1,145
17669,10576,9975,0,0,1726,,,,,,1,1,0.373505503,667,468,345,123,0,123
17669,9847,10711,0,0,3168,,,,,,1,1,0.663708241,1487,768,623,145,0,145
17669,10382,10168,0,0,5033,,,,,,1,1,1.100528874,2340,1249,1054,195,0,195
17669,9486,11117,2,0,3112,,,,,,1,1,0.654722308,1402,776,618,158,2,156
17669,9281,11309,0,2,4433,,,,,,1,1,0.92454808,2051,1100,918,182,1,181
17669,9575,11307,0,2,5002,,,,,,1,1,1.061944607,2289,1264,1079,185,2,183
17669,9088,11470,0,2,3101,,,,,,1,1,0.671981447,1368,784,619,165,2,163
17669,9741,10821,0,0,1491,,,,,,1,1,0.317426453,611,381,263,118,0,118
17669,10751,10173,0,0,7807,,,,,,1,1,1.695548477,3798,1903,1700,203,0,203
17669,9533,11372,0,2,29396,,,,,,1,1,5.992065308,15062,7032,6762,270,1,269
17669,10535,9986,0,2,37064,,,,,,1,1,7.791880931,19049,8837,8496,341,2,339
17669,10995,9555,2,0,1347,,,,,,1,1,0.296195665,512,357,236,121,2,119
17669,10281,9578,0,0,35927,,,,,,1,1,7.36233747,18813,8419,8143,276,3,273
17669,10050,8167,2,0,36740,,,,,,1,1,7.661777397,18942,8777,8533,244,10,234
17669,9071,10515,2,0,35577,,,,,,1,1,7.307323126,18395,8448,8162,286,6,280
17669,10232,10312,0,0,32921,,,,,,1,1,6.856155242,17008,7798,7481,317,6,311
17669,10104,10736,0,0,5301,,,,,,1,1,1.146224492,2499,1296,1086,210,0,210
17669,10522,9286,0,0,37241,,,,,,1,1,7.720585341,19186,8883,8594,289,1,288
17669,10394,10226,2,0,1815,,,,,,1,1,0.376769234,763,466,346,120,2,118
17669,10862,9959,2,0,3854,,,,,,1,1,0.778328931,1691,987,798,189,1,188
17669,11426,9378,0,0,3807,,,,,,1,1,0.829299075,1736,945,764,181,0,181
17669,10440,10113,0,0,2859,,,,,,1,1,0.58363524,1246,725,562,163,0,163
17669,8683,11863,0,2,13542,,,,,,1,1,2.86063967,6763,3268,3025,243,1,242
17669,10402,10012,0,4,36472,,,,,,1,1,7.571285316,19005,8568,8237,331,7,324
17669,9981,10865,0,0,1837,,,,,,1,1,0.378380854,789,456,320,136,0,136
17669,9658,10186,2,3,37884,,,,,,1,1,7.96935688,19185,9201,8904,297,1,296
17669,11254,8956,2,3,37865,,,,,,1,1,7.725370715,19379,9081,8757,324,6,318
17669,10387,10530,0,2,6658,,,,,,1,1,1.344846985,3208,1636,1458,178,0,178
17669,10464,9024,2,0,35537,,,,,,1,1,7.359233217,18746,8252,7965,287,1,286
17669,10084,10460,0,4,12290,,,,,,1,1,2.494304309,6235,2902,2651,251,3,248
17669,10066,9591,4,0,36589,,,,,,1,1,7.421799058,18817,8751,8481,270,1,269
17669,9770,9921,2,0,37617,,,,,,1,1,7.960967626,19036,9149,8866,283,3,280
17669,10175,8937,3,2,34512,,,,,,1,1,7.320944055,17906,8172,7910,262,2,260
17669,10437,10155,0,0,1862,,,,,,1,1,0.400381093,760,491,371,120,0,120
17669,10202,10353,2,0,5469,,,,,,1,1,1.107463004,2585,1345,1151,194,0,194
17669,9944,8774,0,0,36615,,,,,,1,1,7.590361633,18875,8733,8459,274,5,269
17669,10300,9739,0,0,37041,,,,,,1,1,7.50477322,19004,8859,8540,319,1,318
17669,10963,9312,0,0,36753,,,,,,1,1,7.451129083,18802,8819,8506,313,1,312
17669,10755,10076,0,0,913,,,,,,1,1,0.192538635,325,245,147,98,2,96
17669,9322,8946,2,0,38042,,,,,,1,1,7.754192055,19078,9351,9089,262,5,257
17669,10666,9918,0,0,4070,,,,,,1,1,0.844486518,1865,1019,852,167,0,167
17669,9258,9858,0,2,35927,,,,,,1,1,7.403562192,18208,8710,8411,299,0,299
17669,9764,9431,0,2,34926,,,,,,1,1,7.308976227,18386,8136,7868,268,2,266
17669,10514,10071,0,2,1690,,,,,,1,1,0.354035187,694,431,297,134,1,133
17669,10385,9376,2,0,37615,,,,,,1,1,7.883889367,19192,9056,8745,311,1,310
17669,10128,10419,0,0,12394,,,,,,1,1,2.597049549,6069,3039,2792,247,0,247
17669,10885,9478,0,0,38113,,,,,,1,1,8.03998543,18902,9431,9082,349,3,346
17669,9562,10626,0,3,35719,,,,,,1,1,7.192299352,18473,8485,8209,276,4,272
17669,9918,10650,0,2,5365,,,,,,1,1,1.081835729,2527,1323,1131,192,0,192
17669,10477,10069,0,0,12461,,,,,,1,1,2.535211908,6360,2942,2725,217,1,216
17669,10167,10731,1,2,4799,,,,,,1,1,0.995187815,2326,1151,980,171,0,171
17669,7665,10535,0,0,37083,,,,,,1,1,7.664287142,19416,8700,8433,267,3,264
17669,11236,9310,0,0,3695,,,,,,1,1,0.743822025,1603,956,776,180,2,178
17669,10061,10387,0,3,37671,,,,,,1,1,7.9165243610000005,19105,9126,8812,314,3,311
17669,9888,10683,0,0,2060,,,,,,1,1,0.423971001,922,510,392,118,0,118
17669,10899,8981,0,2,37134,,,,,,1,1,7.572144108,18747,9044,8745,299,0,299
17669,10279,10201,0,2,35816,,,,,,1,1,7.385270565,18630,8425,8089,336,9,327
17669,11112,9462,0,0,4132,,,,,,1,1,0.842915458,1890,1036,866,170,1,169
17669,11888,8852,5,0,29655,,,,,,1,1,5.998379409,15645,6873,6609,264,2,262
17669,10156,10388,0,2,7259,,,,,,1,1,1.463342095,3416,1814,1599,215,0,215
17669,8810,10726,0,3,37546,,,,,,1,1,7.642147574,19157,9028,8695,333,9,324
17669,10744,9793,0,0,36259,,,,,,1,1,7.364045109,18706,8633,8346,287,0,287
17669,9822,10740,0,0,10680,,,,,,1,1,2.163775582,5268,2596,2376,220,0,220
17669,9157,10237,0,0,36810,,,,,,1,1,7.554586368,18941,8783,8480,303,3,300
17669,9726,10835,1,2,25105,,,,,,1,1,5.123497899,13159,5838,5568,270,1,269
17669,9403,11144,0,0,2145,,,,,,1,1,0.441681566,947,528,386,142,1,141
17669,10149,10297,0,0,37646,,,,,,1,1,7.648388156,19116,9106,8788,318,5,313
17669,10358,8884,0,2,37140,,,,,,1,1,7.501245936,18908,8966,8666,300,2,298
17669,8455,9585,2,0,36627,,,,,,1,1,7.597892397,18656,8853,8588,265,2,263
17669,9479,9623,0,0,38748,,,,,,1,1,8.195019438,19023,9727,9456,271,3,268
17669,10825,9770,0,0,2165,,,,,,1,1,0.461126391,971,526,384,142,0,142
17669,10600,9458,0,0,35658,,,,,,1,1,7.212916851,18719,8326,8039,287,2,285
17669,9501,8826,2,0,35191,,,,,,1,1,7.32030459,18734,8101,7846,255,1,254
17669,8994,11409,0,2,35122,,,,,,1,1,7.233702365,18621,8098,7793,305,1,304
17669,9948,10949,0,0,10845,,,,,,1,1,2.203792359,5243,2686,2456,230,1,229
17669,10692,9852,4,2,32176,,,,,,1,1,6.599195152,16029,7910,7583,327,6,321
17669,10763,9788,0,0,7059,,,,,,1,1,1.4245560959999999,3430,1718,1525,193,0,193
17669,10307,10596,0,0,4106,,,,,,1,1,0.871713834,1890,1014,826,188,0,188
17669,10878,9666,0,0,31651,,,,,,1,1,6.3762116429999995,15992,7677,7372,305,0,305
17669,9873,10546,1,2,34245,,,,,,1,1,7.130128477,18012,7979,7704,275,1,274
17669,10632,9032,4,0,35833,,,,,,1,1,7.650952662,18598,8475,8190,285,9,276
17669,8398,10527,0,0,36806,,,,,,1,1,7.576837825,19125,8688,8383,305,2,303
17669,11007,9537,0,0,21000,,,,,,1,1,4.350024192,10507,5106,4825,281,0,281
17669,11432,9428,0,0,3961,,,,,,1,1,0.815600435,1793,1005,847,158,0,158
17669,10239,10316,0,4,4878,,,,,,1,1,0.987677571,2234,1221,1019,202,6,196
17669,10252,10303,0,0,1392,,,,,,1,1,0.294460464,563,358,245,113,1,112
17669,10237,10413,0,2,5982,,,,,,1,1,1.22008319,2698,1530,1306,224,1,223
17669,10675,9872,2,0,5247,,,,,,1,1,1.102791286,2435,1308,1112,196,3,193
17669,10425,10424,0,0,6141,,,,,,1,1,1.243665899,2997,1475,1281,194,0,194
17669,10387,10203,2,2,18122,,,,,,1,1,3.68409482,9086,4393,4143,250,1,249
17669,10545,10047,0,2,1201,,,,,,1,1,0.25144981,439,325,213,112,1,111
17669,10390,10202,0,0,1422,,,,,,1,1,0.293567242,519,390,267,123,0,123
17669,8791,9914,0,2,37395,,,,,,1,1,7.757683385,19121,8997,8717,280,2,278
17669,10297,10346,0,0,2909,,,,,,1,1,0.604158621,1290,734,583,151,0,151
17669,9898,9902,2,0,37772,,,,,,1,1,7.8561328,18997,9241,8948,293,1,292
17669,8980,9920,4,1,36211,,,,,,1,1,7.350511256,18512,8735,8506,229,3,226
17669,9268,8487,0,0,36865,,,,,,1,1,7.536743212,18998,8799,8530,269,3,266
17669,9918,9533,0,0,34342,,,,,,1,1,7.020829739,18172,7947,7671,276,2,274
17669,10722,9822,0,3,14692,,,,,,1,1,2.971716233,7487,3473,3214,259,0,259
17669,10618,9900,2,4,36596,,,,,,1,1,7.475953954,18587,8838,8505,333,12,321
17669,10789,9779,0,0,4785,,,,,,1,1,0.971140002,2128,1227,1024,203,0,203
17669,10084,10381,4,2,35888,,,,,,1,1,7.351976907,18490,8551,8255,296,3,293
17669,10326,8851,2,0,37693,,,,,,1,1,7.645729081,19369,9013,8715,298,3,295
17669,11215,8960,0,2,34638,,,,,,1,1,7.131489449,18204,8077,7797,280,1,279
17669,9772,9768,2,0,35860,,,,,,1,1,7.419575511,18809,8386,8107,279,2,277
17669,9015,11545,0,0,1978,,,,,,1,1,0.412993173,867,491,362,129,0,129
17669,10770,9856,0,0,7767,,,,,,1,1,1.62243932,3646,1943,1708,235,1,234
17669,10211,10363,2,4,8422,,,,,,1,1,1.7090960750000002,4185,2027,1844,183,3,180
17669,9916,10097,0,2,35479,,,,,,1,1,7.381046307,18460,8371,8094,277,1,276
17669,9145,9960,0,2,36136,,,,,,1,1,7.571318743,18710,8575,8299,276,5,271
17669,9672,10872,0,0,29903,,,,,,1,1,6.137662943,15188,7207,6906,301,0,301
17669,9881,10883,2,0,35569,,,,,,1,1,7.266477749,17990,8642,8347,295,4,291
17669,9678,10866,0,4,17827,,,,,,1,1,3.635119924,9051,4261,4007,254,9,245
17669,8646,9486,0,0,38000,,,,,,1,1,7.763626678,19463,9125,8838,287,2,285
17669,10430,9831,2,8,35862,,,,,,1,1,7.269028163,18472,8538,8224,314,12,302
17669,10119,10537,2,0,23771,,,,,,1,1,4.928381881,12110,5704,5451,253,0,253
17669,10847,9708,0,4,2590,,,,,,1,1,0.533075222,1138,650,498,152,4,148
17669,10212,10335,2,0,9636,,,,,,1,1,2.199689092,4720,2340,2104,236,0,236
17669,9109,10993,2,4,35573,,,,,,1,1,7.308715116,18436,8434,8165,269,3,266
17669,10439,9704,0,0,35114,,,,,,1,1,7.143188444,18292,8275,8003,272,2,270
17669,10662,10168,0,0,3207,,,,,,1,1,0.656308612,1451,795,629,166,0,166
17669,10869,9571,0,0,35342,,,,,,1,1,7.260201864,18370,8326,8006,320,2,318
17669,7620,11961,2,0,36494,,,,,,1,1,7.463002958,18884,8658,8364,294,4,290
17669,9045,11048,0,0,36223,,,,,,1,1,7.5070465859999995,18816,8565,8288,277,4,273
17669,11081,9198,4,0,36220,,,,,,1,1,7.365435225,18769,8574,8271,303,2,301
17669,10530,9592,0,6,34493,,,,,,1,1,7.35706037,18348,7947,7696,251,3,248
17669,10080,10268,0,0,36492,,,,,,1,1,7.640444015,18973,8595,8266,329,2,327
17669,10160,8955,2,0,36736,,,,,,1,1,7.422016131,18738,8859,8579,280,3,277
17669,9692,11154,0,2,7256,,,,,,1,1,1.48953275,3665,1693,1488,205,0,205
17669,9898,10654,0,0,2737,,,,,,1,1,0.555906731,1191,699,551,148,0,148
17669,9676,11196,2,2,16312,,,,,,1,1,3.363220659,8055,4002,3749,253,4,249
17669,10743,9053,2,0,37826,,,,,,1,1,7.800161525,18984,9262,8944,318,1,317
17669,10638,10285,2,0,12971,,,,,,1,1,2.794451805,6709,3013,2777,236,1,235
17669,9506,10009,2,2,37756,,,,,,1,1,7.666148241,19294,9085,8793,292,9,283
17669,10588,9139,0,2,36006,,,,,,1,1,7.2651716,18321,8693,8394,299,7,292
17669,9840,8900,0,2,37114,,,,,,1,1,7.567818718,19187,8821,8536,285,2,283
17669,10168,10428,0,0,11141,,,,,,1,1,2.249398991,5532,2681,2434,247,0,247
17669,10247,10302,0,0,2706,,,,,,1,1,0.547144611,1143,693,516,177,1,176
17669,9320,9425,2,0,34748,,,,,,1,1,7.3020723069999995,18376,8054,7790,264,2,262
17669,9677,10889,0,2,2706,,,,,,1,1,0.551490346,1195,679,526,153,2,151
17669,11031,8703,0,0,33984,,,,,,1,1,6.952400286,17905,7910,7651,259,1,258
17669,9601,10954,0,3,7604,,,,,,1,1,1.5511331400000001,3641,1881,1680,201,1,200
17669,8555,9775,0,0,36624,,,,,,1,1,7.313951708,18859,8748,8479,269,1,268
17669,10503,10374,2,0,10032,,,,,,1,1,2.068604995,4793,2506,2279,227,2,225
17669,10540,10026,0,2,16063,,,,,,1,1,3.270924232,8077,3853,3573,280,0,280
17669,10037,10265,2,2,35403,,,,,,1,1,6.845054408,18570,8282,8013,269,1,268
17669,10180,9897,0,2,37132,,,,,,1,1,7.627741768,18907,8952,8631,321,6,315
17669,10242,10302,0,0,7601,,,,,,1,1,1.533970724,3717,1830,1606,224,0,224
17669,9770,10774,2,0,9436,,,,,,1,1,1.9111590139999999,4633,2290,2067,223,7,216
17669,10843,9701,0,0,20439,,,,,,1,1,4.10710749,10215,4974,4698,276,3,273
17669,9765,10766,2,1,37566,,,,,,1,1,7.139946729,19060,9098,8788,310,6,304
17669,9813,9728,2,0,34168,,,,,,1,1,6.921842521,18054,7934,7688,246,3,243
17669,11312,9241,0,2,30013,,,,,,1,1,5.182259469,15529,7095,6801,294,3,291
17669,9701,10289,1,0,38479,,,,,,1,1,7.20711027,19255,9440,9096,344,9,335
17669,9406,10325,0,0,34613,,,,,,1,1,6.466896458,18084,8129,7858,271,1,270
17669,10542,9894,0,0,35125,,,,,,1,1,6.146719289,18581,8114,7798,316,3,313
17669,10140,10619,2,0,26869,,,,,,1,1,4.195147095,13615,6484,6198,286,2,284
17669,8577,10229,2,2,37842,,,,,,1,1,5.894757863,19293,9118,8805,313,12,301
17669,8640,10402,0,2,37106,,,,,,1,1,6.324330538,19004,8912,8634,278,3,275
17669,8840,10701,0,0,37125,,,,,,1,1,5.987033761,19105,8858,8554,304,1,303
17669,10550,9399,4,0,37741,,,,,,1,1,6.181106115,19261,9091,8793,298,6,292
17669,10073,10090,0,0,36890,,,,,,1,1,5.799090045,18864,8861,8557,304,0,304
17669,9436,9822,0,4,37474,,,,,,1,1,5.208586775,19272,8959,8675,284,4,280
