key_bits,recovered_zeros_x,recovered_zeros_y,wrong_zeros_x,wrong_zeros_y,queries,traces,calibration_traces,threshold,tpr,tnr,attack_tpr,attack_tnr,duration_seconds,test_outcomes_0_false,test_outcomes_0_true,test_outcomes_1_false,test_outcomes_1_true,test_outcomes_2_false,test_outcomes_2_true
17669,11565,10604,2,2,9444,,,,,,1,1,1.915984795,4691,2261,2030,231,5,226
17669,12181,10118,4,0,18814,,,,,,1,1,3.860487468,9513,4514,4241,273,4,269
17669,11233,10936,0,0,18835,,,,,,1,1,3.8940419139999998,9604,4470,4179,291,1,290
17669,10045,12207,2,2,20149,,,,,,1,1,4.111336336,10244,4802,4501,301,0,301
17669,11813,10607,2,2,6870,,,,,,1,1,1.381869554,3274,1690,1474,216,1,215
17669,11113,9767,3,0,34243,,,,,,1,1,6.953149732,18189,7897,7637,260,1,259
17669,11445,10340,0,0,34055,,,,,,1,1,6.979220774,17666,8047,7752,295,3,292
17669,10386,10814,0,0,34350,,,,,,1,1,7.045042805,17873,8073,7742,331,3,328
17669,9853,11346,2,2,34829,,,,,,1,1,7.156886648,18282,8100,7753,347,19,328
17669,11101,10576,0,0,35387,,,,,,1,1,7.26003825,18162,8450,8125,325,3,322
17669,11528,10461,2,4,35106,,,,,,1,1,7.27197301,17798,8500,8192,308,3,305
17669,10869,10321,0,0,35317,,,,,,1,1,7.317358962,18391,8308,7998,310,5,305
17669,11046,11070,0,1,35516,,,,,,1,1,7.369855703,18267,8467,8152,315,1,314
17669,10902,10424,4,0,36062,,,,,,1,1,7.424492625,18528,8617,8317,300,6,294
17669,11332,10269,2,0,35538,,,,,,1,1,7.44144562,18296,8443,8087,356,5,351
17669,10896,9351,1,1,35374,,,,,,1,1,7.476301514,18608,8249,7981,268,1,267
17669,10953,10056,0,2,36134,,,,,,1,1,7.486737492,18701,8563,8256,307,1,306
17669,10826,11363,2,0,3067,,,,,,1,1,0.62606308,1383,756,584,172,2,170
17669,9514,10878,2,0,36228,,,,,,1,1,7.61158939,18261,8841,8556,285,2,283
17669,10230,11263,0,1,37275,,,,,,1,1,7.622324732,18925,9016,8698,318,0,318
17669,8813,10486,0,4,36961,,,,,,1,1,7.623937286,18954,8858,8567,291,8,283
17669,10379,10159,4,0,37960,,,,,,1,1,7.666893782,19415,9107,8776,331,0,331
17669,10271,8485,0,0,38457,,,,,,1,1,7.838387323,19271,9454,9176,278,3,275
17669,10974,9646,2,2,38451,,,,,,1,1,7.9147287120000005,19611,9255,8925,330,2,328
17669,9992,11027,0,4,36013,,,,,,1,1,7.936375577,18305,8687,8353,334,2,332
17669,10845,8230,2,0,38959,,,,,,1,1,7.960184105,19676,9500,9217,283,4,279
17669,11236,10986,2,4,30733,,,,,,1,1,6.220556714,15818,7304,6997,307,2,305
17669,10585,11871,0,4,4800,,,,,,1,1,1.075136807,2115,1237,1026,211,1,210
17669,10295,11874,0,0,21748,,,,,,1,1,4.428000359,10897,5283,4998,285,1,284
17669,9943,11656,0,1,36207,,,,,,1,1,7.524650432,18385,8735,8383,352,1,351
17669,10341,8234,0,0,36729,,,,,,1,1,7.5556512829999996,18950,8768,8525,243,2,241
17669,10003,11079,0,0,35453,,,,,,1,1,7.162816238,18446,8354,8055,299,1,298
17669,10888,9079,0,0,37158,,,,,,1,1,7.519892027,18980,8938,8636,302,1,301
17669,10496,9551,2,0,35860,,,,,,1,1,7.357294878,18622,8465,8157,308,7,301
17669,9619,9271,2,2,35369,,,,,,1,1,7.238201844,18465,8299,7993,306,13,293
17669,10730,10700,4,4,34653,,,,,,1,1,7.107225751,18010,8167,7858,309,4,305
17669,10872,10859,0,0,37983,,,,,,1,1,7.779696571,19324,9162,8827,335,0,335
17669,10199,9012,2,0,37635,,,,,,1,1,7.619392436,19406,8969,8678,291,1,290
17669,11099,10691,6,0,33097,,,,,,1,1,6.7475658979999995,17394,7704,7409,295,14,281
17669,10167,11640,0,0,36405,,,,,,1,1,7.462467305,18445,8813,8479,334,2,332
17669,10377,10543,0,0,36374,,,,,,1,1,7.480845582,18750,8639,8293,346,4,342
17669,11814,10124,3,0,37796,,,,,,1,1,7.601065139,18600,9415,9049,366,3,363
17669,10096,10070,0,2,37127,,,,,,1,1,7.530398215,19038,8896,8599,297,3,294
17669,10649,10812,0,2,36841,,,,,,1,1,7.422625293,18659,8937,8629,308,2,306
17669,10889,10304,5,0,37322,,,,,,1,1,7.546895799,19166,8906,8562,344,1,343
17669,10797,9107,2,0,36036,,,,,,1,1,7.451821507,18644,8555,8273,282,2,280
17669,9453,9795,0,0,36302,,,,,,1,1,7.375545609,18925,8545,8258,287,4,283
17669,11109,10922,0,4,36890,,,,,,1,1,7.745832179,18610,8978,8654,324,2,322
17669,9666,11616,2,0,37899,,,,,,1,1,7.873851733,19050,9259,8928,331,5,326
17669,9158,10676,0,0,36649,,,,,,1,1,7.525875947,19037,8647,8329,318,1,317
17669,10826,9259,0,4,36721,,,,,,1,1,7.664004044,18661,8887,8601,286,3,283
17669,11500,10477,2,0,36034,,,,,,1,1,7.60991352,18514,8600,8280,320,1,319
17669,11538,10983,0,0,3952,,,,,,1,1,0.862879065,1867,954,777,177,0,177
17669,9633,10520,2,2,36228,,,,,,1,1,7.5884731819999995,18865,8525,8212,313,11,302
17669,11224,11015,0,1,13982,,,,,,1,1,2.947804514,6845,3438,3177,261,2,259
17669,11211,11198,0,0,17204,,,,,,1,1,3.500967063,8534,4196,3918,278,1,277
17669,10349,11609,2,0,36323,,,,,,1,1,7.53669234,18374,8816,8499,317,0,317
17669,10324,10933,1,2,37027,,,,,,1,1,7.637848353,18985,8844,8490,354,3,351
17669,12027,9539,0,0,34134,,,,,,1,1,6.90770441,17968,7944,7666,278,1,277
17669,9660,10907,0,0,35688,,,,,,1,1,7.274463427,18450,8474,8184,290,0,290
17669,10490,9100,0,0,36098,,,,,,1,1,7.261673472,18444,8684,8398,286,3,283
17669,9752,12383,0,0,37029,,,,,,1,1,7.730142841,18748,8967,8620,347,1,346
17669,10141,9952,3,0,36036,,,,,,1,1,7.481991841,18494,8622,8324,298,4,294
17669,10130,10455,2,2,37309,,,,,,1,1,7.937884262,19325,8846,8554,292,2,290
17669,10800,10463,0,0,37609,,,,,,1,1,7.805834223,19103,9085,8749,336,1,335
17669,10098,9364,0,2,36546,,,,,,1,1,7.50552583,19005,8632,8355,277,4,273
17669,8567,10821,2,0,38852,,,,,,1,1,7.853471174,19232,9657,9351,306,5,301
17669,9507,11301,3,2,35878,,,,,,1,1,7.41996621,18580,8499,8199,300,2,298
17669,8807,10122,0,2,35182,,,,,,1,1,7.260472853,18392,8260,7990,270,4,266
17669,10164,10874,3,1,38492,,,,,,1,1,7.899311481,19477,9331,8978,353,12,341
17669,10454,9687,4,1,38564,,,,,,1,1,7.887196397,19808,9209,8871,338,20,318
17669,9177,10075,2,0,35388,,,,,,1,1,7.296196317,18378,8374,8112,262,2,260
17669,8550,9701,0,2,36518,,,,,,1,1,7.447196195,19222,8512,8240,272,8,264
17669,7951,9949,0,0,38844,,,,,,1,1,8.043792129,19806,9383,9111,272,1,271
17669,11168,9780,4,0,38334,,,,,,1,1,8.24684707,19265,9369,9038,331,16,315
17669,9961,11595,3,2,35588,,,,,,1,1,7.304756555,18336,8489,8215,274,1,273
17669,10820,10876,0,0,37666,,,,,,1,1,7.672031578,19038,9130,8762,368,3,365
17669,7995,9070,4,2,36939,,,,,,1,1,7.782770893,18946,8881,8650,231,3,228
17669,8963,10282,0,2,34541,,,,,,1,1,7.307028523,18498,7890,7627,263,1,262
17669,10827,11345,0,3,13836,,,,,,1,1,2.790499865,6808,3372,3088,284,2,282
17669,12027,10142,0,0,17198,,,,,,1,1,3.61276701,8541,4190,3913,277,3,274
17669,10011,10511,0,0,37015,,,,,,1,1,7.661305918,18809,8947,8635,312,1,311
17669,11614,10688,4,2,15962,,,,,,1,1,3.411225535,7846,3919,3641,278,7,271
17669,10127,10818,0,4,36217,,,,,,1,1,7.524372054,18931,8494,8196,298,2,296
17669,11141,11287,0,3,22022,,,,,,1,1,4.567415706,11335,5191,4886,305,0,305
17669,9517,11718,0,0,37912,,,,,,1,1,8.020759921,18895,9337,8994,343,2,341
17669,12063,10268,2,2,30558,,,,,,1,1,6.209442526,15957,7141,6822,319,1,318
17669,9609,11629,2,0,32785,,,,,,1,1,6.829630339,17558,7464,7165,299,2,297
17669,10801,10537,4,1,34580,,,,,,1,1,7.019299668,18196,8045,7751,294,4,290
17669,11495,9126,3,2,35356,,,,,,1,1,7.124559288,18163,8444,8139,305,2,303
17669,10542,10384,0,0,35692,,,,,,1,1,7.449678498,18486,8459,8171,288,1,287
17669,10514,10369,0,2,38144,,,,,,1,1,7.6953631609999995,19383,9218,8893,325,1,324
17669,11160,9551,3,0,35237,,,,,,1,1,7.14366615,18570,8194,7915,279,5,274
17669,10549,9811,0,2,35291,,,,,,1,1,7.214815386,18490,8255,7964,291,4,287
17669,10379,10400,2,0,32077,,,,,,1,1,6.528597458,16993,7413,7155,258,3,255
17669,9429,9791,5,0,35335,,,,,,1,1,7.831466782,18245,8420,8170,250,1,249
17669,9727,11423,0,2,35015,,,,,,1,1,7.094088847,18026,8345,8046,299,7,292
17669,10940,11241,0,0,3652,,,,,,1,1,0.872422945,1653,903,710,193,0,193
17669,10341,10864,4,0,38479,,,,,,1,1,7.880760319,19539,9302,8966,336,3,333
17669,9768,12406,2,0,3065,,,,,,1,1,0.626231425,1410,743,574,169,1,168
17669,8891,12273,0,0,36151,,,,,,1,1,7.350651792,18447,8686,8354,332,2,330
17669,10020,9149,2,0,37784,,,,,,1,1,7.835842012,19167,9164,8875,289,4,285
17669,10666,11504,2,0,3717,,,,,,1,1,0.799130406,1727,909,737,172,2,170
17669,11371,11142,2,0,28399,,,,,,1,1,5.800128916,14705,6690,6376,314,1,313
17669,11071,8738,0,0,36939,,,,,,1,1,7.737140662,18760,8936,8629,307,3,304
17669,10415,11766,0,0,4465,,,,,,1,1,0.907261615,1992,1141,950,191,0,191
17669,10364,9734,0,0,35158,,,,,,1,1,7.076796767,18372,8251,7967,284,3,281
17669,12093,9923,0,0,35347,,,,,,1,1,7.345570775,18343,8331,7989,342,2,340
17669,9633,10889,2,0,34712,,,,,,1,1,7.086060957,18126,8135,7819,316,10,306
17669,11930,10418,2,4,9917,,,,,,1,1,2.105533244,4648,2510,2261,249,0,249
17669,10609,10691,1,4,35738,,,,,,1,1,7.454000219,18499,8470,8171,299,2,297
17669,10500,11177,0,0,35993,,,,,,1,1,7.552491472,18305,8686,8370,316,3,313
17669,12246,9655,4,0,37801,,,,,,1,1,7.812606962,19024,9200,8823,377,4,373
17669,11253,11123,2,2,14752,,,,,,1,1,3.08740816,7334,3561,3265,296,2,294
17669,11884,10289,2,2,7726,,,,,,1,1,1.627367234,3732,1881,1649,232,3,229
17669,9737,9330,0,0,37892,,,,,,1,1,7.690218427,19277,9157,8856,301,1,300
17669,11410,10390,0,0,36820,,,,,,1,1,7.495555057,18802,8844,8514,330,0,330
17669,9589,11362,0,4,35591,,,,,,1,1,7.307231434,18229,8520,8198,322,2,320
17669,10782,11387,2,0,25613,,,,,,1,1,5.154497634,13003,6160,5870,290,2,288
17669,11360,11085,2,3,29457,,,,,,1,1,5.948011519,14802,7162,6831,331,4,327
17669,10382,10026,0,0,37202,,,,,,1,1,7.707722404,18866,9009,8691,318,2,316
17669,10832,10742,0,2,36734,,,,,,1,1,7.425630553,18553,8935,8624,311,6,305
17669,7964,10771,0,0,37221,,,,,,1,1,7.629832479,19094,8910,8603,307,3,304
17669,11237,10940,0,0,1844,,,,,,1,1,0.382514796,749,477,336,141,0,141
17669,9723,10928,2,0,34521,,,,,,1,1,7.032213059,18012,8116,7839,277,3,274
17669,10932,10968,4,2,34886,,,,,,1,1,7.146681452,18316,8114,7772,342,6,336
17669,10394,11395,0,0,34851,,,,,,1,1,7.265926816,18415,8066,7762,304,1,303
17669,9925,11312,0,1,36081,,,,,,1,1,7.333269331,18456,8649,8322,327,1,326
17669,11580,9778,0,2,36707,,,,,,1,1,7.380046051,18351,8999,8641,358,12,346
17669,10923,9583,0,0,36986,,,,,,1,1,7.678699477,18890,8889,8571,318,0,318
17669,10463,10971,0,2,36261,,,,,,1,1,7.357688223,18550,8697,8380,317,7,310
17669,10082,9496,2,1,34778,,,,,,1,1,7.219969711,18222,8140,7864,276,12,264
17669,9922,12250,4,2,9235,,,,,,1,1,1.8944291720000002,4483,2256,2016,240,10,230
17669,8927,8964,0,0,38810,,,,,,1,1,7.8079628880000005,19877,9329,9054,275,1,274
17669,10298,9615,2,0,35596,,,,,,1,1,7.269997049,18351,8473,8174,299,2,297
17669,10557,11794,6,4,31218,,,,,,1,1,6.462241736,16177,7386,7117,269,1,268
17669,8980,9279,2,2,38270,,,,,,1,1,7.701669417,19008,9486,9196,290,2,288
17669,11081,10948,0,0,34785,,,,,,1,1,7.322586195,18038,8215,7898,317,2,315
17669,8946,9186,0,0,36759,,,,,,1,1,7.729272153,19040,8738,8495,243,2,241
17669,9218,10993,2,4,34379,,,,,,1,1,7.283049523,18258,7928,7663,265,4,261
17669,10581,10804,2,2,35728,,,,,,1,1,7.2787299690000005,18515,8437,8098,339,18,321
17669,9572,10906,0,2,37213,,,,,,1,1,7.628415556,18938,8980,8665,315,3,312
17669,10507,8899,0,2,37433,,,,,,1,1,7.650694454,19242,8953,8668,285,4,281
17669,10413,10261,2,0,36112,,,,,,1,1,7.386588093,18561,8633,8348,285,1,284
17669,10905,10413,2,0,36238,,,,,,1,1,7.561700721,18563,8695,8410,285,2,283
17669,11090,10446,0,2,36644,,,,,,1,1,7.426880724,18806,8751,8415,336,3,333
17669,10742,11036,2,0,34518,,,,,,1,1,7.134967187,18154,8027,7717,310,3,307
17669,10666,10952,0,6,37116,,,,,,1,1,7.519248471,18604,9097,8779,318,3,315
17669,8807,10608,0,0,35641,,,,,,1,1,7.330118057,18542,8400,8101,299,4,295
17669,10952,10749,0,0,35322,,,,,,1,1,7.177521392,18123,8446,8139,307,4,303
17669,10173,9825,1,0,36784,,,,,,1,1,7.418335464,18667,8907,8604,303,4,299
17669,10258,10613,0,0,37675,,,,,,1,1,7.6908407709999995,19061,9138,8800,338,1,337
17669,10422,10467,3,0,37011,,,,,,1,1,7.514057573,18810,8952,8655,297,1,296
17669,9334,9937,2,2,36983,,,,,,1,1,7.459194702,18955,8882,8618,264,1,263
17669,10569,10610,0,0,37122,,,,,,1,1,7.648285701,18982,8905,8575,330,2,328
17669,10680,10195,0,0,35079,,,,,,1,1,7.120120945,18438,8178,7893,285,0,285
17669,9856,11465,0,1,34877,,,,,,1,1,7.252627669,18332,8116,7803,313,2,311
17669,10613,10037,0,0,35563,,,,,,1,1,7.328253492,18417,8428,8138,290,1,289
17669,10790,11601,2,0,8668,,,,,,1,1,1.774876455,4085,2158,1891,267,1,266
17669,10361,10260,2,2,35376,,,,,,1,1,7.305433034,18036,8536,8268,268,4,264
17669,11017,9763,1,2,35796,,,,,,1,1,7.270250872,18374,8536,8186,350,10,340
17669,10716,9284,0,0,35929,,,,,,1,1,7.265560439,18643,8486,8172,314,3,311
17669,11273,10897,0,0,4410,,,,,,1,1,0.89886782,2067,1077,888,189,0,189
17669,10405,9700,0,0,35963,,,,,,1,1,7.427168101,18329,8675,8391,284,3,281
17669,9869,10891,0,0,35449,,,,,,1,1,7.297793535,18299,8429,8137,292,5,287
17669,11486,9853,0,0,34660,,,,,,1,1,7.219698282,18013,8165,7848,317,1,316
17669,10161,12040,0,0,2148,,,,,,1,1,0.440503141,897,548,393,155,0,155
17669,10561,10036,0,0,35834,,,,,,1,1,7.232518099,18305,8612,8307,305,2,303
17669,11143,10930,2,5,37910,,,,,,1,1,7.635610544,18948,9312,8974,338,4,334
17669,10826,9781,2,0,37418,,,,,,1,1,7.72227873,19000,9066,8780,286,2,284
17669,10736,9657,2,2,35566,,,,,,1,1,7.279326982,18435,8419,8126,293,3,290
17669,11423,10977,0,0,5391,,,,,,1,1,1.089782018,2526,1331,1128,203,0,203
17669,10859,11310,6,0,26898,,,,,,1,1,5.536701549,13856,6361,6041,320,7,313
17669,10342,9789,3,0,36916,,,,,,1,1,7.653641638,18919,8844,8535,309,4,305
17669,10078,9989,0,0,35156,,,,,,1,1,7.35965808,18451,8207,7916,291,1,290
17669,9312,9402,0,4,36454,,,,,,1,1,7.38083974,19258,8460,8184,276,1,275
17669,9387,11315,0,0,34573,,,,,,1,1,7.228951673,17775,8253,7961,292,2,290
17669,11224,11165,0,0,2188,,,,,,1,1,0.443917259,924,556,404,152,0,152
17669,9494,10974,2,1,34251,,,,,,1,1,7.161882929,17876,8043,7754,289,5,284
17669,9832,12350,0,0,3173,,,,,,1,1,0.656611853,1533,740,580,160,0,160
17669,10008,10918,0,2,35556,,,,,,1,1,7.195363705,18635,8316,8027,289,1,288
17669,9137,10221,3,0,36338,,,,,,1,1,7.383732907,18672,8689,8401,288,4,284
17669,11128,9233,1,0,35525,,,,,,1,1,7.319457045,18511,8351,8039,312,6,306
17669,10431,11336,0,4,36409,,,,,,1,1,7.503064876,18553,8764,8436,328,6,322
17669,11003,8909,2,0,37307,,,,,,1,1,7.6472154660000005,18990,8999,8680,319,2,317
17669,10030,11147,0,2,39026,,,,,,1,1,7.946710335,19463,9609,9264,345,9,336
17669,10361,8125,0,0,37561,,,,,,1,1,7.706351822,19179,9050,8768,282,2,280
17669,10848,11286,0,0,34232,,,,,,1,1,7.05198507,17591,8166,7857,309,2,307
17669,9476,11230,0,2,34851,,,,,,1,1,7.175416084,18241,8160,7870,290,4,286
17669,10686,9868,0,0,36777,,,,,,1,1,7.59500522,18952,8761,8458,303,3,300
17669,10560,11315,2,2,33264,,,,,,1,1,6.817026723,17577,7687,7374,313,19,294
17669,10726,10778,0,2,34906,,,,,,1,1,7.208629433,18172,8213,7905,308,3,305
17669,11095,11222,0,0,3403,,,,,,1,1,0.6956373,1479,871,689,182,0,182
17669,11125,10237,2,2,38321,,,,,,1,1,8.047850313,19079,9445,9093,352,3,349
17669,11332,10244,0,0,34092,,,,,,1,1,6.983143507,18118,7825,7501,324,6,318
17669,11229,10940,0,3,16563,,,,,,1,1,3.369366891,8365,3961,3685,276,1,275
17669,10994,10330,0,0,33597,,,,,,1,1,7.128122986,17534,7881,7580,301,2,299
17669,10224,11254,3,0,35923,,,,,,1,1,7.451845932,18477,8568,8258,310,13,297
17669,10436,10417,0,0,36659,,,,,,1,1,7.422340371,18516,8915,8602,313,1,312
17669,10476,10432,0,0,37678,,,,,,1,1,7.9252683,19051,9134,8775,359,4,355
17669,10574,11205,2,0,35019,,,,,,1,1,7.119953131,18321,8187,7863,324,4,320
17669,9456,10514,0,0,37679,,,,,,1,1,7.676421234,19189,9098,8804,294,4,290
17669,10797,10597,0,4,36036,,,,,,1,1,7.542915428,18190,8744,8386,358,4,354
17669,9126,12103,0,5,35215,,,,,,1,1,7.274713631,18500,8198,7879,319,9,310
17669,9991,12179,2,2,6116,,,,,,1,1,1.235107693,2953,1469,1244,225,5,220
17669,10423,10075,0,0,35552,,,,,,1,1,7.344208573,18040,8599,8285,314,0,314
17669,10786,11681,2,2,14001,,,,,,1,1,2.864678587,7011,3362,3096,266,7,259
17669,9968,8507,2,0,35678,,,,,,1,1,7.357551306,18355,8525,8252,273,4,269
17669,9998,9898,0,0,35988,,,,,,1,1,7.377788442,18724,8486,8194,292,4,288
17669,10166,10800,0,4,37586,,,,,,1,1,7.683772899,18995,9130,8799,331,18,313
17669,9940,9956,0,0,36830,,,,,,1,1,7.590674282,18698,8914,8610,304,2,302
17669,8993,10510,0,3,38801,,,,,,1,1,8.002442886,19502,9496,9189,307,1,306
17669,10229,9893,2,0,35469,,,,,,1,1,7.278713291,18484,8342,8041,301,2,299
17669,11093,11078,0,0,8225,,,,,,1,1,1.661292328,3990,1996,1753,243,3,240
17669,10464,11275,6,0,36432,,,,,,1,1,7.383897567,18618,8745,8421,324,2,322
17669,9981,11955,0,0,35786,,,,,,1,1,7.380442282,18098,8667,8313,354,3,351
17669,9712,10758,1,2,36932,,,,,,1,1,7.530551509,18973,8828,8525,303,4,299
17669,11202,10653,2,2,35252,,,,,,1,1,7.525828933,18063,8432,8107,325,9,316
17669,11027,11095,0,0,32545,,,,,,1,1,6.650241996,17032,7601,7290,311,1,310
17669,11095,10449,4,0,37163,,,,,,1,1,7.673598374,19061,8870,8508,362,3,359
17669,9110,10144,0,0,38514,,,,,,1,1,8.054944208,19001,9613,9326,287,3,284
17669,11475,10050,0,0,37245,,,,,,1,1,7.6566172120000004,18980,8960,8615,345,1,344
17669,11904,10308,0,0,17724,,,,,,1,1,3.564817542,8858,4291,4007,284,2,282
17669,9803,8757,0,0,38824,,,,,,1,1,8.17763902,19362,9580,9278,302,1,301
17669,9510,10899,0,0,37276,,,,,,1,1,7.598501426,18874,9028,8682,346,2,344
17669,9104,9819,0,2,37153,,,,,,1,1,7.592343293,18910,8985,8712,273,1,272
17669,9771,8009,0,0,38481,,,,,,1,1,7.891539356,19640,9286,9017,269,3,266
17669,9622,11246,2,3,34798,,,,,,1,1,7.250661635,18139,8175,7866,309,4,305
17669,11262,10907,2,2,11081,,,,,,1,1,2.233617382,5420,2699,2436,263,2,261
17669,10422,10382,2,0,36025,,,,,,1,1,7.312333452,18652,8534,8229,305,2,303
17669,10183,10549,2,0,36528,,,,,,1,1,7.52838913,18886,8666,8356,310,4,306
17669,8555,10889,0,0,37458,,,,,,1,1,7.739469006,19068,9023,8679,344,10,334
17669,10166,11523,4,0,36621,,,,,,1,1,7.449810473,18751,8782,8476,306,9,297
17669,11239,10795,2,0,34823,,,,,,1,1,7.218821052,18020,8246,7935,311,5,306
17669,9838,9070,2,2,35672,,,,,,1,1,7.659201266,18670,8367,8099,268,6,262
17669,9507,10574,0,2,38715,,,,,,1,1,8.005549455,19557,9419,9099,320,8,312
17669,10357,10320,5,0,37617,,,,,,1,1,7.798132989,18877,9226,8938,288,5,283
17669,10013,10479,0,2,35570,,,,,,1,1,7.199628774,18357,8452,8143,309,4,305
17669,10358,10907,0,3,34605,,,,,,1,1,7.028271335,18190,8055,7750,305,1,304
17669,11230,10942,0,0,4331,,,,,,1,1,0.872798876,1998,1070,877,193,1,192
17669,9379,9695,2,2,36838,,,,,,1,1,7.53337391,18993,8763,8444,319,9,310
17669,9504,10335,0,0,36050,,,,,,1,1,7.370602674,18896,8412,8082,330,1,329
17669,11292,10976,1,1,20503,,,,,,1,1,4.190944412,10357,4942,4680,262,0,262
17669,9328,10888,0,4,36214,,,,,,1,1,7.4122384,18717,8596,8291,305,0,305
17669,10285,10316,4,0,35684,,,,,,1,1,7.279460186,18630,8382,8092,290,5,285
17669,11065,10968,1,2,35107,,,,,,1,1,7.407330868,18109,8315,7947,368,4,364
17669,11511,9656,0,4,33687,,,,,,1,1,6.853696823,17688,7860,7581,279,4,275
17669,10702,10720,4,1,36973,,,,,,1,1,7.731301403,18670,8980,8637,343,18,325
17669,10838,9737,0,2,35906,,,,,,1,1,7.587492471,18593,8501,8190,311,4,307
17669,10290,8099,0,0,36600,,,,,,1,1,7.52726442,18740,8800,8540,260,0,260
17669,9989,10379,0,0,35994,,,,,,1,1,7.28435229,18647,8512,8189,323,2,321
17669,10382,9607,2,0,35591,,,,,,1,1,7.399070398,18545,8366,8052,314,1,313
17669,10571,10997,0,3,35487,,,,,,1,1,7.409174368,18392,8380,8045,335,9,326
17669,10565,9329,4,0,35904,,,,,,1,1,7.269458217,18411,8603,8316,287,4,283
17669,9548,10312,0,0,35453,,,,,,1,1,7.165089862,18558,8303,8014,289,3,286
17669,10182,9946,2,2,35768,,,,,,1,1,7.4093862,18419,8542,8277,265,7,258
17669,11898,10283,0,4,8280,,,,,,1,1,1.678919555,3837,2099,1854,245,7,238
17669,10169,10384,0,1,36294,,,,,,1,1,7.312294725,18746,8611,8285,326,0,326
17669,9008,8830,0,0,37955,,,,,,1,1,7.623424232,19322,9176,8895,281,2,279
17669,10623,10684,2,1,37566,,,,,,1,1,7.595280965,19060,9085,8749,336,5,331
17669,11250,10590,2,0,35975,,,,,,1,1,7.474337175,18549,8550,8224,326,3,323
17669,11271,10780,0,0,36033,,,,,,1,1,7.485164033,18416,8626,8261,365,5,360
17669,9845,11129,0,2,35849,,,,,,1,1,7.302571635,18467,8534,8220,314,4,310
17669,10374,9215,2,0,38152,,,,,,1,1,7.925780061,19550,9146,8836,310,2,308
17669,10999,9018,3,0,36184,,,,,,1,1,7.316510381,19053,8425,8144,281,2,279
17669,11581,10289,0,2,35672,,,,,,1,1,7.354754504,18273,8537,8212,325,7,318
17669,8962,10956,0,0,38101,,,,,,1,1,7.672902027,18913,9441,9135,306,1,305
17669,10653,9786,2,0,37792,,,,,,1,1,7.674950947,18981,9250,8939,311,4,307
17669,8481,10554,0,0,37548,,,,,,1,1,7.645908451,18914,9167,8867,300,2,298
17669,10334,11309,0,2,35297,,,,,,1,1,7.359365472,18305,8344,8040,304,6,298
17669,10178,12008,2,4,26086,,,,,,1,1,5.344812408,12992,6396,6094,302,2,300
17669,9991,11099,2,0,36883,,,,,,1,1,7.791739226,18629,8961,8629,332,2,330
17669,10876,9332,0,0,35045,,,,,,1,1,7.040228547,18286,8233,7940,293,1,292
17669,11794,10599,0,0,18184,,,,,,1,1,3.860208171,9128,4386,4102,284,2,282
17669,11002,10369,2,0,34600,,,,,,1,1,7.049844738,18041,8122,7807,315,5,310
17669,10092,9487,3,0,36274,,,,,,1,1,7.835300596,18838,8586,8322,264,1,263
17669,10297,10871,0,3,35311,,,,,,1,1,7.177102749,18421,8298,8004,294,3,291
17669,10772,10447,0,0,34349,,,,,,1,1,7.140746568,17838,8091,7762,329,4,325
17669,10801,11562,0,0,9934,,,,,,1,1,2.004371825,4764,2452,2186,266,1,265
17669,10281,10371,4,2,35865,,,,,,1,1,7.468287735,18692,8432,8123,309,10,299
17669,9906,9229,0,4,36260,,,,,,1,1,7.514185657,18888,8538,8242,296,3,293
17669,10412,9028,4,2,37587,,,,,,1,1,7.629593292,19240,9023,8722,301,4,297
17669,9466,9714,0,0,37796,,,,,,1,1,7.636214373,19164,9163,8857,306,0,306
17669,9120,9852,0,2,35603,,,,,,1,1,7.292784728,18678,8332,8071,261,1,260
17669,10280,11315,4,0,37106,,,,,,1,1,7.643027434,18961,8904,8567,337,9,328
17669,8865,10287,0,0,37116,,,,,,1,1,8.138644661,19136,8836,8528,308,2,306
17669,10521,11357,4,0,35686,,,,,,1,1,7.412390577,18250,8559,8241,318,2,316
17669,10365,10221,0,2,36414,,,,,,1,1,7.580186161,18539,8780,8465,315,4,311
17669,9976,10953,0,2,36416,,,,,,1,1,7.479774838,18714,8675,8323,352,12,340
17669,10951,9302,1,0,35779,,,,,,1,1,7.364929143,18221,8635,8347,288,2,286
17669,11498,9826,2,0,35901,,,,,,1,1,7.353100268,18317,8648,8360,288,2,286
17669,10576,9802,1,0,35049,,,,,,1,1,7.189526155,18359,8201,7913,288,0,288
17669,10196,11549,0,0,35081,,,,,,1,1,7.669658962,18321,8219,7897,322,4,318
17669,10214,9978,0,0,37266,,,,,,1,1,7.740119806,19245,8853,8538,315,2,313
17669,10556,10273,2,0,36580,,,,,,1,1,7.502699911,18642,8811,8495,316,1,315
17669,9946,9676,2,2,37615,,,,,,1,1,7.619711427,19249,9032,8730,302,8,294
17669,11961,9656,3,0,34268,,,,,,1,1,6.950749031,17946,8012,7714,298,0,298
17669,10883,11527,0,2,7784,,,,,,1,1,1.627871652,3821,1866,1635,231,1,230
17669,10708,9109,6,4,35075,,,,,,1,1,7.582294555,18007,8396,8120,276,9,267
17669,11022,9888,0,0,33287,,,,,,1,1,7.011819753,17897,7546,7248,298,2,296
17669,10708,10761,2,2,34704,,,,,,1,1,7.273923086,17924,8242,7946,296,2,294
17669,10249,10018,0,4,36858,,,,,,1,1,7.553997534,18660,8926,8580,346,2,344
17669,10533,10043,3,2,36921,,,,,,1,1,7.453604402,18736,8939,8632,307,3,304
17669,11168,10187,2,4,35592,,,,,,1,1,7.265645915,18018,8612,8262,350,6,344
17669,10521,10477,1,0,35185,,,,,,1,1,7.22163997,18516,8182,7877,305,2,303
17669,10333,11839,0,0,8989,,,,,,1,1,1.927296166,4267,2234,1980,254,0,254
17669,9228,10249,0,1,36094,,,,,,1,1,7.335682675,18732,8534,8240,294,0,294
17669,10878,10426,2,2,34271,,,,,,1,1,7.064254985,17750,8106,7797,309,15,294
17669,9969,10162,4,5,37719,,,,,,1,1,7.834505358,19348,9028,8713,315,13,302
17669,10394,10337,0,0,37756,,,,,,1,1,7.698147999,19184,9131,8821,310,2,308
17669,11174,10998,0,4,24006,,,,,,1,1,4.938523067,12218,5736,5420,316,1,315
17669,12277,9380,0,0,35787,,,,,,1,1,7.483611799,18646,8395,8044,351,3,348
17669,10313,11856,2,0,3749,,,,,,1,1,0.767338199,1690,933,740,193,0,193
17669,11322,11120,2,2,11491,,,,,,1,1,2.333420856,5591,2808,2524,284,6,278
17669,10598,9873,2,0,34270,,,,,,1,1,7.020181618,17881,8046,7749,297,1,296
17669,9250,10740,0,2,37213,,,,,,1,1,7.848731503,18946,8973,8652,321,1,320
17669,10819,10415,0,1,32953,,,,,,1,1,7.060347563,17609,7530,7246,284,3,281
17669,10788,9178,0,3,36152,,,,,,1,1,7.623811557,18585,8633,8332,301,7,294
17669,10521,9685,0,0,36388,,,,,,1,1,7.561715475,18476,8809,8515,294,4,290
17669,10687,9102,0,0,36337,,,,,,1,1,7.534218635,18543,8759,8483,276,3,273
17669,10493,10426,0,0,33994,,,,,,1,1,6.994571158,17925,7888,7595,293,1,292
17669,8085,10256,0,0,36614,,,,,,1,1,7.77209355,18876,8730,8452,278,0,278
17669,11277,10224,2,2,35452,,,,,,1,1,7.382548893,18428,8355,8041,314,6,308
17669,11347,10885,2,2,30392,,,,,,1,1,6.196080519,15684,7205,6907,298,4,294
17669,9667,9498,0,4,36522,,,,,,1,1,7.381381352,19009,8614,8329,285,0,285
17669,10970,10100,4,2,36387,,,,,,1,1,7.611283482,18418,8829,8518,311,3,308
17669,11588,10262,0,0,36104,,,,,,1,1,7.439194958,18629,8578,8259,319,0,319
17669,9294,9708,0,3,37269,,,,,,1,1,7.849289784,19248,8866,8577,289,5,284
17669,9591,11303,0,0,36679,,,,,,1,1,7.457614919,18512,8909,8560,349,1,348
17669,10612,11078,0,2,35260,,,,,,1,1,7.536923683,18275,8343,8044,299,0,299
17669,9380,9052,0,0,38843,,,,,,1,1,8.213474488,19572,9489,9196,293,1,292
17669,9154,10978,0,0,37683,,,,,,1,1,7.665150125,18995,9177,8843,334,2,332
17669,11428,10930,0,0,3282,,,,,,1,1,0.685008337,1488,812,642,170,0,170
17669,10929,11244,2,0,7360,,,,,,1,1,1.493872272,3541,1795,1566,229,1,228
17669,9510,11635,0,2,36526,,,,,,1,1,7.753219545,18889,8650,8313,337,3,334
17669,10680,9779,2,0,36082,,,,,,1,1,7.476942002,18353,8711,8404,307,1,306
17669,11176,10994,0,2,3657,,,,,,1,1,0.778619864,1616,928,743,185,0,185
17669,11063,11147,0,0,10514,,,,,,1,1,2.165957075,5054,2612,2376,236,1,235
17669,9830,10828,2,0,33661,,,,,,1,1,7.161798749,18128,7623,7336,287,4,283
17669,11573,10692,0,0,4836,,,,,,1,1,1.058029546,2332,1158,970,188,0,188
17669,9712,7907,0,0,38665,,,,,,1,1,7.848160431,19756,9323,9060,263,0,263
17669,9785,11138,0,2,36349,,,,,,1,1,7.390818332,18706,8666,8355,311,1,310
17669,9995,10545,2,2,35896,,,,,,1,1,7.504317813,18585,8498,8183,315,2,313
17669,9878,9736,7,2,35366,,,,,,1,1,7.1608401090000005,18475,8313,8048,265,4,261
17669,9539,9964,2,2,35508,,,,,,1,1,7.428215087,18482,8367,8075,292,4,288
17669,10985,11563,2,0,9576,,,,,,1,1,1.9406211629999999,4719,2308,2067,241,1,240
17669,10726,10317,2,2,35299,,,,,,1,1,7.66914426,18238,8379,8076,303,4,299
17669,10383,11786,0,0,2577,,,,,,1,1,0.540932456,1124,634,449,185,0,185
17669,10355,10827,2,4,35725,,,,,,1,1,7.68924159,18513,8432,8084,348,10,338
17669,9519,11657,0,4,34645,,,,,,1,1,7.265456493,17675,8331,8023,308,15,293
17669,11228,9217,3,0,35643,,,,,,1,1,7.365968588,18773,8286,7988,298,0,298
17669,8687,10486,0,2,38000,,,,,,1,1,7.846036454,18999,9348,9043,305,3,302
17669,8287,11605,0,2,36763,,,,,,1,1,7.747746797,18769,8848,8550,298,5,293
17669,9734,10847,2,2,36751,,,,,,1,1,7.913455364,18877,8789,8493,296,4,292
17669,12013,10523,0,2,30348,,,,,,1,1,6.215194184,14949,7523,7170,353,0,353
17669,9913,11662,0,1,37625,,,,,,1,1,7.640574751,18881,9213,8895,318,2,316
17669,11522,10429,6,0,34738,,,,,,1,1,7.089136723,18133,8139,7812,327,14,313
17669,10916,9003,0,0,36668,,,,,,1,1,7.60399419,18837,8758,8443,315,2,313
17669,11297,10610,0,0,36295,,,,,,1,1,7.5507264769999995,18500,8706,8323,383,3,380
17669,11452,10623,2,2,34292,,,,,,1,1,7.187789095,17753,8107,7782,325,10,315
17669,10570,9536,2,2,37948,,,,,,1,1,7.837971926,19172,9233,8923,310,2,308
17669,11952,10218,0,0,5948,,,,,,1,1,1.218696449,2878,1431,1223,208,0,208
17669,10796,9748,0,2,37230,,,,,,1,1,7.692639377,18768,9069,8745,324,2,322
17669,9668,10712,4,0,38534,,,,,,1,1,8.009242439,19152,9533,9217,316,8,308
17669,10446,9804,2,0,37277,,,,,,1,1,7.544429021,19092,8940,8635,305,6,299
17669,9070,9613,1,0,36145,,,,,,1,1,7.383742937,18912,8470,8177,293,2,291
17669,11573,8990,0,1,37044,,,,,,1,1,7.597094568,18756,8984,8664,320,2,318
17669,9549,11648,2,0,35475,,,,,,1,1,7.208247861,18357,8388,8046,342,12,330
17669,11782,10592,4,2,3753,,,,,,1,1,0.778083133,1687,940,754,186,1,185
17669,10102,10412,0,0,36785,,,,,,1,1,7.472018599,19076,8695,8376,319,1,318
17669,11655,10811,0,0,11934,,,,,,1,1,2.443713578,6208,2728,2458,270,1,269
17669,10328,9710,0,0,37701,,,,,,1,1,7.619675955,19095,9145,8829,316,5,311
17669,10289,9441,0,0,35467,,,,,,1,1,7.332247991,18788,8197,7912,285,5,280
17669,11222,10952,2,0,3245,,,,,,1,1,0.696861336,1521,777,607,170,1,169
17669,10496,10439,1,1,35749,,,,,,1,1,7.443045049,18652,8397,8094,303,4,299
17669,11369,10924,4,0,6522,,,,,,1,1,1.5173481629999999,3023,1633,1400,233,3,230
17669,8779,9262,0,3,38849,,,,,,1,1,7.899242193,19546,9523,9266,257,1,256
17669,8674,11416,0,2,37625,,,,,,1,1,7.743285328,19046,9140,8841,299,6,293
17669,11065,9689,6,2,37388,,,,,,1,1,7.708746495,19043,9020,8715,305,1,304
17669,11363,10807,2,0,17783,,,,,,1,1,3.65852684,9052,4240,3989,251,0,251
17669,9748,9048,0,4,35726,,,,,,1,1,7.269786448,18908,8276,8010,266,6,260
17669,10942,8966,2,0,37942,,,,,,1,1,7.6964347360000005,19119,9257,8948,309,2,307
17669,10196,10619,0,2,34156,,,,,,1,1,7.283115176,17988,7934,7634,300,3,297
17669,10701,10785,0,2,34919,,,,,,1,1,7.24084377,18381,8113,7801,312,1,311
17669,10683,9508,0,2,35966,,,,,,1,1,7.5824373099999995,18727,8453,8120,333,0,333
17669,11088,10901,1,3,36197,,,,,,1,1,7.850440395,18306,8766,8407,359,1,358
17669,10204,10221,0,0,35301,,,,,,1,1,7.22446209,18365,8320,8024,296,4,292
17669,11476,9800,0,4,37569,,,,,,1,1,7.630517759,19133,9056,8732,324,5,319
17669,11629,9182,2,0,35926,,,,,,1,1,7.507522219,18576,8522,8216,306,6,300
17669,8175,11577,2,5,36376,,,,,,1,1,7.615370035,18749,8669,8380,289,3,286
17669,10090,10447,0,0,37639,,,,,,1,1,7.693672468,18918,9204,8891,313,4,309
17669,9324,11229,4,0,33768,,,,,,1,1,7.030782438,17825,7831,7550,281,5,276
17669,10085,11023,2,2,34837,,,,,,1,1,7.299366415,18295,8115,7803,312,4,308
17669,10549,9468,2,4,36471,,,,,,1,1,7.543215181,18997,8600,8326,274,6,268
17669,10382,10766,2,2,36181,,,,,,1,1,7.446654689,18470,8697,8380,317,5,312
17669,11397,9582,0,2,37504,,,,,,1,1,7.792727299,18927,9134,8825,309,2,307
17669,10309,11892,2,0,4931,,,,,,1,1,1.008156931,2188,1267,1058,209,3,206
17669,10711,11460,0,0,9890,,,,,,1,1,1.9943986580000002,4850,2403,2169,234,0,234
17669,11026,10104,2,3,34658,,,,,,1,1,7.151316638,18098,8117,7791,326,3,323
17669,11142,10261,2,0,36784,,,,,,1,1,7.744956613,19003,8730,8409,321,1,320
17669,10927,9017,1,0,36298,,,,,,1,1,7.438487075,18555,8715,8402,313,2,311
17669,11092,10848,2,0,36057,,,,,,1,1,7.657254502,18719,8512,8198,314,1,313
17669,10306,9920,0,0,35435,,,,,,1,1,7.336545884,18580,8287,8006,281,6,275
17669,9362,11702,4,0,35683,,,,,,1,1,7.249819887,18090,8636,8315,321,12,309
17669,10023,10985,0,0,36580,,,,,,1,1,7.470673393,18215,9038,8749,289,0,289
17669,11051,11118,0,2,15377,,,,,,1,1,3.230497427,7791,3663,3403,260,1,259
17669,10144,11447,2,0,35720,,,,,,1,1,7.305327732,18167,8618,8301,317,3,314
17669,8873,9408,1,2,37302,,,,,,1,1,7.698418638,19213,8914,8653,261,1,260
17669,10459,9714,0,0,35265,,,,,,1,1,7.2860147,18142,8414,8119,295,1,294
17669,9280,10307,0,4,38345,,,,,,1,1,8.04236595,19244,9413,9138,275,3,272
17669,11658,10869,0,0,3947,,,,,,1,1,0.856453929,1895,935,753,182,1,181
17669,9743,11494,2,0,36061,,,,,,1,1,7.556841374,18489,8606,8246,360,3,357
17669,9207,10964,0,2,35367,,,,,,1,1,7.63179891,18306,8374,8061,313,3,310
17669,10663,10483,2,0,38077,,,,,,1,1,8.055967334,19289,9200,8812,388,4,384
17669,10260,11553,0,0,35714,,,,,,1,1,7.490910711,18371,8502,8163,339,3,336
17669,9587,8730,0,0,37238,,,,,,1,1,7.632192505,19015,8980,8717,263,3,260
17669,10938,10694,0,2,34264,,,,,,1,1,7.069492601,17834,8065,7765,300,8,292
17669,9853,11481,0,0,35085,,,,,,1,1,7.719751048,18346,8215,7906,309,3,306
17669,10338,11480,2,0,35354,,,,,,1,1,7.477809326,18288,8366,8032,334,0,334
17669,10869,9971,0,0,31998,,,,,,1,1,6.77510784,16998,7358,7074,284,1,283
17669,9812,10591,0,0,35633,,,,,,1,1,7.2798968649999996,18791,8284,8010,274,2,272
17669,9877,10511,0,0,36434,,,,,,1,1,7.7018315269999995,18866,8634,8334,300,1,299
17669,9690,10568,4,0,35319,,,,,,1,1,7.222418433,18328,8356,8077,279,1,278
17669,8738,10186,0,1,37953,,,,,,1,1,7.678904941,19390,9149,8884,265,3,262
17669,10485,11156,0,0,35295,,,,,,1,1,7.290405247,18286,8351,8044,307,1,306
17669,11694,10519,3,2,19251,,,,,,1,1,3.999393723,10046,4466,4193,273,0,273
17669,10754,10608,4,0,34001,,,,,,1,1,7.049369735,17333,8195,7917,278,2,276
17669,10948,10738,2,2,35985,,,,,,1,1,7.428081547,18341,8658,8330,328,6,322
17669,9775,10021,0,0,34507,,,,,,1,1,7.146055823,18073,8078,7800,278,5,273
17669,11513,10659,0,0,13293,,,,,,1,1,2.7585708970000002,6523,3246,2968,278,0,278
17669,10423,11005,0,0,35148,,,,,,1,1,7.376120187,18145,8339,8014,325,2,323
17669,11214,9860,4,2,34699,,,,,,1,1,7.117831835,18109,8138,7824,314,16,298
17669,9047,10326,0,0,35862,,,,,,1,1,7.418094791,18396,8583,8283,300,0,300
17669,9136,9123,2,1,38535,,,,,,1,1,7.802998101,19692,9289,9024,265,4,261
17669,10737,10401,0,0,37328,,,,,,1,1,7.576563253,18723,9159,8872,287,0,287
17669,9888,11664,0,4,36141,,,,,,1,1,7.458674999,18535,8629,8281,348,17,331
17669,9560,9700,0,2,37079,,,,,,1,1,7.49534131,18988,8898,8603,295,9,286
17669,10338,10408,1,1,36419,,,,,,1,1,7.730461352,18567,8771,8461,310,3,307
17669,11599,10673,0,3,16938,,,,,,1,1,3.541347873,8617,4016,3727,289,0,289
17669,11273,10484,0,2,34404,,,,,,1,1,7.037091252,18146,7983,7691,292,0,292
17669,10012,10814,6,2,35328,,,,,,1,1,7.488769396,18105,8449,8124,325,15,310
17669,10733,10585,0,2,36380,,,,,,1,1,7.642986826,18662,8700,8382,318,7,311
17669,9570,11076,2,0,34872,,,,,,1,1,7.128764535,18252,8167,7881,286,0,286
17669,11859,9603,2,0,35392,,,,,,1,1,7.331275444,18039,8530,8237,293,2,291
17669,10448,9439,0,0,35514,,,,,,1,1,7.486338991,18427,8406,8131,275,0,275
17669,9106,11016,0,0,36864,,,,,,1,1,7.593670211,18977,8792,8489,303,1,302
17669,11442,10727,0,0,4483,,,,,,1,1,0.925078143,2154,1067,872,195,1,194
17669,12398,9813,2,0,17307,,,,,,1,1,3.606853102,8774,4118,3821,297,2,295
17669,10617,10554,2,0,34763,,,,,,1,1,6.999172918,18207,8128,7828,300,6,294
17669,11478,10591,0,4,36558,,,,,,1,1,7.381546866,18318,8951,8613,338,3,335
17669,11096,11074,0,4,4435,,,,,,1,1,1.016084363,2047,1105,927,178,2,176
17669,9642,9345,0,0,36692,,,,,,1,1,7.840185811,19026,8695,8419,276,3,273
17669,9572,9736,0,0,38828,,,,,,1,1,8.193662971,19413,9554,9247,307,4,303
17669,11286,8778,4,0,38216,,,,,,1,1,8.212021459,19264,9304,8960,344,3,341
17669,11314,11169,1,0,5575,,,,,,1,1,1.165994613,2577,1388,1166,222,0,222
17669,9576,10267,2,0,36003,,,,,,1,1,7.423034558,18840,8439,8154,285,7,278
17669,8555,9775,0,0,36681,,,,,,1,1,7.787165765,18859,8767,8479,288,1,287
17669,10779,9900,3,0,35809,,,,,,1,1,7.5200062800000005,18565,8468,8160,308,1,307
17669,10634,9222,2,0,39662,,,,,,1,1,8.075563173,19899,9708,9361,347,0,347
17669,9848,11027,0,0,36547,,,,,,1,1,7.67881128,18605,8811,8491,320,1,319
17669,9628,9453,0,2,36620,,,,,,1,1,7.539580823,18935,8705,8430,275,2,273
17669,9829,10805,0,0,34282,,,,,,1,1,7.191431305,18118,7949,7683,266,0,266
17669,9329,10272,2,0,36937,,,,,,1,1,7.539623044,19201,8729,8451,278,9,269
17669,12029,9965,0,0,35373,,,,,,1,1,7.355831616,18328,8357,8026,331,2,329
17669,10017,10096,0,4,38493,,,,,,1,1,7.971778948,19690,9246,8935,311,0,311
17669,10548,11631,0,2,2752,,,,,,1,1,0.562949193,1162,716,558,158,1,157
17669,9929,11881,2,2,36315,,,,,,1,1,7.437981604,18258,8875,8568,307,0,307
17669,10219,9006,2,0,34599,,,,,,1,1,7.068460388,18273,8042,7800,242,4,238
17669,10539,11483,0,0,34706,,,,,,1,1,7.184507738,18122,8137,7827,310,1,309
17669,11809,9792,0,2,37027,,,,,,1,1,7.493834649,19069,8806,8460,346,8,338
17669,8455,9958,2,2,36642,,,,,,1,1,7.412372998,18947,8714,8447,267,2,265
17669,10629,10716,7,0,36226,,,,,,1,1,7.487431976,18665,8622,8305,317,6,311
17669,10010,10326,0,0,37461,,,,,,1,1,7.613617941,18725,9214,8906,308,0,308
17669,10970,10154,2,2,35670,,,,,,1,1,7.36365612,18230,8562,8246,316,13,303
17669,9543,9257,0,0,36629,,,,,,1,1,7.386621054,18765,8783,8485,298,2,296
17669,10725,11445,0,0,18180,,,,,,1,1,3.729482112,8959,4456,4147,309,2,307
17669,9501,10378,1,0,39832,,,,,,1,1,7.983472121,19741,9862,9495,367,1,366
17669,10218,11621,2,2,36496,,,,,,1,1,7.472856376,18747,8715,8396,319,4,315
17669,9377,11126,0,0,36536,,,,,,1,1,7.475047287,18628,8788,8456,332,2,330
17669,10678,10921,5,2,35824,,,,,,1,1,7.424790615,18300,8597,8267,330,1,329
17669,9282,10863,1,0,37006,,,,,,1,1,7.884277234,18973,8857,8538,319,1,318
17669,11081,9198,4,0,36131,,,,,,1,1,7.683899685,18733,8550,8252,298,2,296
17669,10642,11555,0,2,12320,,,,,,1,1,2.482630001,6072,2993,2731,262,2,260
17669,8577,10229,2,2,37748,,,,,,1,1,8.068383558,19275,9090,8797,293,11,282
17669,10715,9479,0,2,36678,,,,,,1,1,7.615839461,19092,8626,8292,334,6,328
17669,10203,11471,2,4,34992,,,,,,1,1,7.256256217,17942,8350,8000,350,7,343
17669,10708,9802,3,2,36505,,,,,,1,1,7.503702594,18448,8879,8580,299,8,291
17669,10481,10230,0,0,38568,,,,,,1,1,7.754097106,19191,9530,9213,317,1,316
17669,10939,11511,2,3,27499,,,,,,1,1,5.718836097,14234,6473,6154,319,2,317
17669,9489,11382,0,0,34112,,,,,,1,1,7.146324518,17940,7933,7627,306,2,304
17669,11116,11210,0,0,1822,,,,,,1,1,0.368567321,780,455,323,132,0,132
17669,10154,10162,0,0,35100,,,,,,1,1,7.406408635,18075,8356,8043,313,1,312
17669,9541,11380,0,2,36854,,,,,,1,1,7.659763625,18869,8848,8559,289,1,288
17669,8881,10197,0,0,39457,,,,,,1,1,8.209800029,19972,9595,9300,295,0,295
17669,10765,11042,0,2,36980,,,,,,1,1,7.466443936,18685,8974,8627,347,2,345
17669,9393,7828,0,0,38409,,,,,,1,1,7.931258578,19363,9376,9082,294,3,291
17669,10578,9485,4,2,36953,,,,,,1,1,7.6055441550000005,18992,8831,8532,299,3,296
17669,10475,11145,0,2,35888,,,,,,1,1,7.521728151,18599,8480,8151,329,4,325
17669,8825,9915,2,4,37972,,,,,,1,1,7.784144768,19319,9187,8908,279,5,274
17669,10803,9932,0,4,35806,,,,,,1,1,7.437385505,18769,8375,8088,287,2,285
17669,11033,11156,2,2,3359,,,,,,1,1,0.683278021,1562,810,633,177,1,176
17669,10333,10046,2,0,34760,,,,,,1,1,7.096791239,18240,8117,7831,286,6,280
17669,10996,10983,1,0,36015,,,,,,1,1,7.687237717,18561,8551,8199,352,5,347
17669,10210,9359,3,2,37118,,,,,,1,1,7.591309681,18877,8983,8708,275,6,269
17669,10766,10629,1,4,37142,,,,,,1,1,7.630037151,18898,8950,8606,344,8,336
17669,9920,11774,2,0,34836,,,,,,1,1,7.252972179,18231,8123,7764,359,1,358
17669,9444,10991,5,0,34709,,,,,,1,1,7.289868051,18498,7955,7654,301,1,300
17669,10280,9746,0,2,36619,,,,,,1,1,7.551688443,18731,8793,8491,302,2,300
17669,10591,10064,0,2,36121,,,,,,1,1,7.724479097,18680,8563,8248,315,1,314
17669,10852,9485,4,0,36012,,,,,,1,1,7.61187823,18613,8555,8266,289,3,286
17669,8840,10701,0,0,37170,,,,,,1,1,7.821044471,19105,8873,8554,319,1,318
17669,10369,10482,0,4,35973,,,,,,1,1,7.482334618,18778,8447,8146,301,1,300
17669,10223,8637,0,0,38045,,,,,,1,1,7.817312244,19448,9163,8892,271,1,270
17669,9544,11344,2,2,36151,,,,,,1,1,7.349255205,18829,8508,8202,306,1,305
17669,9843,9819,7,0,35634,,,,,,1,1,7.190539723,18179,8594,8327,267,7,260
17669,10639,9940,0,2,36578,,,,,,1,1,7.93972556,18952,8665,8369,296,2,294
17669,10347,8033,0,0,38101,,,,,,1,1,7.78501039,19554,9142,8879,263,5,258
17669,10294,11128,0,2,34056,,,,,,1,1,7.482450772,17799,7966,7641,325,7,318
17669,11075,9741,0,2,34712,,,,,,1,1,7.121761017,18246,8087,7795,292,4,288
17669,10782,11511,2,2,30710,,,,,,1,1,6.634624687,15607,7392,7073,319,0,319
17669,8269,10987,0,2,37087,,,,,,1,1,7.582787101,19046,8881,8602,279,2,277
17669,11552,10221,4,6,35694,,,,,,1,1,7.337171946,18435,8478,8175,303,10,293
17669,10259,10149,3,2,34710,,,,,,1,1,7.056285895,18117,8177,7938,239,2,237
17669,11021,11149,0,2,20429,,,,,,1,1,4.136395286,10311,4928,4666,262,6,256
17669,10152,10133,0,2,36165,,,,,,1,1,7.511677212,18704,8579,8276,303,3,300
17669,10016,10626,5,2,35658,,,,,,1,1,7.287076772,18679,8346,8059,287,9,278
17669,10464,9024,2,0,35542,,,,,,1,1,7.244765765,18735,8255,7958,297,1,296
17669,8607,9613,1,2,37905,,,,,,1,1,8.103800261,19515,9051,8763,288,3,285
17669,10927,10069,0,0,36209,,,,,,1,1,7.455049028,18590,8666,8379,287,2,285
17669,10534,9451,6,0,36050,,,,,,1,1,7.5875851,18783,8505,8248,257,1,256
17669,10359,11804,1,0,33644,,,,,,1,1,7.136810244,17792,7775,7473,302,2,300
17669,9938,10639,0,0,35634,,,,,,1,1,7.993385123,18511,8411,8110,301,3,298
17669,9770,9921,2,0,37773,,,,,,1,1,7.924948011,19045,9203,8881,322,6,316
17669,11713,10608,0,2,4756,,,,,,1,1,0.970650733,2203,1186,1005,181,0,181
17669,8604,10786,0,0,35116,,,,,,1,1,7.284841928,18299,8265,7978,287,2,285
17669,11319,9249,0,2,35648,,,,,,1,1,7.447555561,18509,8420,8121,299,3,296
17669,10887,10116,1,0,37307,,,,,,1,1,8.092848109,18956,9007,8670,337,3,334
17669,10575,9688,0,0,35534,,,,,,1,1,7.298399935,18440,8404,8118,286,2,284
17669,11016,9995,1,0,34653,,,,,,1,1,7.206058232,18077,8134,7826,308,3,305
17669,10008,10977,0,2,36559,,,,,,1,1,7.771813249,18399,8916,8588,328,1,327
17669,10013,10124,0,2,36718,,,,,,1,1,7.62275655,18788,8802,8476,326,2,324
17669,10967,8778,0,0,36867,,,,,,1,1,7.766225758,18986,8785,8474,311,1,310
17669,11691,9550,0,0,34188,,,,,,1,1,7.34464481,17867,8009,7706,303,4,299
17669,9995,12184,0,2,2801,,,,,,1,1,0.644606417,1201,722,566,156,1,155
17669,10848,10514,0,0,36650,,,,,,1,1,7.652656466,19000,8673,8369,304,2,302
17669,10951,10414,0,1,35709,,,,,,1,1,7.734206599,18527,8426,8096,330,2,328
17669,8799,10213,0,0,38003,,,,,,1,1,8.101732618,19188,9272,9001,271,0,271
17669,11313,10989,0,0,17221,,,,,,1,1,3.5813075640000003,8887,4016,3714,302,3,299
17669,10575,10823,3,2,37857,,,,,,1,1,8.100021026,19401,9053,8703,350,0,350
17669,10332,10332,4,4,37199,,,,,,1,1,8.055379126,19100,8900,8601,299,1,298
17669,10875,10663,0,0,35372,,,,,,1,1,7.405370319,18360,8363,8077,286,2,284
17669,10770,11669,2,0,3104,,,,,,1,1,0.628899031,1383,775,604,171,0,171
17669,11186,10163,0,0,37907,,,,,,1,1,8.021206573,19407,9082,8746,336,2,334
17669,12133,10039,2,0,6840,,,,,,1,1,1.429365404,3205,1689,1432,257,7,250
17669,10919,11251,0,0,9327,,,,,,1,1,1.902251331,4632,2232,2001,231,0,231
17669,10139,9310,0,0,36100,,,,,,1,1,7.518615949,18713,8552,8269,283,4,279
17669,11051,10122,0,0,36252,,,,,,1,1,7.897490712,18397,8749,8392,357,5,352
17669,8455,9585,2,0,36642,,,,,,1,1,7.770754456,18656,8858,8588,270,2,268
17669,10773,10762,0,0,36130,,,,,,1,1,7.692453051,18469,8669,8346,323,0,323
17669,9404,11104,0,0,35724,,,,,,1,1,7.55015406,18576,8423,8121,302,1,301
17669,10024,8202,2,0,37882,,,,,,1,1,7.920063295,19353,9133,8870,263,7,256
17669,10601,10893,0,0,37243,,,,,,1,1,7.685840929,19029,8935,8591,344,2,342
17669,11167,10821,0,3,33645,,,,,,1,1,7.351372086,17880,7715,7380,335,0,335
17669,10488,10576,4,0,36320,,,,,,1,1,7.534046911,18521,8738,8415,323,15,308
17669,10713,10568,2,2,34701,,,,,,1,1,7.410149623,18107,8146,7844,302,7,295
17669,8640,10402,0,2,37093,,,,,,1,1,7.763556568,19016,8902,8629,273,3,270
17669,11275,10503,2,0,38038,,,,,,1,1,7.767113401,19208,9253,8929,324,0,324
17669,10134,10446,0,0,36172,,,,,,1,1,7.427398481,18693,8600,8321,279,0,279
17669,10654,10291,0,2,37972,,,,,,1,1,7.80764486,19379,9128,8791,337,7,330
17669,9717,9993,0,2,35406,,,,,,1,1,7.440328208,18431,8361,8108,253,2,251
17669,11429,8548,3,0,36681,,,,,,1,1,7.520897501,18840,8780,8499,281,2,279
17669,8810,10726,0,3,37814,,,,,,1,1,8.094627624,19332,9078,8752,326,5,321
17669,11256,10957,0,0,16921,,,,,,1,1,3.509503478,8829,3911,3641,270,0,270
17669,10544,8425,0,0,35919,,,,,,1,1,7.832100895,18326,8653,8366,287,8,279
17669,10425,9983,2,2,37501,,,,,,1,1,7.7528160029999995,19351,8914,8592,322,3,319
17669,9747,11460,0,3,36183,,,,,,1,1,7.414821363,18364,8750,8431,319,3,316
17669,11035,9978,0,0,34525,,,,,,1,1,7.121338485,17916,8166,7889,277,0,277
17669,11337,8526,2,1,37467,,,,,,1,1,8.018690235,18972,9105,8820,285,2,283
17669,11720,10449,0,2,24722,,,,,,1,1,5.307455255,12567,5938,5659,279,2,277
17669,10061,10387,0,3,38042,,,,,,1,1,7.936278169,19304,9197,8853,344,3,341
17669,11099,8953,2,0,36257,,,,,,1,1,7.635796915,18864,8559,8284,275,1,274
17669,9277,10223,2,2,37132,,,,,,1,1,7.739622068,18834,8995,8687,308,1,307
17669,10094,10775,4,0,35609,,,,,,1,1,7.467715663,18652,8342,8069,273,6,267
17669,11966,10210,2,0,13188,,,,,,1,1,2.710603839,6801,3067,2814,253,3,250
17669,10796,10889,0,0,37460,,,,,,1,1,8.05251543,19175,8974,8637,337,2,335
17669,9873,10546,1,2,34120,,,,,,1,1,7.314116275,17968,7951,7701,250,1,249
17669,9900,10264,2,0,35883,,,,,,1,1,7.99747998,18335,8624,8324,300,0,300
17669,12590,9412,3,0,35010,,,,,,1,1,7.264735946,18044,8330,8024,306,1,305
17669,11716,9612,0,2,37267,,,,,,1,1,7.779327273,18375,9277,8939,338,3,335
17669,10703,9337,0,2,37079,,,,,,1,1,7.608134872,18921,8937,8653,284,9,275
17669,10050,8167,2,0,36678,,,,,,1,1,7.464034733,18935,8756,8525,231,8,223
17669,10393,10172,5,0,37082,,,,,,1,1,7.539655802,18841,8956,8627,329,0,329
17669,9694,10179,0,0,37788,,,,,,1,1,7.632289896,19294,9099,8803,296,2,294
17669,10252,12047,0,2,8851,,,,,,1,1,1.857355782,4353,2144,1934,210,5,205
17669,11226,10484,3,3,37828,,,,,,1,1,8.063522142,19258,9117,8781,336,2,334
17669,10628,10177,0,0,34716,,,,,,1,1,7.147559369,18196,8114,7822,292,0,292
17669,11050,9175,1,0,35077,,,,,,1,1,7.398859828,18354,8215,7922,293,3,290
17669,10926,9892,0,0,34812,,,,,,1,1,7.270779335,18153,8168,7845,323,2,321
17669,11050,11120,0,0,2945,,,,,,1,1,0.640403974,1256,758,585,173,0,173
17669,10084,10381,4,2,35841,,,,,,1,1,7.742605528,18489,8535,8253,282,2,280
17669,10306,10725,4,0,35603,,,,,,1,1,7.499354051,18497,8393,8073,320,6,314
17669,10073,10090,0,0,37013,,,,,,1,1,7.726343041,18864,8902,8557,345,0,345
17669,11314,10644,0,0,33726,,,,,,1,1,7.518265514,17712,7848,7530,318,1,317
17669,10826,10280,0,3,36048,,,,,,1,1,7.482023899,18545,8609,8324,285,2,283
17669,10516,10759,2,0,36011,,,,,,1,1,7.416058456,18547,8576,8264,312,2,310
17669,11049,10704,0,1,35699,,,,,,1,1,7.803939197,18476,8449,8124,325,3,322
17669,10299,11469,2,2,35319,,,,,,1,1,7.486865202,18235,8362,8002,360,5,355
17669,9898,9902,2,0,37645,,,,,,1,1,7.696105082,18916,9217,8922,295,1,294
17669,9745,11230,2,2,37000,,,,,,1,1,7.703551388,18729,8976,8657,319,3,316
17669,9571,10612,2,0,37041,,,,,,1,1,7.98535694,18744,8990,8673,317,6,311
17669,10554,9409,2,2,38333,,,,,,1,1,8.333465779,19355,9337,9033,304,15,289
17669,10792,9939,0,2,35729,,,,,,1,1,7.56423273,18907,8256,7946,310,0,310
17669,9960,10091,4,2,36700,,,,,,1,1,7.839307253,18727,8838,8541,297,3,294
17669,10828,10044,2,0,36520,,,,,,1,1,7.887448078,18655,8769,8442,327,3,324
17669,9572,10119,2,0,34730,,,,,,1,1,7.190892598,18271,8102,7847,255,2,253
17669,11164,10203,2,0,35933,,,,,,1,1,7.257984871,18344,8623,8280,343,4,339
17669,11125,8668,2,2,36487,,,,,,1,1,8.036455286,18977,8612,8326,286,3,283
17669,10736,11165,0,0,33819,,,,,,1,1,6.991760695,17779,7855,7525,330,1,329
17669,10751,10728,4,0,35765,,,,,,1,1,7.297384376,18237,8604,8284,320,7,313
17669,9687,11220,0,0,38839,,,,,,1,1,7.987927302,19443,9515,9149,366,0,366
17669,10470,11702,0,2,8105,,,,,,1,1,1.6455997,3941,1962,1722,240,4,236
17669,10152,9606,2,1,37109,,,,,,1,1,7.854225093,18935,8931,8619,312,2,310
17669,10316,11241,2,11,34987,,,,,,1,1,7.397574182,18086,8315,8044,271,8,263
17669,10808,9864,0,3,37052,,,,,,1,1,7.822607757,19338,8684,8338,346,2,344
17669,12095,9659,6,0,36157,,,,,,1,1,7.867727644,18014,8912,8593,319,8,311
17669,10791,10197,0,0,37598,,,,,,1,1,8.021883386,18961,9140,8783,357,1,356
17669,9812,9487,0,2,36556,,,,,,1,1,7.617654671,18664,8804,8520,284,2,282
17669,11082,11378,2,0,5163,,,,,,1,1,1.058076323,2428,1261,1048,213,2,211
17669,8118,11337,0,3,38963,,,,,,1,1,7.988739555,19355,9643,9321,322,7,315
17669,10530,9592,0,6,34429,,,,,,1,1,6.959298454,18303,7937,7685,252,3,249
17669,10899,11023,2,2,34401,,,,,,1,1,7.249431887,18120,7985,7674,311,1,310
17669,10300,9739,0,0,37032,,,,,,1,1,7.5106109,19004,8856,8540,316,1,315
17669,11008,10070,0,2,39016,,,,,,1,1,7.9819024,19373,9644,9289,355,4,351
17669,10462,10129,4,2,37230,,,,,,1,1,7.640839909,18837,9043,8736,307,4,303
17669,10662,10487,2,0,36919,,,,,,1,1,7.683956974,18396,9111,8810,301,3,298
17669,9201,8844,2,0,36806,,,,,,1,1,7.533057861,19134,8721,8491,230,4,226
17669,11913,8473,0,0,35487,,,,,,1,1,7.180660296,18234,8483,8196,287,2,285
17669,10898,10531,4,2,36128,,,,,,1,1,7.367812365,18740,8543,8241,302,2,300
17669,9774,11116,0,3,36478,,,,,,1,1,7.470527272,18640,8757,8433,324,5,319
17669,10293,9605,0,2,37840,,,,,,1,1,7.805217006,19312,9096,8760,336,14,322
17669,10084,9240,0,4,38830,,,,,,1,1,8.031155912,19350,9596,9308,288,4,284
17669,9697,11280,2,2,35319,,,,,,1,1,7.315862646,18446,8282,7973,309,4,305
17669,8569,10498,0,1,38405,,,,,,1,1,7.720749617,19513,9299,9005,294,8,286
17669,9081,9745,0,2,36107,,,,,,1,1,7.607527643,18438,8694,8413,281,2,279
17669,9780,10578,1,0,36592,,,,,,1,1,7.508355066,18871,8710,8409,301,2,299
17669,10897,11272,0,4,21779,,,,,,1,1,4.5223280710000004,10911,5269,4939,330,3,327
17669,9501,11105,1,2,38476,,,,,,1,1,7.716164029,19499,9329,9010,319,1,318
17669,10085,11308,3,4,34584,,,,,,1,1,7.198703843,17849,8212,7901,311,10,301
17669,10686,11490,0,2,1830,,,,,,1,1,0.377461295,755,462,311,151,0,151
17669,10899,8981,0,2,37074,,,,,,1,1,7.539143328,18719,9031,8738,293,0,293
17669,10903,9988,2,2,34011,,,,,,1,1,7.145997407,17679,8009,7695,314,6,308
17669,10485,11730,0,2,15023,,,,,,1,1,3.033551029,7646,3556,3291,265,4,261
17669,9768,10619,0,0,37738,,,,,,1,1,7.821403402,19168,9124,8802,322,3,319
17669,10598,9623,0,0,34865,,,,,,1,1,7.255595829,18411,8085,7801,284,2,282
17669,10475,10664,0,0,36597,,,,,,1,1,7.740790801,18709,8796,8500,296,2,294
17669,9918,9533,0,0,34399,,,,,,1,1,7.13153226,18172,7966,7671,295,2,293
17669,9068,10875,0,3,35372,,,,,,1,1,7.185431288,18622,8231,7943,288,6,282
17669,9501,8826,2,0,35146,,,,,,1,1,7.160751351,18734,8086,7846,240,1,239
17669,9851,10557,2,0,35297,,,,,,1,1,7.154099223,18354,8333,8056,277,0,277
17669,9667,11666,2,3,34748,,,,,,1,1,7.319183378,18226,8096,7766,330,9,321
17669,10941,10178,0,3,35207,,,,,,1,1,7.2398636100000004,17960,8465,8148,317,0,317
17669,10383,11610,0,0,33593,,,,,,1,1,6.913493238,17747,7769,7461,308,0,308
17669,10744,9793,0,0,36244,,,,,,1,1,7.405966529,18706,8628,8346,282,0,282
17669,9274,10514,0,2,36233,,,,,,1,1,7.3418760800000005,18580,8686,8405,281,2,279
17669,10522,9286,0,0,37163,,,,,,1,1,7.644060552,19186,8857,8594,263,1,262
17669,10379,10856,0,0,36027,,,,,,1,1,7.586003825,18344,8692,8393,299,0,299
17669,11604,8925,3,0,36174,,,,,,1,1,7.501081361,18275,8806,8519,287,0,287
17669,10932,10701,3,2,33691,,,,,,1,1,6.856798777,17704,7834,7515,319,2,317
17669,10082,12089,0,2,14103,,,,,,1,1,3.017864594,7129,3357,3097,260,6,254
17669,9421,10205,2,0,36576,,,,,,1,1,7.437639656,18881,8695,8390,305,3,302
17669,9947,9229,0,0,38388,,,,,,1,1,7.799471413,19207,9460,9199,261,2,259
17669,9813,9728,2,0,34159,,,,,,1,1,7.203056557,18054,7931,7688,243,3,240
17669,10836,11176,4,4,33210,,,,,,1,1,6.964374832,17477,7719,7424,295,7,288
17669,10567,9137,5,0,37719,,,,,,1,1,7.77886634,19175,9110,8786,324,16,308
17669,9485,9459,2,0,37305,,,,,,1,1,7.591490905,18895,9059,8767,292,2,290
17669,10381,10398,0,0,35947,,,,,,1,1,7.391259243,18591,8523,8213,310,1,309
17669,10920,11024,2,0,35748,,,,,,1,1,7.324965983,18547,8447,8140,307,0,307
17669,11334,9706,0,0,36146,,,,,,1,1,7.66513559,18640,8597,8285,312,2,310
17669,11191,11171,0,0,12228,,,,,,1,1,2.551475316,6125,2913,2636,277,2,275
17669,11258,10916,0,2,8046,,,,,,1,1,1.638994398,3893,1965,1742,223,0,223
17669,9276,11403,0,0,37354,,,,,,1,1,7.779071141,18990,9016,8684,332,2,330
17669,10713,9239,0,0,35899,,,,,,1,1,7.470158987,18710,8447,8152,295,4,291
17669,10916,11040,5,0,35092,,,,,,1,1,7.27828114,18142,8315,7995,320,3,317
17669,10491,11678,2,2,7982,,,,,,1,1,1.618820827,3669,2034,1789,245,3,242
17669,9251,8511,3,0,38507,,,,,,1,1,8.023255716,19662,9285,9010,275,1,274
17669,11215,8866,2,0,36538,,,,,,1,1,7.426766068,18610,8816,8520,296,4,292
17669,8398,10527,0,0,36728,,,,,,1,1,7.708826934,19125,8662,8383,279,2,277
17669,11298,10884,0,4,29051,,,,,,1,1,5.913279502,14914,6902,6569,333,17,316
17669,9335,8955,0,0,36316,,,,,,1,1,7.364573039,18474,8788,8522,266,0,266
17669,9344,8593,0,0,37028,,,,,,1,1,7.746342503,19219,8773,8510,263,3,260
17669,9772,9768,2,0,35920,,,,,,1,1,7.440328644,18826,8402,8112,290,2,288
17669,10846,11352,0,2,4326,,,,,,1,1,0.884991575,1903,1097,868,229,0,229
17669,9259,10218,0,0,37700,,,,,,1,1,7.648281384,19441,8974,8663,311,3,308
17669,9887,10698,0,0,36435,,,,,,1,1,7.454830018,18519,8797,8475,322,5,317
17669,10927,10416,0,4,36971,,,,,,1,1,7.536419129,18832,8901,8564,337,4,333
17669,12079,8918,3,2,33975,,,,,,1,1,6.905892005,17565,8056,7758,298,0,298
17669,7844,10127,0,2,37720,,,,,,1,1,7.609228053,19272,9087,8813,274,1,273
17669,10507,9415,2,2,35638,,,,,,1,1,7.298877732,18349,8509,8238,271,8,263
17669,11212,10479,2,2,33318,,,,,,1,1,6.865190165,17619,7693,7380,313,3,310
17669,10880,10394,0,0,37482,,,,,,1,1,7.555509691,19202,8975,8645,330,0,330
17669,9916,10729,0,2,35765,,,,,,1,1,7.288534456,18589,8438,8138,300,3,297
17669,10738,9025,4,0,34629,,,,,,1,1,7.101715439,18376,7990,7717,273,6,267
17669,11530,10702,6,2,17468,,,,,,1,1,3.704946338,9294,3960,3706,254,2,252
17669,10550,9399,4,0,37818,,,,,,1,1,7.709993727,19265,9117,8798,319,5,314
17669,10530,11641,0,0,6493,,,,,,1,1,1.33791489,3216,1549,1370,179,0,179
17669,10618,9900,2,4,36552,,,,,,1,1,7.728397305,18590,8824,8510,314,12,302
17669,10053,11440,2,0,33524,,,,,,1,1,6.863818538,17208,8018,7738,280,1,279
17669,10122,11157,0,0,35513,,,,,,1,1,7.388750941,18113,8532,8196,336,1,335
17669,11324,9101,3,0,36945,,,,,,1,1,7.820208838,18994,8833,8548,285,0,285
17669,10205,11107,2,4,34953,,,,,,1,1,7.353908891,17860,8403,8116,287,4,283
17669,11341,10426,0,0,36556,,,,,,1,1,7.501628246,19152,8532,8192,340,5,335
17669,7595,9782,0,1,39155,,,,,,1,1,8.068200638,19842,9509,9214,295,2,293
17669,10586,11291,0,4,36082,,,,,,1,1,7.815853638,18410,8669,8335,334,4,330
17669,11275,10457,4,2,36173,,,,,,1,1,7.965792646,18147,8845,8509,336,7,329
17669,11405,10766,0,0,18077,,,,,,1,1,4.112774245,9241,4272,3980,292,0,292
17669,10981,9751,2,0,35485,,,,,,1,1,7.518208671,18477,8361,8075,286,4,282
17669,11474,10695,0,0,14929,,,,,,1,1,3.278920856,7402,3626,3351,275,0,275
17669,10672,11191,0,6,33974,,,,,,1,1,7.550555119,17760,7957,7657,300,4,296
17669,10588,9139,0,2,35880,,,,,,1,1,7.778012503,18319,8651,8392,259,6,253
17669,11052,11119,0,0,5307,,,,,,1,1,1.296314959,2494,1305,1102,203,0,203
17669,10999,9651,4,0,35933,,,,,,1,1,8.033236047,18176,8719,8400,319,12,307
17669,11197,10184,0,6,35066,,,,,,1,1,7.541116233,17959,8407,8114,293,4,289
17669,11825,10408,0,0,2958,,,,,,1,1,0.603997948,1331,733,572,161,0,161
17669,9817,9269,2,2,36076,,,,,,1,1,7.861832902,18727,8534,8253,281,6,275
17669,10553,10568,0,0,37599,,,,,,1,1,8.22121268,19388,8940,8609,331,3,328
17669,9040,11463,0,0,35055,,,,,,1,1,7.7835026339999995,18480,8134,7827,307,8,299
17669,10137,9631,0,0,35092,,,,,,1,1,7.888144641,18262,8284,8022,262,0,262
17669,9557,10624,3,1,36713,,,,,,1,1,7.895220213,18736,8817,8474,343,16,327
17669,10258,11395,2,0,36354,,,,,,1,1,7.752343814,18800,8613,8285,328,0,328
17669,8934,9722,0,0,38545,,,,,,1,1,8.447232018,19554,9327,8990,337,1,336
17669,11354,10366,2,0,35359,,,,,,1,1,7.6562504449999995,18136,8449,8124,325,3,322
17669,10798,10644,2,0,36090,,,,,,1,1,7.754210297,18505,8622,8281,341,5,336
17669,9436,9822,0,4,37433,,,,,,1,1,8.086137737,19269,8946,8674,272,4,268
17669,11808,10704,0,0,7058,,,,,,1,1,1.431570457,3419,1714,1503,211,0,211
17669,10548,10857,0,0,37905,,,,,,1,1,8.422344083,19319,9120,8774,346,1,345
17669,10937,9791,0,0,35290,,,,,,1,1,7.753890338,18463,8279,8010,269,0,269
17669,11471,10134,5,0,36797,,,,,,1,1,7.760028491,18440,9017,8694,323,4,319
17669,10717,10114,2,0,34295,,,,,,1,1,7.438615296,18094,7966,7697,269,2,267
17669,8957,10269,0,0,36444,,,,,,1,1,7.854303887,18870,8637,8337,300,2,298
17669,10636,10744,1,4,37089,,,,,,1,1,8.201824701,18630,9064,8733,331,21,310
17669,10535,9986,0,2,36958,,,,,,1,1,7.747895097,18994,8815,8481,334,1,333
17669,10001,10400,2,0,37225,,,,,,1,1,8.238218176,18874,9032,8745,287,0,287
17669,11031,8703,0,0,33957,,,,,,1,1,7.15546458,17905,7901,7651,250,1,249
17669,9258,11466,0,2,36257,,,,,,1,1,7.493720053,18431,8753,8433,320,7,313
17669,10777,9572,0,0,35346,,,,,,1,1,7.242383123,18427,8319,8038,281,4,277
17669,9148,11160,0,0,35942,,,,,,1,1,7.557411017,18683,8491,8214,277,1,276
17669,11230,10946,0,0,6401,,,,,,1,1,1.335252278,3087,1550,1336,214,0,214
17669,9953,9421,0,0,36128,,,,,,1,1,7.547991098,18809,8523,8250,273,2,271
17669,10080,10268,0,0,36468,,,,,,1,1,8.110629182,18973,8587,8266,321,2,319
17669,9463,11441,0,2,35913,,,,,,1,1,7.773125725,18447,8581,8277,304,4,300
17669,10611,9278,2,0,35285,,,,,,1,1,7.383124041,18625,8194,7922,272,4,268
17669,10034,10955,3,2,34171,,,,,,1,1,7.224371642,17745,8071,7787,284,6,278
17669,9433,10467,0,0,35656,,,,,,1,1,7.631675397,18308,8526,8230,296,2,294
17669,10589,10685,0,2,36374,,,,,,1,1,7.647943692,18803,8631,8322,309,5,304
17669,10281,9578,0,0,36035,,,,,,1,1,7.822528925,18813,8455,8143,312,3,309
17669,10326,8851,2,0,37621,,,,,,1,1,7.933841495,19347,8991,8699,292,3,289
17669,11172,8575,3,0,36426,,,,,,1,1,7.515739459,18891,8633,8364,269,4,265
17669,10158,10632,2,0,37001,,,,,,1,1,7.685427933,19027,8835,8531,304,2,302
17669,9781,10426,0,0,36378,,,,,,1,1,7.610865551,18594,8728,8400,328,0,328
17669,11388,10192,0,0,37939,,,,,,1,1,8.009348465,18971,9305,8947,358,1,357
17669,9102,10464,0,2,37897,,,,,,1,1,7.882499531,19065,9261,8951,310,2,308
17669,12327,9898,6,0,10064,,,,,,1,1,2.072896012,4801,2502,2243,259,0,259
17669,11190,10581,0,0,35534,,,,,,1,1,7.396841767,18581,8316,7995,321,3,318
17669,10204,11516,0,0,34705,,,,,,1,1,7.371306744,17977,8203,7881,322,6,316
17669,9706,10698,2,0,36692,,,,,,1,1,7.706460429,18699,8827,8488,339,9,330
17669,9562,10626,0,3,35782,,,,,,1,1,7.393951229,18492,8504,8222,282,7,275
17669,9908,11025,0,2,36747,,,,,,1,1,7.832433416,18599,8927,8633,294,0,294
17669,11041,11201,0,0,3855,,,,,,1,1,0.837206833,1798,949,790,159,0,159
17669,9823,10518,0,0,33611,,,,,,1,1,6.853337126,17883,7724,7444,280,1,279
17669,10122,10552,2,0,35412,,,,,,1,1,7.614593758,18106,8514,8236,278,0,278
17669,11037,9563,0,0,37372,,,,,,1,1,7.832116393,19085,8984,8665,319,0,319
17669,10266,10843,4,0,36201,,,,,,1,1,7.33231953,18470,8711,8402,309,8,301
17669,10234,10314,0,0,35762,,,,,,1,1,7.563289986,18505,8466,8141,325,7,318
17669,8578,9491,0,2,38114,,,,,,1,1,7.81201102,19121,9355,9072,283,3,280
17669,9415,11981,0,6,34043,,,,,,1,1,7.159500512,17854,7949,7658,291,3,288
17669,10149,10297,0,0,37694,,,,,,1,1,8.007133655,19116,9122,8788,334,5,329
17669,10807,9805,2,2,35226,,,,,,1,1,7.224484429,18252,8329,8013,316,4,312
17669,10416,10307,3,0,36070,,,,,,1,1,7.334288067,18219,8776,8477,299,4,295
17669,10123,11952,0,4,38285,,,,,,1,1,7.855511274,19256,9330,8961,369,15,354
17669,10814,10015,0,2,36176,,,,,,1,1,7.701006298,18405,8719,8386,333,2,331
17669,7665,10535,0,0,37164,,,,,,1,1,7.779591928,19416,8727,8433,294,3,291
17669,10046,10958,0,0,35009,,,,,,1,1,7.238073451,18333,8181,7867,314,2,312
17669,9840,8900,0,2,36968,,,,,,1,1,7.601169744,19090,8790,8492,298,1,297
17669,9597,12135,0,4,35858,,,,,,1,1,7.591236213,18516,8496,8146,350,4,346
17669,10485,10214,1,2,37961,,,,,,1,1,7.6314374130000004,19161,9238,8914,324,0,324
17669,11635,10319,0,0,33719,,,,,,1,1,6.920509517,17692,7862,7559,303,1,302
17669,10913,10543,6,2,37317,,,,,,1,1,7.833802473,19031,8979,8651,328,1,327
17669,11305,10271,0,1,36384,,,,,,1,1,7.4473464830000005,18900,8582,8262,320,0,320
17669,9533,12035,0,0,34890,,,,,,1,1,7.241707182,18119,8222,7895,327,2,325
17669,9860,11233,0,2,35452,,,,,,1,1,7.316911807,18404,8380,8092,288,2,286
17669,10689,8501,2,0,36038,,,,,,1,1,7.655726091,18856,8457,8189,268,2,266
17669,10194,11753,0,0,36661,,,,,,1,1,7.587596154,18689,8818,8482,336,3,333
17669,9268,8487,0,0,36835,,,,,,1,1,7.680786211,18998,8789,8530,259,3,256
17669,9765,10766,2,1,37558,,,,,,1,1,7.772921858,19041,9099,8780,319,6,313
17669,9109,10993,2,4,35693,,,,,,1,1,7.320097488,18484,8465,8186,279,1,278
17669,11025,10810,2,0,34548,,,,,,1,1,7.204727594,17965,8132,7813,319,5,314
17669,9721,9170,2,0,36887,,,,,,1,1,7.611990206,19086,8756,8467,289,12,277
17669,11319,10864,2,0,1444,,,,,,1,1,0.30293733,583,368,243,125,3,122
17669,10592,9509,2,0,36402,,,,,,1,1,7.346832339,18731,8684,8381,303,6,297
17669,10799,11556,0,2,23139,,,,,,1,1,4.937344732,11563,5628,5308,320,4,316
17669,9916,10097,0,2,35566,,,,,,1,1,7.5222934519999995,18495,8393,8108,285,1,284
17669,9739,10838,0,0,37053,,,,,,1,1,7.697129728,18669,9034,8718,316,3,313
17669,10463,9184,0,2,37106,,,,,,1,1,7.592694206,18887,8962,8667,295,0,295
17669,9333,11033,0,2,37274,,,,,,1,1,7.530808322,18961,8987,8648,339,3,336
17669,10330,11851,0,2,3782,,,,,,1,1,0.771946608,1733,933,750,183,0,183
17669,10920,8913,0,0,36710,,,,,,1,1,7.538949893,18877,8773,8486,287,5,282
17669,10194,11811,0,2,34630,,,,,,1,1,7.251435312,18206,8058,7750,308,6,302
17669,10542,9894,0,0,35101,,,,,,1,1,7.202122822,18581,8106,7798,308,3,305
17669,7981,8355,0,0,39441,,,,,,1,1,8.107835947,19977,9606,9354,252,2,250
17669,9924,11765,2,3,36285,,,,,,1,1,7.568408687,18261,8846,8514,332,3,329
17669,11054,11117,0,0,9328,,,,,,1,1,2.088849468,4467,2321,2102,219,0,219
17669,9258,9858,0,2,35866,,,,,,1,1,7.476769475,18221,8689,8422,267,0,267
17669,10735,11775,0,0,3977,,,,,,1,1,0.828186534,1839,970,772,198,0,198
17669,9183,11118,2,0,37275,,,,,,1,1,7.513557925,19155,8894,8562,332,5,327
17669,10240,11931,0,0,11481,,,,,,1,1,2.346058965,5512,2844,2563,281,0,281
17669,10358,8884,0,2,37113,,,,,,1,1,7.8073155100000005,18908,8957,8666,291,2,289
17669,9320,9425,2,0,34715,,,,,,1,1,7.066899186,18376,8043,7790,253,3,250
17669,10406,10687,2,3,36003,,,,,,1,1,7.4752664509999995,18384,8661,8364,297,4,293
17669,11410,10822,4,0,19134,,,,,,1,1,3.938609658,9845,4498,4205,293,1,292
17669,10746,10684,0,2,34573,,,,,,1,1,7.311900267,17938,8172,7881,291,2,289
17669,9211,10362,2,0,37813,,,,,,1,1,7.70236494,19115,9196,8890,306,2,304
17669,10504,11682,2,0,1835,,,,,,1,1,0.386523393,732,489,364,125,0,125
17669,10572,10050,0,2,35570,,,,,,1,1,7.361206449,18504,8383,8083,300,3,297
17669,10160,8955,2,0,36718,,,,,,1,1,7.663851281,18738,8853,8579,274,3,271
17669,11353,10041,6,2,34542,,,,,,1,1,7.346902695,18292,7973,7669,304,20,284
17669,10125,10902,0,5,35125,,,,,,1,1,7.532221459,18382,8205,7872,333,8,325
17669,9738,11032,1,4,34814,,,,,,1,1,7.204273902,18342,8092,7804,288,5,283
17669,11204,10970,0,2,35391,,,,,,1,1,7.2890455020000005,17583,8722,8358,364,9,355
17669,10434,10684,0,4,35154,,,,,,1,1,7.289592567,18006,8416,8100,316,20,296
17669,11770,9486,4,0,34207,,,,,,1,1,7.0604729410000004,18004,7936,7605,331,6,325
17669,9944,8774,0,0,36552,,,,,,1,1,7.470966704,18875,8712,8459,253,5,248
17669,10330,11368,0,0,36966,,,,,,1,1,7.7333086699999996,18916,8852,8506,346,1,345
17669,8617,10954,0,0,36539,,,,,,1,1,7.484064379,18852,8694,8395,299,0,299
17669,10707,9147,0,0,35587,,,,,,1,1,7.471569874,18449,8423,8131,292,1,291
17669,9319,10977,0,4,36497,,,,,,1,1,7.693127465,19012,8588,8279,309,3,306
17669,10632,9032,4,0,35805,,,,,,1,1,7.4460716510000005,18590,8465,8180,285,5,280
17669,10885,9478,0,0,38026,,,,,,1,1,7.983048196,18902,9402,9082,320,3,317
17669,8734,11909,0,2,36408,,,,,,1,1,7.415510664,18758,8660,8330,330,1,329
17669,10812,9583,2,0,36635,,,,,,1,1,7.699219173,18643,8849,8555,294,1,293
17669,9045,11048,0,0,36289,,,,,,1,1,7.688475952,18816,8587,8288,299,4,295
17669,10418,10233,2,2,36386,,,,,,1,1,7.346387672,18456,8817,8521,296,1,295
17669,10459,9882,0,3,36221,,,,,,1,1,7.588328839,18710,8602,8295,307,5,302
17669,10280,11542,0,4,36547,,,,,,1,1,7.694692292,18338,8931,8584,347,4,343
17669,9339,10759,0,0,35278,,,,,,1,1,7.54056924,18386,8282,7954,328,2,326
17669,10869,9571,0,0,35372,,,,,,1,1,7.26291653,18370,8336,8006,330,2,328
17669,10486,10477,0,0,37184,,,,,,1,1,7.532549475,18638,9098,8748,350,1,349
17669,11192,9441,0,2,35782,,,,,,1,1,7.664816368,18430,8513,8187,326,2,324
17669,10867,11288,0,2,35019,,,,,,1,1,7.220903968,18292,8209,7900,309,3,306
17669,10037,10265,2,2,35704,,,,,,1,1,7.56214129,18686,8359,8059,300,1,299
17669,11478,8803,2,0,35100,,,,,,1,1,7.128247187,18173,8314,8015,299,0,299
17669,9973,9138,4,0,35571,,,,,,1,1,7.388112315,18348,8477,8208,269,2,267
17669,10439,9704,0,0,35117,,,,,,1,1,7.27206648,18292,8276,8003,273,2,271
17669,10786,10599,0,2,35938,,,,,,1,1,7.448621712,18635,8474,8119,355,2,353
17669,8137,10095,2,0,36508,,,,,,1,1,8.025391301,19153,8546,8283,263,6,257
17669,10744,9572,2,0,38782,,,,,,1,1,7.921359045,19148,9641,9289,352,8,344
17669,12110,10106,2,0,8822,,,,,,1,1,1.891698013,4425,2088,1867,221,4,217
17669,11083,9956,0,2,35598,,,,,,1,1,7.476492711,18538,8363,8029,334,0,334
17669,10137,11235,0,3,37610,,,,,,1,1,7.8360621,19135,9064,8717,347,2,345
17669,11198,10990,0,0,3327,,,,,,1,1,0.687818644,1523,804,608,196,0,196
17669,8940,10684,2,2,37616,,,,,,1,1,8.065604018,19378,8965,8657,308,10,298
17669,10301,10924,1,2,34585,,,,,,1,1,7.13406762,18294,7992,7685,307,2,305
17669,11056,10325,5,0,33643,,,,,,1,1,6.937779729,18079,7643,7365,278,3,275
17669,10438,11739,0,0,9327,,,,,,1,1,1.943987737,4630,2236,2011,225,1,224
17669,10573,11548,0,2,38520,,,,,,1,1,7.913804539,19542,9324,8994,330,2,328
17669,10977,10956,0,0,36554,,,,,,1,1,7.953442175,18805,8710,8381,329,2,327
17669,10063,10085,2,2,37461,,,,,,1,1,8.053380417,19162,8992,8677,315,6,309
17669,11302,10871,0,2,5552,,,,,,1,1,1.286566192,2673,1334,1123,211,0,211
17669,10224,10596,2,0,35697,,,,,,1,1,7.819702257,18743,8328,8030,298,3,295
17669,11006,10589,2,4,34325,,,,,,1,1,7.344075168,18177,7914,7594,320,7,313
17669,9658,10186,2,3,37861,,,,,,1,1,7.9614282880000005,19186,9196,8913,283,2,281
17669,11254,8956,2,3,37841,,,,,,1,1,8.296092313,19379,9073,8757,316,6,310
17669,8639,9996,0,11,37011,,,,,,1,1,7.746750057,18919,8920,8668,252,2,250
17669,10242,10528,0,0,36480,,,,,,1,1,7.681045681,18805,8689,8392,297,0,297
17669,10937,9611,2,0,34186,,,,,,1,1,7.215034935,18102,7886,7574,312,0,312
17669,9471,10492,2,2,36871,,,,,,1,1,7.89641833,18828,8881,8600,281,1,280
17669,9411,11974,0,0,34978,,,,,,1,1,7.390711909,18296,8194,7900,294,3,291
17669,9018,10203,4,0,38271,,,,,,1,1,7.697127581,19354,9327,9064,263,2,261
17669,9157,10237,0,0,36744,,,,,,1,1,7.868416248,18941,8761,8480,281,3,278
17669,10780,8820,2,0,36300,,,,,,1,1,7.379458561,18997,8511,8230,281,1,280
17669,8646,9486,0,0,38024,,,,,,1,1,8.017823097,19463,9133,8838,295,2,293
17669,9173,8282,0,0,36652,,,,,,1,1,7.700189866,19004,8699,8449,250,0,250
17669,10241,10951,2,4,37931,,,,,,1,1,7.8457572970000005,18927,9334,8998,336,5,331
17669,10588,9348,4,2,38696,,,,,,1,1,8.137639492,19596,9384,9052,332,5,327
17669,10378,9698,0,0,36889,,,,,,1,1,7.854648597,19079,8748,8434,314,0,314
17669,8791,9914,0,2,37546,,,,,,1,1,7.854355109,19214,9027,8749,278,3,275
17669,9553,11011,2,0,35365,,,,,,1,1,7.678867825,18230,8409,8092,317,3,314
17669,10655,9181,2,2,36151,,,,,,1,1,7.553144457,18677,8604,8338,266,1,265
17669,9953,10013,0,5,37831,,,,,,1,1,7.846025228,19362,9074,8753,321,6,315
17669,9756,11060,0,0,38961,,,,,,1,1,8.153948721,19431,9594,9252,342,0,342
17669,9852,10981,2,8,38161,,,,,,1,1,7.931654318,19347,9254,8948,306,11,295
17669,10963,9312,0,0,36741,,,,,,1,1,7.695300134,18802,8815,8506,309,1,308
17669,9866,10448,2,2,38630,,,,,,1,1,7.938496855,19293,9517,9214,303,4,299
17669,10722,10084,0,0,35370,,,,,,1,1,7.184303779,18339,8365,8064,301,2,299
17669,11892,8858,5,0,34422,,,,,,1,1,7.225560433,18251,7962,7715,247,2,245
17669,10788,9304,4,2,35609,,,,,,1,1,7.445475162,18455,8439,8163,276,5,271
17669,10239,7962,0,0,36552,,,,,,1,1,7.452132608,19165,8562,8299,263,4,259
17669,9253,10352,1,3,37823,,,,,,1,1,7.930234437,19020,9254,8959,295,0,295
17669,9479,9623,0,0,38754,,,,,,1,1,8.132678045,19023,9729,9456,273,3,270
17669,11230,10017,0,0,35816,,,,,,1,1,7.26270302,18573,8462,8143,319,4,315
17669,11215,8960,0,2,34442,,,,,,1,1,7.058680986,18158,8012,7752,260,1,259
17669,10423,10768,0,0,36717,,,,,,1,1,7.397619664,18510,8952,8649,303,0,303
17669,10200,10546,0,0,37742,,,,,,1,1,7.737937935,19281,9057,8710,347,1,346
17669,10487,11831,0,0,3776,,,,,,1,1,0.771547153,1775,906,717,189,0,189
17669,10039,10231,4,0,36573,,,,,,1,1,7.578597809,18898,8697,8416,281,0,281
17669,11172,9025,0,0,35544,,,,,,1,1,7.245754364,18591,8328,8031,297,4,293
17669,9701,10289,1,0,38422,,,,,,1,1,8.0372634,19255,9421,9096,325,9,316
17669,10431,9543,0,0,37583,,,,,,1,1,7.758662951,19326,8974,8665,309,2,307
17669,9878,10271,0,0,36218,,,,,,1,1,7.61780866,18759,8585,8296,289,2,287
17669,9580,12599,0,1,30402,,,,,,1,1,6.385314748,15592,7244,6922,322,4,318
17669,10407,9901,0,0,36550,,,,,,1,1,7.60081756,18883,8688,8397,291,1,290
17669,10529,10973,0,2,33873,,,,,,1,1,7.109473256,17681,7948,7652,296,3,293
17669,10500,10598,0,2,37230,,,,,,1,1,7.658441583,18604,9136,8782,354,3,351
17669,10589,10751,0,2,36358,,,,,,1,1,7.686492347,18637,8696,8367,329,0,329
17669,10792,11413,4,4,21946,,,,,,1,1,4.474752123,10929,5361,5066,295,12,283
17669,11156,9635,0,2,35638,,,,,,1,1,7.329947708,18118,8605,8295,310,2,308
17669,10392,11073,2,0,36578,,,,,,1,1,7.485966048,18509,8862,8517,345,1,344
17669,10622,9636,2,2,37654,,,,,,1,1,8.044139877,19333,9004,8691,313,5,308
17669,12073,10217,1,0,10071,,,,,,1,1,2.053226507,4958,2439,2204,235,2,233
17669,9624,10810,1,2,35792,,,,,,1,1,7.309044594,18582,8464,8182,282,3,279
17669,11909,10457,4,4,13057,,,,,,1,1,2.650667869,6541,3133,2883,250,0,250
17669,8994,11409,0,2,35188,,,,,,1,1,7.114687808,18621,8120,7793,327,1,326
17669,8714,10986,0,0,35994,,,,,,1,1,7.476189294,18351,8675,8382,293,2,291
17669,11747,9324,2,0,35217,,,,,,1,1,7.19237374,18299,8306,8000,306,2,304
17669,10993,11180,0,2,4302,,,,,,1,1,0.881254447,1997,1062,881,181,1,180
17669,11270,10899,2,1,32627,,,,,,1,1,6.776297905,17088,7599,7258,341,8,333
17669,9145,9960,0,2,36534,,,,,,1,1,7.497322684,18908,8680,8414,266,5,261
17669,11037,10894,0,4,35516,,,,,,1,1,7.404194791,18225,8477,8140,337,1,336
17669,10154,11544,0,2,38200,,,,,,1,1,7.906140993,19274,9283,8923,360,13,347
17669,9886,11871,0,4,36098,,,,,,1,1,7.328391508,18611,8569,8220,349,2,347
17669,10180,9897,0,2,37135,,,,,,1,1,7.522787512,18921,8950,8636,314,7,307
17669,11007,11162,2,0,11199,,,,,,1,1,2.316328488,5711,2621,2375,246,0,246
17669,10446,11174,0,0,35391,,,,,,1,1,7.227719615,18263,8407,8093,314,1,313
17669,10733,10136,3,0,36925,,,,,,1,1,7.570111609,19014,8798,8483,315,6,309
17669,10294,10424,2,0,34427,,,,,,1,1,7.289212871,17894,8128,7851,277,0,277
17669,11022,11339,2,4,32618,,,,,,1,1,6.811902705,16743,7775,7450,325,0,325
17669,10291,10005,1,4,34245,,,,,,1,1,7.215248615,18088,7949,7690,259,1,258
17669,10893,10449,4,2,36184,,,,,,1,1,7.317378879,18490,8691,8379,312,3,309
17669,7620,11961,2,0,36381,,,,,,1,1,7.611381305,18876,8622,8361,261,4,257
17669,11469,8684,4,2,36387,,,,,,1,1,7.376500933,18658,8705,8386,319,7,312
17669,10385,9376,2,0,37347,,,,,,1,1,7.692070759,19141,8969,8701,268,1,267
17669,11803,9660,2,0,33979,,,,,,1,1,7.153987473,17835,7921,7619,302,3,299
17669,8651,9773,0,0,37447,,,,,,1,1,7.700445677,19368,8909,8648,261,0,261
17669,9681,10881,0,0,36933,,,,,,1,1,7.742397922,18834,8890,8571,319,0,319
17669,9894,10428,0,0,36880,,,,,,1,1,7.619865866,18496,9049,8763,286,3,283
17669,11364,10805,0,0,11733,,,,,,1,1,2.388776052,5826,2816,2541,275,0,275
17669,10444,9955,0,2,37916,,,,,,1,1,7.7215354309999995,18969,9314,8995,319,4,315
17669,10279,10201,0,2,35782,,,,,,1,1,7.608633841,18631,8413,8088,325,9,316
17669,8942,8023,0,0,37880,,,,,,1,1,7.809378421,19561,9025,8756,269,4,265
17669,11817,9592,0,2,35127,,,,,,1,1,7.28574353,18244,8280,7957,323,3,320
17669,10430,9831,2,8,35435,,,,,,1,1,7.286266874,18233,8449,8145,304,11,293
17669,9322,8946,2,0,38078,,,,,,1,1,7.876336967,19078,9363,9089,274,5,269
17669,9764,9431,0,2,34752,,,,,,1,1,7.2555180759999995,18340,8086,7846,240,2,238
17669,11195,9372,0,2,34565,,,,,,1,1,7.151661359,18091,8082,7772,310,12,298
17669,10743,9053,2,0,37846,,,,,,1,1,8.016088154,19024,9261,8961,300,1,299
17669,9352,10099,2,0,36123,,,,,,1,1,7.338940167,18720,8567,8298,269,5,264
17669,10586,9600,0,0,35572,,,,,,1,1,7.219888134,18694,8271,7935,336,3,333
17669,10716,10125,2,0,36262,,,,,,1,1,7.497122561,18850,8562,8274,288,2,286
17669,10063,11333,1,0,36947,,,,,,1,1,7.748862397,18866,8872,8535,337,1,336
17669,9406,10325,0,0,34565,,,,,,1,1,7.356755342,18084,8113,7858,255,1,254
17669,10566,9857,2,0,35517,,,,,,1,1,7.425999251,18354,8428,8121,307,2,305
17669,11081,10379,0,2,34681,,,,,,1,1,7.118856497,17774,8295,7978,317,7,310
17669,10600,9458,0,0,35655,,,,,,1,1,7.763279215,18719,8325,8039,286,2,284
17669,11727,10746,5,0,6404,,,,,,1,1,1.296678977,2961,1617,1408,209,2,207
17669,11132,11041,0,2,5468,,,,,,1,1,1.135740445,2560,1348,1136,212,4,208
17669,8504,9854,0,0,36488,,,,,,1,1,7.356084568,18973,8618,8339,279,4,275
17669,10236,10833,0,2,36060,,,,,,1,1,7.576705459,18715,8512,8191,321,6,315
17669,12670,8726,4,0,37111,,,,,,1,1,7.810793008,18523,9137,8823,314,1,313
17669,10700,9860,4,2,38505,,,,,,1,1,8.140114948,19280,9447,9116,331,7,324
17669,9056,12194,2,2,38706,,,,,,1,1,8.252033722,19063,9615,9202,413,9,404
17669,9796,11342,0,2,34554,,,,,,1,1,7.317412545,18474,7889,7587,302,3,299
17669,11060,10286,0,0,37072,,,,,,1,1,7.9676682450000005,18711,9014,8681,333,0,333
17669,9493,10626,0,0,35141,,,,,,1,1,7.177480576,18361,8244,7952,292,3,289
17669,8980,9920,4,1,36188,,,,,,1,1,7.599551849,18448,8747,8501,246,3,243
17669,10366,10640,0,0,36077,,,,,,1,1,7.360237,18806,8474,8151,323,4,319
17669,11442,10740,2,3,28120,,,,,,1,1,5.816202402,14319,6736,6407,329,7,322
17669,10486,8254,2,0,37233,,,,,,1,1,7.593090981,19028,8959,8672,287,15,272
17669,10826,10937,1,0,35451,,,,,,1,1,7.570275786,18749,8192,7874,318,2,316
17669,10883,9671,0,0,36423,,,,,,1,1,7.467618449,18516,8807,8514,293,0,293
17669,10473,10888,0,2,36168,,,,,,1,1,7.527413576,18448,8679,8317,362,4,358
17669,9506,10009,2,2,37773,,,,,,1,1,7.820788195,19290,9091,8790,301,9,292
17669,10234,9841,2,0,37542,,,,,,1,1,7.628914785,19205,9009,8690,319,5,314
17669,9961,11494,2,0,33612,,,,,,1,1,6.939963578,17311,8000,7699,301,1,300
17669,10162,8765,2,0,35248,,,,,,1,1,7.156753196,18271,8358,8097,261,4,257
17669,9758,10627,0,2,35267,,,,,,1,1,7.240409862,18382,8311,8048,263,3,260
17669,11355,10862,0,2,15557,,,,,,1,1,3.048915433,7567,3858,3584,274,0,274
17669,10374,10100,0,1,37043,,,,,,1,1,7.768565979,19008,8862,8551,311,2,309
17669,10107,10496,2,0,34526,,,,,,1,1,6.933339743,18048,8097,7813,284,5,279
17669,9881,10883,2,0,37283,,,,,,1,1,7.833592905,18836,9066,8751,315,4,311
17669,8487,9844,0,3,38530,,,,,,1,1,6.592064368,19505,9367,9076,291,8,283
17669,10402,10012,0,4,36405,,,,,,1,1,6.129227797,18964,8553,8218,335,4,331
17669,9328,10015,0,1,36360,,,,,,1,1,5.966205505,18798,8621,8301,320,2,318
17669,10193,10555,0,0,34625,,,,,,1,1,7.08277558,18367,7986,7700,286,3,283
17669,10066,9591,4,0,36504,,,,,,1,1,6.465249076,18748,8732,8440,292,1,291
17669,10175,8937,3,2,34540,,,,,,1,1,5.17601886,17929,8178,7923,255,4,251
17669,9071,10515,2,0,35625,,,,,,1,1,5.550822106,18449,8456,8192,264,7,257
17669,9714,9893,0,2,36527,,,,,,1,1,5.612437584,18738,8754,8473,281,0,281
17669,10442,10597,2,0,34469,,,,,,1,1,6.287504957,18041,8067,7773,294,2,292
17669,10469,11156,0,2,37846,,,,,,1,1,5.670475302,19029,9238,8897,341,9,332
17669,10825,8353,2,0,37968,,,,,,1,1,6.587184496,18966,9351,9051,300,6,294
17669,10124,10589,2,2,36760,,,,,,1,1,5.287349452,18652,8913,8631,282,4,278
