key_bits,recovered_zeros_x,recovered_zeros_y,wrong_zeros_x,wrong_zeros_y,queries,traces,calibration_traces,threshold,tpr,tnr,attack_tpr,attack_tnr,duration_seconds,test_outcomes_0_false,test_outcomes_0_true,test_outcomes_1_false,test_outcomes_1_true,test_outcomes_2_false,test_outcomes_2_true
17669,11445,10340,0,0,34160,,,,,,1,1,7.00610503,17666,8082,7752,330,3,327
17669,10061,12227,2,2,34587,,,,,,1,1,7.065665891,17963,8140,7796,344,2,342
17669,9853,11346,2,2,34906,,,,,,1,1,7.199505215,18273,8125,7742,383,16,367
17669,11478,8803,2,0,35400,,,,,,1,1,7.21366628,18208,8417,8059,358,0,358
17669,11113,9767,3,0,34091,,,,,,1,1,7.246784308,18113,7859,7599,260,1,259
17669,11742,10467,0,2,35250,,,,,,1,1,7.284673655,18009,8461,8142,319,6,313
17669,9989,10379,0,0,35976,,,,,,1,1,7.405605023,18647,8506,8189,317,2,315
17669,9973,9138,4,0,35517,,,,,,1,1,7.417601158,18348,8459,8208,251,2,249
17669,10285,10316,4,0,35678,,,,,,1,1,7.420271536,18639,8378,8095,283,5,278
17669,10896,9351,1,1,35434,,,,,,1,1,7.4237400860000005,18623,8267,7990,277,1,276
17669,9514,10878,2,0,36178,,,,,,1,1,7.426074649,18259,8825,8556,269,2,267
17669,11332,10269,2,0,35543,,,,,,1,1,7.4491216829999995,18296,8445,8088,357,7,350
17669,10549,9811,0,2,35231,,,,,,1,1,7.481667093,18490,8235,7964,271,4,267
17669,11500,10477,2,0,36131,,,,,,1,1,7.485095052,18543,8629,8299,330,1,329
17669,9943,11656,0,1,36136,,,,,,1,1,7.493542675,18396,8708,8384,324,1,323
17669,9888,11664,0,4,36056,,,,,,1,1,7.496425666,18532,8598,8270,328,13,315
17669,10902,10424,4,0,36063,,,,,,1,1,7.56866372,18506,8627,8324,303,5,298
17669,8813,10486,0,4,37021,,,,,,1,1,7.672989448,18954,8878,8567,311,8,303
17669,10199,9012,2,0,37572,,,,,,1,1,7.682303692,19358,8957,8657,300,1,299
17669,9721,9170,2,0,36825,,,,,,1,1,7.748354377,19083,8737,8469,268,15,253
17669,10816,11864,2,2,3271,,,,,,1,1,0.749652115,1532,781,604,177,1,176
17669,10230,11263,0,1,37290,,,,,,1,1,7.798236118,18925,9021,8698,323,0,323
17669,11338,11019,2,2,37207,,,,,,1,1,7.859633515,18934,8959,8604,355,7,348
17669,7981,8355,0,0,39501,,,,,,1,1,8.150337607,19977,9626,9354,272,2,270
17669,10845,8230,2,0,38937,,,,,,1,1,8.224829233,19686,9492,9225,267,5,262
17669,10953,11722,2,0,14150,,,,,,1,1,3.073485272,7141,3367,3092,275,7,268
17669,11496,11173,0,0,19146,,,,,,1,1,3.978407614,9503,4673,4376,297,0,297
17669,10003,11079,0,0,35444,,,,,,1,1,7.192173639,18446,8351,8055,296,1,295
17669,9411,11974,0,0,35068,,,,,,1,1,7.202550246,18296,8224,7900,324,3,321
17669,11002,10369,2,0,34569,,,,,,1,1,7.287891398,18041,8113,7811,302,6,296
17669,11049,10704,0,1,35751,,,,,,1,1,7.468085782,18482,8466,8129,337,9,328
17669,10341,8234,0,0,36729,,,,,,1,1,7.709015274,18950,8768,8525,243,2,241
17669,9991,11099,2,0,36880,,,,,,1,1,7.409949961,18629,8960,8629,331,2,329
17669,10888,9079,0,0,37254,,,,,,1,1,7.628088483,18980,8970,8636,334,1,333
17669,10167,11640,0,0,36384,,,,,,1,1,7.443378334,18445,8806,8479,327,2,325
17669,12439,10177,2,4,36400,,,,,,1,1,7.452285232,18932,8551,8185,366,2,364
17669,9018,10203,4,0,38297,,,,,,1,1,7.7915514550000005,19346,9339,9066,273,2,271
17669,10349,11609,2,0,36759,,,,,,1,1,7.604486729,18534,8943,8604,339,0,339
17669,10096,10070,0,2,36910,,,,,,1,1,7.712894295,18937,8846,8565,281,2,279
17669,10377,10543,0,0,36236,,,,,,1,1,7.572002659,18750,8593,8293,300,4,296
17669,11437,11097,4,2,34835,,,,,,1,1,7.077032145,18285,8111,7783,328,2,326
17669,10565,9329,4,0,36127,,,,,,1,1,7.377102271,18505,8653,8337,316,4,312
17669,9666,11616,2,0,37808,,,,,,1,1,7.855799149,18950,9254,8904,350,4,346
17669,10490,9100,0,0,36125,,,,,,1,1,7.654494949,18444,8693,8398,295,3,292
17669,10820,10876,0,0,37576,,,,,,1,1,7.864986611,19038,9100,8762,338,3,335
17669,11109,10922,0,4,36941,,,,,,1,1,7.7203188,18639,8990,8668,322,2,320
17669,10649,10812,0,2,36984,,,,,,1,1,7.671130149,18662,8984,8630,354,6,348
17669,10889,10304,5,0,37260,,,,,,1,1,7.846503611,19188,8877,8559,318,2,316
17669,9158,10676,0,0,36625,,,,,,1,1,7.652471394,19037,8639,8329,310,1,309
17669,11540,11132,1,0,9246,,,,,,1,1,1.893556902,4459,2280,2053,227,0,227
17669,10463,10971,0,2,36279,,,,,,1,1,7.476447795,18546,8706,8385,321,8,313
17669,9319,10977,0,4,36439,,,,,,1,1,7.435752695,19013,8568,8278,290,3,287
17669,12027,9539,0,0,34122,,,,,,1,1,7.018654229,17968,7940,7666,274,1,273
17669,10130,10455,2,2,37268,,,,,,1,1,7.555063195,19265,8844,8529,315,2,313
17669,10379,10400,2,0,32097,,,,,,1,1,6.665757022,16998,7418,7155,263,1,262
17669,10970,10154,2,2,35698,,,,,,1,1,7.1957681749999995,18287,8557,8260,297,18,279
17669,10249,10018,0,4,37050,,,,,,1,1,7.468709157,18811,8961,8644,317,2,315
17669,10324,10933,1,2,36979,,,,,,1,1,7.488872866,18985,8828,8490,338,3,335
17669,10200,10546,0,0,37679,,,,,,1,1,7.65044432,19281,9036,8710,326,1,325
17669,10462,10129,4,2,37335,,,,,,1,1,7.574001464,18875,9072,8756,316,4,312
17669,9339,10759,0,0,35236,,,,,,1,1,7.1097682110000004,18386,8268,7954,314,2,312
17669,10423,10768,0,0,36732,,,,,,1,1,7.419309559,18510,8957,8649,308,0,308
17669,10127,10818,0,4,36573,,,,,,1,1,7.455540361,19088,8582,8261,321,2,319
17669,8550,9701,0,2,36526,,,,,,1,1,7.354002714,19216,8515,8235,280,7,273
17669,9752,12383,0,0,37128,,,,,,1,1,7.798600844,18748,9000,8620,380,1,379
17669,9946,9676,2,2,37640,,,,,,1,1,7.858242155,19248,9041,8731,310,10,300
17669,9992,11027,0,4,36156,,,,,,1,1,7.324359794,18416,8714,8402,312,3,309
17669,11260,11071,0,1,35821,,,,,,1,1,7.361923227,18365,8558,8218,340,4,336
17669,11495,9126,3,2,35359,,,,,,1,1,7.4693645570000005,18212,8431,8146,285,2,283
17669,10412,9028,4,2,37444,,,,,,1,1,7.6294669,19153,8980,8649,331,3,328
17669,10454,9687,4,1,38506,,,,,,1,1,7.832722803,19787,9195,8866,329,19,310
17669,8807,10122,0,2,35150,,,,,,1,1,7.253160082,18383,8253,7992,261,5,256
17669,11168,9780,4,0,38494,,,,,,1,1,7.809082716,19342,9406,9066,340,13,327
17669,10011,10511,0,0,36955,,,,,,1,1,7.552373716,18809,8927,8635,292,1,291
17669,9334,9937,2,2,36925,,,,,,1,1,7.4772393,18955,8861,8613,248,1,247
17669,11081,11588,0,2,20087,,,,,,1,1,4.058684824,10027,4884,4592,292,1,291
17669,10063,10085,2,2,37432,,,,,,1,1,7.579437782,19166,8981,8677,304,7,297
17669,12068,10275,2,2,34180,,,,,,1,1,7.113144436,17834,7999,7651,348,2,346
17669,9667,11666,2,3,34727,,,,,,1,1,7.091104955,18245,8087,7779,308,11,297
17669,11588,10262,0,0,36122,,,,,,1,1,7.392314979,18629,8584,8259,325,0,325
17669,9588,12606,0,1,35404,,,,,,1,1,7.163260364,18212,8430,8098,332,3,329
17669,9886,11871,0,4,36172,,,,,,1,1,7.32793995,18679,8588,8271,317,2,315
17669,10796,11392,2,0,36295,,,,,,1,1,7.663501991,18518,8728,8407,321,3,318
17669,10514,10369,0,2,38145,,,,,,1,1,7.743247092,19366,9224,8893,331,1,330
17669,12200,10531,4,3,34462,,,,,,1,1,7.068366793,17739,8201,7880,321,8,313
17669,10801,10537,4,1,34553,,,,,,1,1,7.148915155,18161,8046,7746,300,7,293
17669,9517,11718,0,0,37843,,,,,,1,1,7.635481285,18895,9314,8994,320,2,318
17669,8639,9996,0,11,37046,,,,,,1,1,7.563997342,18899,8935,8658,277,4,273
17669,10493,10426,0,0,34057,,,,,,1,1,7.24991095,17925,7909,7595,314,1,313
17669,10953,10056,0,2,36134,,,,,,1,1,7.297680807,18701,8563,8256,307,1,306
17669,11160,9551,3,0,35219,,,,,,1,1,7.15782339,18570,8188,7915,273,5,268
17669,12246,9655,4,0,37836,,,,,,1,1,7.672187741,19118,9190,8852,338,4,334
17669,10020,9149,2,0,37762,,,,,,1,1,7.715514104,19172,9155,8875,280,4,276
17669,11656,11168,0,0,4280,,,,,,1,1,0.87178942,1971,1054,853,201,0,201
17669,7964,10771,0,0,37176,,,,,,1,1,7.690307789,19094,8895,8603,292,3,289
17669,9727,11423,0,2,34999,,,,,,1,1,7.190888151,18014,8340,8035,305,5,300
17669,9969,10162,4,5,37550,,,,,,1,1,7.841386057,19285,8978,8669,309,9,300
17669,10341,10864,4,0,38741,,,,,,1,1,8.0069474,19618,9374,8999,375,4,371
17669,11473,11200,0,0,4770,,,,,,1,1,1.03284375,2216,1174,968,206,0,206
17669,9633,10889,2,0,34582,,,,,,1,1,7.243898403,18130,8091,7821,270,6,264
17669,9979,12692,2,0,8578,,,,,,1,1,1.770919171,4259,2041,1804,237,0,237
17669,11128,9233,1,0,35543,,,,,,1,1,7.262200237,18577,8341,8057,284,5,279
17669,10280,9746,0,2,36741,,,,,,1,1,7.488261948,18817,8815,8521,294,2,292
17669,9852,10981,2,8,38127,,,,,,1,1,7.796419202,19355,9240,8948,292,13,279
17669,9589,11362,0,4,35639,,,,,,1,1,7.416974579,18258,8535,8224,311,4,307
17669,11195,9372,0,2,34536,,,,,,1,1,7.031344827,18089,8073,7772,301,12,289
17669,11215,8866,2,0,36606,,,,,,1,1,7.458693865,18616,8839,8527,312,6,306
17669,10655,9181,2,2,36163,,,,,,1,1,7.31198369,18670,8610,8337,273,1,272
17669,11364,11093,2,3,36642,,,,,,1,1,7.4397871,18545,8877,8534,343,4,339
17669,9218,10993,2,4,34519,,,,,,1,1,7.01885029,18296,7970,7687,283,4,279
17669,11675,10708,2,2,35115,,,,,,1,1,7.180512891,18584,8098,7763,335,11,324
17669,10869,10321,0,0,35365,,,,,,1,1,7.483837125,18391,8324,7998,326,5,321
17669,10905,10413,2,0,36381,,,,,,1,1,7.599614814,18568,8743,8416,327,2,325
17669,9120,9852,0,2,35668,,,,,,1,1,7.36290971,18684,8351,8069,282,1,281
17669,10832,10742,0,2,36831,,,,,,1,1,7.54463002,18580,8966,8647,319,10,309
17669,9253,10352,1,3,37817,,,,,,1,1,7.614811929,19020,9252,8959,293,0,293
17669,11410,10390,0,0,36877,,,,,,1,1,7.695885338,18802,8863,8514,349,0,349
17669,9925,11312,0,1,36041,,,,,,1,1,7.336316302,18451,8639,8327,312,1,311
17669,9723,10928,2,0,34618,,,,,,1,1,7.400835139,18032,8146,7852,294,3,291
17669,10570,9536,2,2,37841,,,,,,1,1,7.7207607,19110,9207,8890,317,2,315
17669,8963,10282,0,2,34739,,,,,,1,1,7.04170865,18597,7935,7663,272,0,272
17669,10680,9779,2,0,36341,,,,,,1,1,7.484294391,18475,8775,8459,316,1,315
17669,10053,12397,4,2,34188,,,,,,1,1,7.072172504,17890,7995,7687,308,13,295
17669,10394,11395,0,0,34872,,,,,,1,1,7.357646634,18415,8073,7762,311,1,310
17669,8980,9279,2,2,38282,,,,,,1,1,7.970301078,19019,9489,9204,285,4,281
17669,9998,9898,0,0,36000,,,,,,1,1,7.298724125,18724,8490,8194,296,4,292
17669,10359,11804,1,0,33797,,,,,,1,1,6.873604482,17800,7824,7475,349,2,347
17669,10788,9304,4,2,35319,,,,,,1,1,7.426842651,18367,8344,8080,264,2,262
17669,11796,10873,0,0,23721,,,,,,1,1,4.895991974,12383,5524,5234,290,0,290
17669,12004,10408,2,2,33731,,,,,,1,1,6.904015872,17586,7924,7627,297,7,290
17669,10529,10973,0,2,33924,,,,,,1,1,6.876757086,17702,7962,7664,298,3,295
17669,10366,10640,0,0,36029,,,,,,1,1,7.2838651500000005,18806,8458,8151,307,4,303
17669,10205,11107,2,4,35027,,,,,,1,1,7.106705056,17920,8415,8138,277,4,273
17669,11486,9853,0,0,34648,,,,,,1,1,7.126718151,18013,8161,7848,313,1,312
17669,11528,10461,2,4,35094,,,,,,1,1,7.140458058,17811,8493,8196,297,3,294
17669,11090,10446,0,2,36552,,,,,,1,1,7.369817681,18801,8719,8406,313,6,307
17669,10581,10804,2,2,35750,,,,,,1,1,7.238906772,18516,8445,8101,344,20,324
17669,10666,10952,0,6,37071,,,,,,1,1,7.518723823,18538,9093,8746,347,3,344
17669,10974,9646,2,2,38373,,,,,,1,1,7.716755935,19593,9233,8919,314,6,308
17669,11379,11149,2,0,33688,,,,,,1,1,6.809099549,17461,7953,7632,321,1,320
17669,10394,10337,0,0,37774,,,,,,1,1,7.746653524,19184,9137,8821,316,2,314
17669,10342,9789,3,0,36862,,,,,,1,1,7.786433298,18919,8826,8535,291,4,287
17669,10569,10610,0,0,37044,,,,,,1,1,7.463591186,18982,8879,8575,304,2,302
17669,8807,10608,0,0,35587,,,,,,1,1,7.282050259,18542,8382,8101,281,4,277
17669,9756,11060,0,0,38934,,,,,,1,1,7.824237459,19431,9585,9252,333,0,333
17669,8175,11577,2,5,36279,,,,,,1,1,7.449823453,18711,8639,8349,290,4,286
17669,9856,11465,0,1,34708,,,,,,1,1,7.201845648,18256,8076,7776,300,2,298
17669,10610,12060,2,0,9055,,,,,,1,1,1.852734799,4383,2211,1961,250,2,248
17669,10258,10613,0,0,37675,,,,,,1,1,7.6662736559999995,19061,9138,8800,338,1,337
17669,10716,9284,0,0,35833,,,,,,1,1,7.243223761,18643,8454,8172,282,3,279
17669,11241,11245,0,2,35550,,,,,,1,1,7.209266669,18391,8398,8035,363,6,357
17669,10024,8202,2,0,37999,,,,,,1,1,7.73775771,19360,9169,8868,301,9,292
17669,11996,10890,4,4,26632,,,,,,1,1,5.412434497,13384,6462,6138,324,1,323
17669,11747,9324,2,0,35075,,,,,,1,1,7.394926521,18242,8262,7953,309,2,307
17669,9070,9613,1,0,36529,,,,,,1,1,7.5269476189999995,19147,8550,8268,282,4,278
17669,9572,10906,0,2,37383,,,,,,1,1,7.562645009,18979,9032,8692,340,3,337
17669,9352,10099,2,0,36125,,,,,,1,1,7.328908951,18725,8567,8301,266,5,261
17669,10560,11315,2,2,33192,,,,,,1,1,6.913107694,17574,7662,7368,294,18,276
17669,10636,10744,1,4,37110,,,,,,1,1,7.631561924,18632,9071,8735,336,21,315
17669,10078,9989,0,0,35279,,,,,,1,1,7.138580096,18451,8248,7916,332,1,331
17669,11046,11070,0,1,35582,,,,,,1,1,7.269301867,18262,8491,8153,338,1,337
17669,9387,11315,0,0,34543,,,,,,1,1,7.040563782,17775,8243,7961,282,2,280
17669,10574,11205,2,0,34998,,,,,,1,1,7.138827243,18321,8180,7863,317,4,313
17669,11296,11374,0,0,1700,,,,,,1,1,0.347867134,666,448,310,138,0,138
17669,9453,9795,0,0,36353,,,,,,1,1,7.377412967,18925,8562,8258,304,4,300
17669,10826,9781,2,0,37540,,,,,,1,1,7.605064994,19056,9095,8801,294,2,292
17669,12037,10502,2,4,37408,,,,,,1,1,7.52428378,18645,9197,8828,369,1,368
17669,10361,10260,2,2,35312,,,,,,1,1,7.288026768,17990,8523,8247,276,8,268
17669,10431,11336,0,4,36469,,,,,,1,1,7.47302174,18555,8782,8432,350,5,345
17669,9853,11481,0,0,35238,,,,,,1,1,7.16814104,18346,8266,7906,360,3,357
17669,10652,12127,0,4,6178,,,,,,1,1,1.247615577,2924,1517,1297,220,0,220
17669,9866,10448,2,2,38789,,,,,,1,1,7.874477473,19374,9553,9244,309,4,305
17669,10030,11147,0,2,39018,,,,,,1,1,7.847631552,19453,9606,9253,353,6,347
17669,10848,11286,0,0,34289,,,,,,1,1,7.024348947,17591,8185,7857,328,2,326
17669,9137,10221,3,0,36344,,,,,,1,1,7.36300348,18672,8691,8401,290,4,286
17669,9785,11138,0,2,36450,,,,,,1,1,7.424640356,18732,8694,8364,330,2,328
17669,10358,10907,0,3,34638,,,,,,1,1,7.05253909,18190,8066,7750,316,1,315
17669,11716,9612,0,2,37042,,,,,,1,1,7.448137509,18302,9211,8893,318,3,315
17669,12053,10616,2,6,19335,,,,,,1,1,4.030309386,9483,4773,4467,306,15,291
17669,9173,8282,0,0,36640,,,,,,1,1,7.410526027,19004,8695,8449,246,0,246
17669,8942,8023,0,0,37862,,,,,,1,1,7.8612294590000005,19561,9019,8756,263,4,259
17669,10085,11023,2,2,34741,,,,,,1,1,7.050837122,18210,8095,7754,341,4,337
17669,10500,11177,0,0,36029,,,,,,1,1,7.311480507,18305,8698,8370,328,3,325
17669,11202,10653,2,2,35329,,,,,,1,1,7.253870224,18054,8463,8114,349,9,340
17669,10234,9841,2,0,37506,,,,,,1,1,7.655852144,19205,8997,8690,307,5,302
17669,10797,10597,0,4,36093,,,,,,1,1,7.344568014,18206,8760,8393,367,4,363
17669,9706,10698,2,0,36601,,,,,,1,1,7.518303573,18698,8795,8482,313,10,303
17669,10423,10075,0,0,35498,,,,,,1,1,7.309713206,18040,8581,8285,296,0,296
17669,11269,10957,0,0,35224,,,,,,1,1,7.271112951,18162,8342,7964,378,3,375
17669,10298,9615,2,0,35548,,,,,,1,1,7.258924794,18351,8457,8174,283,2,281
17669,9104,9819,0,2,37472,,,,,,1,1,7.567986851,19049,9077,8808,269,1,268
17669,10386,10814,0,0,34299,,,,,,1,1,7.227972428,17873,8056,7742,314,3,311
17669,10797,9107,2,0,36030,,,,,,1,1,7.529215758,18644,8553,8273,280,2,278
17669,10516,10759,2,0,35951,,,,,,1,1,7.47323398,18512,8563,8250,313,2,311
17669,9553,11011,2,0,35341,,,,,,1,1,7.244765663,18233,8404,8104,300,3,297
17669,9507,10574,0,2,38738,,,,,,1,1,7.94613968,19557,9426,9097,329,6,323
17669,10229,9893,2,0,35819,,,,,,1,1,7.30188523,18637,8443,8147,296,2,294
17669,10448,12383,2,2,16041,,,,,,1,1,3.325599747,7875,3935,3639,296,3,293
17669,9981,11955,0,0,35711,,,,,,1,1,7.367662611,18098,8642,8313,329,3,326
17669,10878,10426,2,2,34222,,,,,,1,1,7.117458452,17742,8090,7790,300,10,290
17669,9845,11129,0,2,36007,,,,,,1,1,7.427826373,18516,8575,8234,341,4,337
17669,11903,10840,2,2,11043,,,,,,1,1,2.25058665,5546,2627,2384,243,1,242
17669,8993,10510,0,3,38677,,,,,,1,1,7.828413321,19458,9465,9176,289,1,288
17669,10572,10050,0,2,35587,,,,,,1,1,7.223157687,18503,8389,8083,306,3,303
17669,12272,10171,2,0,33642,,,,,,1,1,6.907561269,17577,7876,7563,313,5,308
17669,11172,9025,0,0,35517,,,,,,1,1,7.2633296640000005,18591,8319,8031,288,4,284
17669,9466,9714,0,0,37784,,,,,,1,1,7.734187202,19164,9159,8857,302,0,302
17669,11081,10948,0,0,34872,,,,,,1,1,7.150356516,18038,8244,7898,346,2,344
17669,10999,9018,3,0,36609,,,,,,1,1,7.395335823,19217,8532,8204,328,2,326
17669,10422,10382,2,0,35986,,,,,,1,1,7.327435912,18638,8523,8221,302,2,300
17669,9953,10013,0,5,37445,,,,,,1,1,7.5917232,19173,8985,8683,302,4,298
17669,10689,8501,2,0,35792,,,,,,1,1,7.436960274,18729,8401,8140,261,2,259
17669,10571,10997,0,3,35490,,,,,,1,1,7.230804546,18400,8380,8050,330,9,321
17669,10496,9551,2,0,35805,,,,,,1,1,7.27637531,18623,8445,8153,292,6,286
17669,10166,11523,4,0,36822,,,,,,1,1,7.491713975,18826,8833,8503,330,9,321
17669,10899,11023,2,2,34530,,,,,,1,1,7.069064117,18195,8011,7698,313,1,312
17669,9507,11301,3,2,35827,,,,,,1,1,7.447315422,18580,8482,8199,283,2,281
17669,10872,10859,0,0,37908,,,,,,1,1,7.762570674,19324,9137,8827,310,0,310
17669,10589,10751,0,2,36229,,,,,,1,1,7.422242689,18563,8664,8326,338,0,338
17669,11271,10780,0,0,36042,,,,,,1,1,7.37793901,18416,8629,8261,368,5,363
17669,10013,10479,0,2,35409,,,,,,1,1,7.247459503,18296,8409,8114,295,4,291
17669,9877,10511,0,0,36407,,,,,,1,1,7.419503495,18866,8625,8334,291,1,290
17669,9504,10335,0,0,35915,,,,,,1,1,7.386244932,18896,8367,8082,285,1,284
17669,9510,11635,0,2,36502,,,,,,1,1,7.543830925,18889,8642,8313,329,3,326
17669,11403,11276,0,0,4313,,,,,,1,1,0.870578124,1959,1073,865,208,1,207
17669,10365,10221,0,2,36277,,,,,,1,1,7.49777115,18537,8736,8468,268,4,264
17669,11928,10346,0,0,35583,,,,,,1,1,7.205328216,18322,8467,8140,327,2,325
17669,10318,11897,0,0,36277,,,,,,1,1,7.472907872,18456,8755,8444,311,1,310
17669,10486,10477,0,0,37154,,,,,,1,1,7.576893484,18638,9088,8748,340,1,339
17669,10446,11174,0,0,35478,,,,,,1,1,7.349516078,18263,8436,8093,343,1,342
17669,10280,11542,0,4,36533,,,,,,1,1,7.398387168,18342,8926,8587,339,7,332
17669,10241,10951,2,4,37890,,,,,,1,1,7.707495629,18935,9316,8993,323,3,320
17669,10405,9700,0,0,35972,,,,,,1,1,7.291973447,18329,8678,8391,287,3,284
17669,10951,9302,1,0,35842,,,,,,1,1,7.240555124,18221,8656,8347,309,2,307
17669,9548,10312,0,0,35435,,,,,,1,1,7.162756933,18558,8297,8014,283,3,280
17669,10746,10684,0,2,34795,,,,,,1,1,7.184834018,18022,8232,7923,309,2,307
17669,10622,9636,2,2,37661,,,,,,1,1,7.599171997,19346,9004,8697,307,6,301
17669,11207,11482,2,0,2020,,,,,,1,1,0.413697559,833,521,376,145,1,144
17669,9906,9229,0,4,36115,,,,,,1,1,7.381506696,18874,8494,8241,253,5,248
17669,10800,10463,0,0,37705,,,,,,1,1,7.574367175,19103,9117,8749,368,1,367
17669,10899,11419,0,3,34586,,,,,,1,1,7.063514777,17868,8188,7846,342,4,338
17669,9008,8830,0,0,38015,,,,,,1,1,7.658248009,19322,9196,8895,301,2,299
17669,9068,10875,0,3,35457,,,,,,1,1,7.277471629,18635,8259,7955,304,3,301
17669,10521,11357,4,0,35738,,,,,,1,1,7.251614921,18266,8576,8256,320,2,318
17669,10271,8485,0,0,38481,,,,,,1,1,7.735211857,19271,9462,9176,286,3,283
17669,10617,10554,2,0,34798,,,,,,1,1,7.036352858,18206,8140,7828,312,5,307
17669,10385,9376,2,0,37722,,,,,,1,1,8.08530181,19297,9064,8767,297,1,296
17669,11511,9656,0,4,33657,,,,,,1,1,6.847391387,17688,7850,7581,269,4,265
17669,10436,10417,0,0,36707,,,,,,1,1,7.435083295,18516,8931,8602,329,1,328
17669,10653,9786,2,0,37866,,,,,,1,1,7.825807055,18982,9274,8938,336,6,330
17669,11814,10124,3,0,37991,,,,,,1,1,7.713389459,18726,9452,9091,361,3,358
17669,11195,11020,0,4,36760,,,,,,1,1,7.445105015,19054,8681,8337,344,3,341
17669,10826,9259,0,4,36721,,,,,,1,1,7.604965719,18633,8893,8591,302,3,299
17669,10937,9611,2,0,34191,,,,,,1,1,7.069024836,18152,7877,7592,285,0,285
17669,11006,10589,2,4,34137,,,,,,1,1,7.09154574,18072,7874,7557,317,6,311
17669,10716,10125,2,0,36217,,,,,,1,1,7.333440452,18850,8547,8274,273,2,271
17669,10431,9543,0,0,37616,,,,,,1,1,7.701915497,19326,8985,8665,320,2,318
17669,11125,10237,2,2,38706,,,,,,1,1,7.772839103,19269,9542,9189,353,4,349
17669,10788,9178,0,3,36060,,,,,,1,1,7.318949526,18570,8603,8319,284,7,277
17669,10281,10371,4,2,35799,,,,,,1,1,7.228968473,18707,8403,8117,286,3,283
17669,11803,9660,2,0,33861,,,,,,1,1,6.9794199070000005,17767,7897,7597,300,3,297
17669,11192,9441,0,2,35745,,,,,,1,1,7.25848445,18408,8505,8178,327,2,325
17669,10521,10477,1,0,35078,,,,,,1,1,7.208929396,18446,8166,7866,300,1,299
17669,10399,12339,4,2,25881,,,,,,1,1,5.21944551,13054,6237,5884,353,4,349
17669,12078,10376,0,2,35553,,,,,,1,1,7.2000569070000005,18139,8547,8227,320,4,316
17669,12093,9923,0,0,35368,,,,,,1,1,7.274383082,18343,8338,7989,349,2,347
17669,10280,11315,4,0,37248,,,,,,1,1,7.505593119,18967,8952,8575,377,10,367
17669,10598,9873,2,0,34636,,,,,,1,1,7.154647919,18064,8131,7821,310,2,308
17669,11101,10576,0,0,35441,,,,,,1,1,7.167073756,18162,8468,8125,343,3,340
17669,9251,8511,3,0,38351,,,,,,1,1,7.812859735,19662,9233,9010,223,1,222
17669,9543,9257,0,0,36689,,,,,,1,1,7.393352441,18765,8803,8485,318,2,316
17669,10700,9860,4,2,38317,,,,,,1,1,7.747904961,19173,9405,9071,334,7,327
17669,11498,9826,2,0,36297,,,,,,1,1,7.487293756,18531,8727,8415,312,3,309
17669,8118,11337,0,3,39086,,,,,,1,1,7.984011455,19421,9672,9351,321,4,317
17669,10098,9364,0,2,36621,,,,,,1,1,7.600822454,19009,8656,8356,300,3,297
17669,11241,10997,2,4,36182,,,,,,1,1,7.490261056,18643,8610,8291,319,4,315
17669,9712,7907,0,0,38638,,,,,,1,1,7.802351954,19756,9314,9060,254,0,254
17669,10239,7962,0,0,36492,,,,,,1,1,7.661486014,19165,8542,8299,243,4,239
17669,11451,10750,2,3,35080,,,,,,1,1,7.215755422,17819,8461,8122,339,8,331
17669,10722,10084,0,0,35349,,,,,,1,1,7.349072054,18339,8358,8064,294,2,292
17669,10725,12009,0,0,20420,,,,,,1,1,4.319133583,9898,5104,4790,314,2,312
17669,10915,11754,0,4,10622,,,,,,1,1,2.177069649,5307,2532,2281,251,4,247
17669,10291,10005,1,4,34629,,,,,,1,1,7.370830468,18283,8033,7753,280,3,277
17669,10355,10827,2,4,35301,,,,,,1,1,7.176507073,18419,8299,8015,284,2,282
17669,11273,10986,0,3,34964,,,,,,1,1,7.236824918,18180,8231,7909,322,2,320
17669,9228,10249,0,1,36114,,,,,,1,1,7.507095819,18750,8538,8250,288,0,288
17669,10819,10415,0,1,33009,,,,,,1,1,6.790638019,17638,7542,7255,287,3,284
17669,12670,8726,4,0,37183,,,,,,1,1,7.603466597,18523,9161,8823,338,1,337
17669,11021,11660,2,0,21410,,,,,,1,1,4.3248829109999996,10889,5115,4824,291,2,289
17669,9471,10492,2,2,36812,,,,,,1,1,7.56906441,18778,8871,8579,292,1,291
17669,10609,10691,1,4,35816,,,,,,1,1,7.292115207,18524,8491,8181,310,2,308
17669,8555,10889,0,0,37377,,,,,,1,1,7.563202404,19068,8996,8679,317,10,307
17669,12277,9380,0,0,35697,,,,,,1,1,7.196479231,18646,8365,8044,321,3,318
17669,10726,11945,0,0,3859,,,,,,1,1,0.794079483,1759,945,735,210,0,210
17669,9878,9736,7,2,35406,,,,,,1,1,7.250745597,18489,8325,8058,267,4,263
17669,10586,11291,0,4,36087,,,,,,1,1,7.397646932,18424,8669,8344,325,5,320
17669,10803,9932,0,4,35785,,,,,,1,1,7.215133124,18769,8368,8088,280,2,278
17669,10379,10159,4,0,37800,,,,,,1,1,7.610002446,19343,9066,8741,325,0,325
17669,11588,11084,0,0,6264,,,,,,1,1,1.267706411,2982,1536,1326,210,0,210
17669,11156,11303,0,3,32914,,,,,,1,1,6.778870986,17173,7712,7395,317,0,317
17669,11099,10691,6,0,33030,,,,,,1,1,6.811015706,17330,7696,7388,308,16,292
17669,10154,11544,0,2,38247,,,,,,1,1,7.715340324,19272,9299,8922,377,10,367
17669,10926,11310,0,4,37258,,,,,,1,1,7.643853474,18865,9015,8652,363,5,358
17669,11166,11701,0,0,1327,,,,,,1,1,0.27492978,513,343,215,128,0,128
17669,10820,11442,4,4,36987,,,,,,1,1,7.569627969,18744,8948,8601,347,13,334
17669,9071,10515,2,0,35471,,,,,,1,1,7.178791483,18323,8429,8139,290,6,284
17669,10082,9496,2,1,34738,,,,,,1,1,7.057668754,18220,8127,7863,264,10,254
17669,8714,10986,0,0,36006,,,,,,1,1,7.354778394,18351,8679,8382,297,2,295
17669,10970,10100,4,2,36376,,,,,,1,1,7.416036458,18439,8821,8526,295,3,292
17669,9624,10810,1,2,35828,,,,,,1,1,7.295885723,18582,8476,8182,294,3,291
17669,11155,11521,0,0,8086,,,,,,1,1,1.676409659,3931,1952,1701,251,0,251
17669,8674,11416,0,2,37583,,,,,,1,1,7.684752644,19039,9127,8837,290,3,287
17669,11353,10890,2,2,35368,,,,,,1,1,7.189539265,18322,8358,8028,330,4,326
17669,9803,8757,0,0,38791,,,,,,1,1,7.871910906,19362,9569,9278,291,1,290
17669,10726,10317,2,2,35268,,,,,,1,1,7.318771804,18231,8365,8058,307,3,304
17669,9493,10626,0,0,35153,,,,,,1,1,7.334688401,18361,8248,7952,296,3,293
17669,9830,10828,2,0,33848,,,,,,1,1,6.845432774,18251,7663,7392,271,4,267
17669,11230,10017,0,0,35885,,,,,,1,1,7.324557012,18573,8485,8143,342,4,338
17669,10169,10384,0,1,36315,,,,,,1,1,7.353828398,18746,8618,8285,333,0,333
17669,10730,10700,4,4,34768,,,,,,1,1,7.133049988,18039,8198,7865,333,4,329
17669,10328,9710,0,0,37692,,,,,,1,1,7.551397443,19095,9142,8829,313,5,308
17669,10152,10133,0,2,36246,,,,,,1,1,7.334475663,18727,8601,8284,317,3,314
17669,8779,9262,0,3,39034,,,,,,1,1,7.886705837,19624,9569,9297,272,1,271
17669,10001,10400,2,0,37207,,,,,,1,1,7.711830659,18851,9028,8728,300,0,300
17669,9961,11595,3,2,35684,,,,,,1,1,7.388530724,18353,8516,8217,299,1,298
17669,9764,9431,0,2,35011,,,,,,1,1,7.130396067,18437,8154,7888,266,2,264
17669,10678,11999,0,0,11679,,,,,,1,1,2.425054005,6027,2690,2418,272,0,272
17669,9737,9330,0,0,37811,,,,,,1,1,7.6941521139999995,19277,9130,8856,274,1,273
17669,10164,10874,3,1,38489,,,,,,1,1,7.783135248,19479,9330,8980,350,12,338
17669,11493,11180,2,0,9795,,,,,,1,1,1.980142201,4841,2354,2108,246,3,243
17669,9485,9459,2,0,37034,,,,,,1,1,7.493255898,18802,8988,8732,256,1,255
17669,11469,8684,4,2,36385,,,,,,1,1,7.383781763,18674,8699,8386,313,7,306
17669,10680,10195,0,0,35082,,,,,,1,1,7.160397529,18438,8179,7893,286,0,286
17669,10066,9591,4,0,36650,,,,,,1,1,7.392900051,18798,8775,8473,302,1,301
17669,11147,11267,0,0,37196,,,,,,1,1,7.5036757210000005,18731,9067,8736,331,1,330
17669,10444,9955,0,2,37859,,,,,,1,1,7.754842375,18967,9295,8993,302,3,299
17669,10023,10985,0,0,36562,,,,,,1,1,7.409343604,18215,9032,8749,283,0,283
17669,9322,8946,2,0,38093,,,,,,1,1,7.754122984,19078,9368,9089,279,5,274
17669,10290,8099,0,0,36591,,,,,,1,1,7.390751247,18740,8797,8540,257,0,257
17669,9913,11662,0,1,37656,,,,,,1,1,7.652852411,18900,9222,8910,312,1,311
17669,10496,10439,1,1,35815,,,,,,1,1,7.392431499,18655,8421,8103,318,4,314
17669,9714,9893,0,2,36554,,,,,,1,1,7.382152478,18738,8763,8473,290,0,290
17669,8287,11605,0,2,36745,,,,,,1,1,7.408412811,18766,8840,8541,299,6,293
17669,10413,10261,2,0,36145,,,,,,1,1,7.434930437,18561,8644,8348,296,1,295
17669,12137,10550,2,0,6534,,,,,,1,1,1.339223281,3172,1566,1336,230,2,228
17669,10141,9952,3,0,35993,,,,,,1,1,7.276936609,18485,8605,8307,298,3,295
17669,11186,10163,0,0,37868,,,,,,1,1,7.638142528,19407,9069,8746,323,2,321
17669,10476,10432,0,0,37741,,,,,,1,1,7.607781753,19051,9155,8775,380,4,376
17669,9258,11466,0,2,36326,,,,,,1,1,7.52034813,18433,8778,8441,337,6,331
17669,11071,8738,0,0,36900,,,,,,1,1,7.553338702,18760,8923,8629,294,3,291
17669,10473,10888,0,2,35960,,,,,,1,1,7.332405351,18390,8620,8290,330,3,327
17669,10297,10871,0,3,35404,,,,,,1,1,7.20599856,18431,8326,8005,321,8,313
17669,11681,10816,4,3,36141,,,,,,1,1,7.296798407,18267,8756,8394,362,15,347
17669,11026,10104,2,3,34514,,,,,,1,1,7.091386396,18045,8078,7765,313,3,310
17669,10507,8899,0,2,37421,,,,,,1,1,7.77544751,19222,8954,8663,291,4,287
17669,10738,9025,4,0,34502,,,,,,1,1,7.082143749,18296,7965,7689,276,8,268
17669,8504,9854,0,0,36413,,,,,,1,1,7.444757463,18973,8593,8339,254,4,250
17669,10442,10597,2,0,34463,,,,,,1,1,7.176063395,18039,8066,7774,292,2,290
17669,11003,8909,2,0,37280,,,,,,1,1,7.622701636,18990,8990,8680,310,2,308
17669,10446,9804,2,0,37247,,,,,,1,1,7.543143851,19088,8930,8631,299,4,295
17669,10893,10449,4,2,35819,,,,,,1,1,7.329297016,18370,8580,8291,289,3,286
17669,10600,9458,0,0,35694,,,,,,1,1,7.273783542,18719,8338,8039,299,2,297
17669,11088,10901,1,3,36148,,,,,,1,1,7.324639317,18320,8748,8416,332,0,332
17669,11092,10848,2,0,36276,,,,,,1,1,7.387373854,18838,8557,8233,324,1,323
17669,9633,10520,2,2,36190,,,,,,1,1,7.596778722,18868,8511,8211,300,5,295
17669,9838,9070,2,2,35699,,,,,,1,1,7.324046004,18672,8374,8095,279,9,270
17669,10825,8353,2,0,37962,,,,,,1,1,7.722399086,18966,9349,9051,298,6,292
17669,10736,9657,2,2,35735,,,,,,1,1,7.285819964,18542,8445,8142,303,4,299
17669,9560,9700,0,2,37022,,,,,,1,1,7.555187147,18985,8876,8591,285,7,278
17669,9177,10075,2,0,35378,,,,,,1,1,7.270817075,18363,8369,8092,277,3,274
17669,11312,11156,2,2,34924,,,,,,1,1,7.107375319,18029,8276,7933,343,2,341
17669,8957,10269,0,0,36579,,,,,,1,1,7.393763977,18870,8682,8337,345,2,343
17669,11337,8526,2,1,37501,,,,,,1,1,7.5784412,18947,9123,8815,308,2,306
17669,9510,10899,0,0,37192,,,,,,1,1,7.585604582,18874,9000,8682,318,2,316
17669,11081,10379,0,2,34611,,,,,,1,1,7.276372621,17776,8271,7978,293,5,288
17669,10883,9671,0,0,36480,,,,,,1,1,7.389347568,18516,8826,8514,312,0,312
17669,11272,10900,2,1,34793,,,,,,1,1,7.227248295,18280,8090,7757,333,9,324
17669,9690,10568,4,0,35769,,,,,,1,1,7.28921804,18535,8478,8200,278,1,277
17669,10561,10036,0,0,35762,,,,,,1,1,7.409252085,18305,8588,8307,281,2,279
17669,10258,11395,2,0,36297,,,,,,1,1,7.426311458,18800,8594,8285,309,0,309
17669,10459,9882,0,3,36007,,,,,,1,1,7.428930077,18613,8550,8256,294,4,290
17669,10838,9737,0,2,35994,,,,,,1,1,7.418120698,18613,8528,8203,325,4,321
17669,9056,12194,2,2,38705,,,,,,1,1,7.9494906610000005,19120,9611,9248,363,10,353
17669,11393,10831,2,0,33443,,,,,,1,1,6.91443375,17427,7857,7555,302,0,302
17669,8567,10821,2,0,38822,,,,,,1,1,8.029628172,19233,9647,9352,295,6,289
17669,9881,10883,2,0,37286,,,,,,1,1,7.8389875270000005,18836,9067,8751,316,4,312
17669,10663,10483,2,0,37948,,,,,,1,1,7.753751706,19308,9154,8822,332,4,328
17669,7995,9070,4,2,36994,,,,,,1,1,7.702900037,18925,8904,8643,261,3,258
17669,10124,10589,2,2,36914,,,,,,1,1,7.491127694,18688,8964,8666,298,6,292
17669,7951,9949,0,0,38919,,,,,,1,1,8.146239966,19806,9408,9111,297,1,296
17669,10224,11254,3,0,35649,,,,,,1,1,7.334901457,18324,8509,8202,307,11,296
17669,11250,10590,2,0,36164,,,,,,1,1,7.693279735,18608,8609,8271,338,3,335
17669,9324,11229,4,0,33715,,,,,,1,1,7.143804343,17777,7823,7531,292,5,287
17669,10611,9278,2,0,35303,,,,,,1,1,7.264468216,18625,8200,7922,278,4,274
17669,10393,12293,0,0,3577,,,,,,1,1,0.747846082,1650,874,695,179,0,179
17669,11065,10968,1,2,35102,,,,,,1,1,7.1776961,18226,8286,7982,304,4,300
17669,10204,11516,0,0,34759,,,,,,1,1,7.2330465,17977,8221,7881,340,6,334
17669,10382,9607,2,0,35470,,,,,,1,1,7.185161485,18507,8337,8048,289,1,288
17669,10826,10280,0,3,36096,,,,,,1,1,7.287763172,18545,8625,8324,301,2,299
17669,10542,10384,0,0,35725,,,,,,1,1,7.250097668,18486,8470,8171,299,1,298
17669,9157,10237,0,0,36693,,,,,,1,1,7.572835602,18941,8744,8480,264,3,261
17669,11817,9592,0,2,35027,,,,,,1,1,7.241655934,18238,8247,7952,295,2,293
17669,11332,10244,0,0,33993,,,,,,1,1,7.005048299,18118,7792,7501,291,6,285
17669,10034,10955,3,2,34635,,,,,,1,1,7.25705528,17963,8186,7886,300,9,291
17669,10900,11801,0,0,4091,,,,,,1,1,0.829374935,1879,1013,827,186,0,186
17669,11591,11078,0,0,9290,,,,,,1,1,2.162697385,4300,2369,2117,252,1,251
17669,9572,9736,0,0,38819,,,,,,1,1,8.116709371,19413,9551,9247,304,4,300
17669,9658,10186,2,3,37768,,,,,,1,1,7.68246873,19114,9179,8883,296,1,295
17669,10092,9487,3,0,36233,,,,,,1,1,7.383208299,18832,8573,8318,255,1,254
17669,8946,9186,0,0,36813,,,,,,1,1,7.492126066,19040,8756,8495,261,2,259
17669,8873,9408,1,2,37305,,,,,,1,1,7.692941024,19189,8918,8638,280,1,279
17669,11811,11003,0,2,22680,,,,,,1,1,4.808132555,11651,5372,5087,285,2,283
17669,9429,9791,5,0,35124,,,,,,1,1,7.227874896,18126,8378,8136,242,3,239
17669,10733,10585,0,2,36357,,,,,,1,1,7.382077249,18661,8692,8380,312,8,304
17669,10364,9734,0,0,35191,,,,,,1,1,7.297073694,18372,8262,7967,295,3,292
17669,11254,8956,2,3,37805,,,,,,1,1,7.807886734,19379,9061,8757,304,6,298
17669,10938,10694,0,2,34206,,,,,,1,1,7.187463253,17827,8043,7750,293,5,288
17669,8891,12273,0,0,36160,,,,,,1,1,7.441813758,18447,8689,8354,335,2,333
17669,9415,11981,0,6,34025,,,,,,1,1,7.009829952,17852,7943,7656,287,3,284
17669,9771,8009,0,0,38514,,,,,,1,1,7.915433624,19640,9297,9017,280,3,277
17669,10334,11309,0,2,35251,,,,,,1,1,7.228704555,18306,8328,8039,289,6,283
17669,10772,10447,0,0,34331,,,,,,1,1,6.973153011,17838,8085,7762,323,4,319
17669,11305,10271,0,1,36394,,,,,,1,1,7.43435061,18901,8585,8262,323,0,323
17669,11008,10070,0,2,39128,,,,,,1,1,7.957625574,19393,9679,9302,377,4,373
17669,11215,8960,0,2,34538,,,,,,1,1,7.142027266,18173,8045,7770,275,1,274
17669,10486,8254,2,0,37239,,,,,,1,1,7.686562423,19025,8960,8666,294,12,282
17669,10807,9805,2,2,35175,,,,,,1,1,7.190169168,18248,8313,8012,301,4,297
17669,10932,10968,4,2,34656,,,,,,1,1,7.165837901,18155,8068,7703,365,4,361
17669,11475,10050,0,0,37326,,,,,,1,1,7.626342472,18980,8987,8615,372,1,371
17669,9377,11126,0,0,36449,,,,,,1,1,7.593373544,18628,8759,8456,303,2,301
17669,10500,10598,0,2,37144,,,,,,1,1,7.92473433,18600,9109,8783,326,3,323
17669,11892,8858,5,0,34342,,,,,,1,1,7.101052422,18182,7937,7651,286,3,283
17669,10708,10761,2,2,34763,,,,,,1,1,7.103551847,17993,8250,7980,270,2,268
17669,9869,10891,0,0,35434,,,,,,1,1,7.414746749,18299,8424,8137,287,5,282
17669,10708,9109,6,4,34875,,,,,,1,1,7.25468742,17962,8335,8092,243,6,237
17669,9136,9123,2,1,38823,,,,,,1,1,7.988565682,19800,9362,9063,299,5,294
17669,10923,9583,0,0,37061,,,,,,1,1,7.901743183,18890,8914,8571,343,0,343
17669,10539,11483,0,0,34748,,,,,,1,1,7.167803042,18122,8151,7827,324,1,323
17669,9570,11076,2,0,34830,,,,,,1,1,7.166379638,18234,8155,7869,286,0,286
17669,8927,8964,0,0,38810,,,,,,1,1,7.906387728,19877,9329,9054,275,1,274
17669,11580,9778,0,2,36696,,,,,,1,1,7.5608600500000005,18355,8995,8644,351,14,337
17669,10592,9509,2,0,36421,,,,,,1,1,7.586028378,18723,8692,8378,314,3,311
17669,9479,9623,0,0,38772,,,,,,1,1,8.042988795,19023,9735,9456,279,3,276
17669,9940,9956,0,0,36752,,,,,,1,1,7.658773833,18698,8888,8610,278,2,276
17669,10556,10273,2,0,36625,,,,,,1,1,7.576664948,18642,8826,8495,331,1,330
17669,10533,10043,3,2,36991,,,,,,1,1,7.7171736939999995,18776,8951,8638,313,3,310
17669,10406,10687,2,3,35873,,,,,,1,1,7.435749383,18259,8649,8333,316,5,311
17669,9851,10557,2,0,35279,,,,,,1,1,7.179165754,18354,8327,8056,271,0,271
17669,11037,10894,0,4,35543,,,,,,1,1,7.290764066,18289,8475,8171,304,1,303
17669,10952,10749,0,0,35295,,,,,,1,1,7.250981943,18123,8437,8139,298,4,294
17669,9619,9271,2,2,35604,,,,,,1,1,7.226296871,18636,8343,8061,282,12,270
17669,10402,10012,0,4,36502,,,,,,1,1,7.504965438,19027,8576,8253,323,12,311
17669,7844,10127,0,2,37720,,,,,,1,1,8.078325434,19272,9087,8813,274,1,273
17669,10333,10046,2,0,34897,,,,,,1,1,7.252233664,18243,8163,7835,328,12,316
17669,10382,12461,0,2,11312,,,,,,1,1,2.272741884,5483,2779,2508,271,0,271
17669,7620,11961,2,0,36351,,,,,,1,1,7.548324538,18882,8612,8367,245,4,241
17669,8994,11409,0,2,35116,,,,,,1,1,7.353378103,18621,8096,7793,303,1,302
17669,9294,9708,0,3,36936,,,,,,1,1,7.572350018,19100,8780,8504,276,4,272
17669,9667,9498,0,4,36445,,,,,,1,1,7.508209734,19007,8589,8329,260,0,260
17669,12021,10527,0,2,37699,,,,,,1,1,7.911785156,18800,9272,8917,355,0,355
17669,10946,11855,0,2,8858,,,,,,1,1,1.902343903,4403,2114,1887,227,0,227
17669,10017,10096,0,4,38466,,,,,,1,1,7.764598478,19690,9237,8935,302,0,302
17669,10422,10467,3,0,37083,,,,,,1,1,7.653629546,18810,8976,8655,321,1,320
17669,10605,12102,2,2,31911,,,,,,1,1,6.627743314,16612,7460,7081,379,11,368
17669,9393,7828,0,0,38382,,,,,,1,1,7.77679794,19363,9367,9082,285,3,282
17669,10193,10555,0,0,34667,,,,,,1,1,7.2932304519999995,18367,8000,7700,300,3,297
17669,8455,9958,2,2,36573,,,,,,1,1,7.583791521,18923,8693,8429,264,3,261
17669,10173,9825,1,0,36939,,,,,,1,1,7.554057212,18803,8925,8639,286,4,282
17669,9145,9960,0,2,36578,,,,,,1,1,7.411124512,18903,8697,8416,281,5,276
17669,9823,10518,0,0,33602,,,,,,1,1,6.979456215,17883,7721,7444,277,1,276
17669,11410,11224,2,2,35081,,,,,,1,1,7.193480379,18170,8283,7938,345,13,332
17669,11401,11305,2,0,17615,,,,,,1,1,3.621669922,8846,4241,3954,287,6,281
17669,10916,11040,5,0,35197,,,,,,1,1,7.188372912,18195,8342,8024,318,1,317
17669,10357,10320,5,0,37797,,,,,,1,1,7.975858885,18953,9274,8978,296,5,291
17669,11038,11638,0,0,11807,,,,,,1,1,2.411184905,5708,2915,2646,269,0,269
17669,10743,9053,2,0,37836,,,,,,1,1,7.590518717,18975,9267,8940,327,2,325
17669,10613,10037,0,0,35539,,,,,,1,1,7.325320169,18417,8420,8138,282,1,281
17669,9660,10907,0,0,35778,,,,,,1,1,7.343014982,18450,8504,8184,320,0,320
17669,10612,11078,0,2,35398,,,,,,1,1,7.531467118,18300,8383,8051,332,0,332
17669,10016,10626,5,2,35707,,,,,,1,1,7.297013278,18672,8369,8072,297,13,284
17669,11392,11391,0,1,8419,,,,,,1,1,1.706013768,3999,2086,1838,248,0,248
17669,11461,10853,0,0,35002,,,,,,1,1,7.189548302,18049,8313,7986,327,1,326
17669,10279,10201,0,2,35773,,,,,,1,1,7.366116279,18629,8411,8089,322,11,311
17669,8962,10956,0,0,38173,,,,,,1,1,8.070635654,18913,9465,9135,330,1,329
17669,11429,8548,3,0,36797,,,,,,1,1,7.551578681,18877,8813,8519,294,2,292
17669,10683,9508,0,2,36220,,,,,,1,1,7.29109376,18889,8511,8202,309,0,309
17669,10548,10857,0,0,37938,,,,,,1,1,7.779550705,19319,9131,8774,357,1,356
17669,8881,10197,0,0,39439,,,,,,1,1,8.068845355,19972,9589,9300,289,0,289
17669,8617,10954,0,0,36488,,,,,,1,1,7.478371653,18852,8677,8395,282,0,282
17669,10785,11515,2,2,34749,,,,,,1,1,7.356498434,17731,8350,8032,318,0,318
17669,10469,11156,0,2,37844,,,,,,1,1,7.649637092,19038,9233,8893,340,10,330
17669,10578,9485,4,2,36898,,,,,,1,1,7.68395117,18995,8811,8530,281,5,276
17669,10008,10918,0,2,35568,,,,,,1,1,7.365449255,18635,8319,8024,295,1,294
17669,10180,9897,0,2,37296,,,,,,1,1,7.52424964,18939,9004,8655,349,6,343
17669,11452,10623,2,2,34302,,,,,,1,1,6.957212117,17745,8112,7779,333,11,322
17669,9995,10545,2,2,36347,,,,,,1,1,7.366971662,18771,8630,8314,316,6,310
17669,10194,11753,0,0,36694,,,,,,1,1,7.777776541,18689,8829,8482,347,3,344
17669,9609,11629,2,0,32571,,,,,,1,1,6.686312854,17436,7413,7104,309,0,309
17669,10392,11073,2,0,36307,,,,,,1,1,7.329797133,18435,8779,8465,314,1,313
17669,7595,9782,0,1,39086,,,,,,1,1,7.943289485,19842,9486,9214,272,2,270
17669,10374,9215,2,0,38086,,,,,,1,1,7.916190299,19550,9124,8836,288,2,286
17669,10361,8125,0,0,37582,,,,,,1,1,7.706518271,19179,9057,8768,289,2,287
17669,11297,10610,0,0,36184,,,,,,1,1,7.394459909,18500,8669,8323,346,3,343
17669,10726,10778,0,2,34840,,,,,,1,1,7.144920626,18172,8191,7905,286,3,283
17669,11051,10122,0,0,36156,,,,,,1,1,7.424415483,18397,8717,8392,325,5,320
17669,9796,11342,0,2,34636,,,,,,1,1,7.176687458,18476,7916,7588,328,3,325
17669,8980,9920,4,1,35969,,,,,,1,1,7.34687209,18313,8706,8462,244,3,241
17669,10628,10177,0,0,34821,,,,,,1,1,7.243745256,18196,8149,7822,327,0,327
17669,10214,9978,0,0,37284,,,,,,1,1,7.64574058,19245,8859,8538,321,2,319
17669,9207,10964,0,2,35319,,,,,,1,1,7.191412634,18292,8360,8053,307,3,304
17669,9781,10426,0,0,36327,,,,,,1,1,7.538705619,18594,8711,8400,311,0,311
17669,11075,9741,0,2,34805,,,,,,1,1,7.270069223,18281,8112,7812,300,4,296
17669,11083,9956,0,2,35605,,,,,,1,1,7.327850961,18554,8363,8038,325,0,325
17669,10951,10414,0,1,35709,,,,,,1,1,7.332863903,18556,8419,8104,315,2,313
17669,10175,8937,3,2,34754,,,,,,1,1,7.3312125439999996,18081,8207,7948,259,2,257
17669,11552,10221,4,6,36168,,,,,,1,1,7.347262282,18606,8621,8301,320,8,312
17669,10204,10221,0,0,35388,,,,,,1,1,7.290229546,18365,8349,8024,325,4,321
17669,10166,10800,0,4,37584,,,,,,1,1,7.634583345,19001,9131,8810,321,19,302
17669,11720,11119,0,0,5363,,,,,,1,1,1.206185751,2505,1321,1105,216,0,216
17669,11476,9800,0,4,37613,,,,,,1,1,7.6012989399999995,19128,9072,8731,341,6,335
17669,9549,11648,2,0,35365,,,,,,1,1,7.435606535,18362,8349,8044,305,7,298
17669,9860,11233,0,2,35550,,,,,,1,1,7.376722173,18405,8413,8094,319,1,318
17669,10382,10026,0,0,37208,,,,,,1,1,7.656431105,18866,9011,8691,320,2,318
17669,11471,10134,5,0,36807,,,,,,1,1,7.507681423,18443,9022,8702,320,8,312
17669,9976,10953,0,2,36382,,,,,,1,1,7.547203726,18719,8663,8326,337,14,323
17669,9681,10881,0,0,36948,,,,,,1,1,7.648504849,18834,8895,8571,324,0,324
17669,10464,11275,6,0,36877,,,,,,1,1,7.446924012,18796,8855,8484,371,5,366
17669,9379,9695,2,2,36857,,,,,,1,1,7.50654111,19030,8764,8465,299,7,292
17669,11573,8990,0,1,37108,,,,,,1,1,7.640011848,18761,9005,8668,337,2,335
17669,11095,10449,4,0,36971,,,,,,1,1,7.858447661,19061,8806,8508,298,3,295
17669,10796,10889,0,0,37475,,,,,,1,1,7.71032478,19175,8979,8637,342,2,340
17669,10736,11165,0,0,33750,,,,,,1,1,6.930593012,17779,7832,7525,307,1,306
17669,11060,10286,0,0,37075,,,,,,1,1,7.510065232,18711,9015,8681,334,0,334
17669,8085,10256,0,0,36635,,,,,,1,1,7.461449644,18876,8737,8452,285,0,285
17669,11712,10535,3,2,33380,,,,,,1,1,6.97363677,17705,7682,7371,311,1,310
17669,11106,11573,2,0,8737,,,,,,1,1,1.7606104930000002,4143,2171,1919,252,2,250
17669,11525,11144,3,2,8360,,,,,,1,1,1.725079226,4088,2011,1761,250,5,245
17669,9433,10467,0,0,35641,,,,,,1,1,7.428810047,18308,8521,8230,291,2,289
17669,10848,10514,0,0,36656,,,,,,1,1,7.481183218,19000,8675,8369,306,2,304
17669,12251,10506,2,2,26143,,,,,,1,1,5.561495867,13594,6117,5802,315,1,314
17669,10544,8425,0,0,35919,,,,,,1,1,7.24589177,18326,8653,8366,287,8,279
17669,11405,10917,0,2,36164,,,,,,1,1,7.424948265,18153,8831,8482,349,4,345
17669,10937,9791,0,0,35398,,,,,,1,1,7.270613533,18463,8315,8010,305,0,305
17669,10575,10823,3,2,37863,,,,,,1,1,7.812558296,19402,9056,8707,349,2,347
17669,9587,8730,0,0,37286,,,,,,1,1,7.685834265,19015,8996,8717,279,3,276
17669,9622,11246,2,3,34744,,,,,,1,1,7.831473611,18121,8157,7848,309,2,307
17669,10378,9698,0,0,36856,,,,,,1,1,7.788951405,19079,8737,8434,303,0,303
17669,9211,10362,2,0,37545,,,,,,1,1,7.691849778,18979,9132,8830,302,2,300
17669,10742,11036,2,0,34756,,,,,,1,1,7.346837068,18204,8106,7766,340,3,337
17669,10430,9831,2,8,35454,,,,,,1,1,7.22000024,18227,8459,8150,309,13,296
17669,11190,10581,0,0,35432,,,,,,1,1,7.352421596,18581,8282,7995,287,3,284
17669,11143,10930,2,5,37985,,,,,,1,1,7.662634023,18965,9334,8982,352,7,345
17669,10182,9946,2,2,35863,,,,,,1,1,7.315778559,18415,8576,8280,296,9,287
17669,8578,9491,0,2,37860,,,,,,1,1,7.688201301,18998,9294,9020,274,2,272
17669,10549,9468,2,4,36637,,,,,,1,1,7.4447615,18988,8658,8325,333,5,328
17669,9697,11280,2,2,35228,,,,,,1,1,7.499343004,18398,8262,7956,306,4,302
17669,10554,9409,2,2,38401,,,,,,1,1,7.795382512,19351,9361,9033,328,14,314
17669,9642,9345,0,0,36740,,,,,,1,1,7.440047165,19026,8711,8419,292,3,289
17669,9734,10847,2,2,36404,,,,,,1,1,7.510133393,18702,8691,8371,320,4,316
17669,11353,10041,6,2,34406,,,,,,1,1,7.18108019,18220,7933,7613,320,19,301
17669,11604,8925,3,0,36331,,,,,,1,1,7.342601576,18288,8864,8549,315,0,315
17669,10416,10307,3,0,35874,,,,,,1,1,7.51855313,18055,8754,8443,311,4,307
17669,10183,10549,2,0,36487,,,,,,1,1,7.505557349,18886,8652,8355,297,4,293
17669,10306,10725,4,0,35730,,,,,,1,1,7.248641299,18509,8438,8093,345,15,330
17669,11629,9182,2,0,35903,,,,,,1,1,7.571895522,18571,8514,8210,304,5,299
17669,10744,9572,2,0,38748,,,,,,1,1,7.947080194,19149,9627,9282,345,2,343
17669,9102,10464,0,2,37807,,,,,,1,1,7.705059716,19065,9231,8951,280,2,278
17669,10654,10291,0,2,37977,,,,,,1,1,7.694387594,19377,9130,8790,340,8,332
17669,10407,9901,0,0,36610,,,,,,1,1,7.592658812,18883,8708,8397,311,1,310
17669,10330,11368,0,0,36996,,,,,,1,1,7.732122407,18916,8862,8506,356,1,355
17669,10867,11288,0,2,34956,,,,,,1,1,7.374945029,18292,8188,7900,288,3,285
17669,10588,9348,4,2,38783,,,,,,1,1,7.878836665,19685,9397,9093,304,5,299
17669,9312,9402,0,4,36446,,,,,,1,1,7.829571896,19299,8444,8185,259,1,258
17669,9506,10009,2,2,37736,,,,,,1,1,7.666558275,19295,9079,8796,283,6,277
17669,10686,9868,0,0,36747,,,,,,1,1,7.45567763,18952,8751,8458,293,3,290
17669,8569,10498,0,1,38434,,,,,,1,1,7.856133123,19513,9309,9006,303,8,295
17669,10634,9222,2,0,39560,,,,,,1,1,7.998572715,19899,9674,9361,313,0,313
17669,9739,10838,0,0,37095,,,,,,1,1,7.553414965,18669,9048,8718,330,3,327
17669,9812,10591,0,0,35684,,,,,,1,1,7.266364568,18791,8301,8010,291,2,289
17669,11913,8473,0,0,35487,,,,,,1,1,7.224850964,18234,8483,8196,287,2,285
17669,10102,10412,0,0,36809,,,,,,1,1,7.565744894,19076,8703,8376,327,1,326
17669,10218,11621,2,2,36459,,,,,,1,1,7.443700994,18724,8706,8383,323,5,318
17669,10733,10136,3,0,36913,,,,,,1,1,7.509607011,19015,8793,8481,312,7,305
17669,10801,11796,6,4,34039,,,,,,1,1,7.05234964,17634,8050,7745,305,1,304
17669,9887,10698,0,0,36417,,,,,,1,1,7.369094512,18519,8791,8475,316,5,311
17669,9333,11033,0,2,37215,,,,,,1,1,7.72965574,18961,8967,8647,320,3,317
17669,11326,11010,1,1,35546,,,,,,1,1,7.420022849,18216,8508,8194,314,0,314
17669,10816,11752,0,2,34696,,,,,,1,1,7.182579949,18041,8170,7855,315,0,315
17669,10791,10197,0,0,37598,,,,,,1,1,7.661485883,18961,9140,8783,357,1,356
17669,11635,10319,0,0,33731,,,,,,1,1,6.834248431,17692,7866,7559,307,1,306
17669,10224,10596,2,0,36070,,,,,,1,1,7.486390259,18869,8428,8083,345,4,341
17669,11207,11471,2,0,7764,,,,,,1,1,1.5679919660000001,3680,1909,1643,266,6,260
17669,11226,10484,3,3,37670,,,,,,1,1,7.653414444,19210,9068,8744,324,2,322
17669,12215,10297,1,0,35830,,,,,,1,1,7.373210104,18474,8514,8186,328,2,326
17669,11197,10184,0,6,35455,,,,,,1,1,7.220736394,18126,8505,8186,319,5,314
17669,9878,10271,0,0,36200,,,,,,1,1,7.438909128,18759,8579,8296,283,2,281
17669,10137,11235,0,3,37458,,,,,,1,1,7.853416865,19092,9021,8697,324,2,322
17669,10260,11553,0,0,35735,,,,,,1,1,7.219892536,18371,8509,8163,346,3,343
17669,9126,12103,0,5,35192,,,,,,1,1,7.277676747,18504,8189,7879,310,16,294
17669,10866,11704,6,2,34686,,,,,,1,1,7.140628917,18037,8167,7852,315,6,309
17669,10994,10330,0,0,33603,,,,,,1,1,6.959305402,17534,7883,7580,303,2,301
17669,9947,9229,0,0,38499,,,,,,1,1,7.842712122,19207,9497,9199,298,2,296
17669,10383,11610,0,0,33578,,,,,,1,1,7.015586979,17747,7764,7461,303,0,303
17669,11272,11401,0,0,11003,,,,,,1,1,2.224135776,5278,2734,2477,257,0,257
17669,10481,10230,0,0,38682,,,,,,1,1,7.773855377,19191,9568,9213,355,1,354
17669,11615,10714,0,0,37306,,,,,,1,1,7.720329314,18909,9015,8648,367,1,366
17669,10776,11893,0,4,17163,,,,,,1,1,3.501367375,8532,4164,3861,303,2,301
17669,10382,10766,2,2,35829,,,,,,1,1,7.423975333,18241,8629,8299,330,3,327
17669,10586,9600,0,0,35539,,,,,,1,1,7.302200908,18694,8260,7935,325,3,322
17669,11017,9763,1,2,36043,,,,,,1,1,7.431975102,18603,8553,8219,334,7,327
17669,10766,10629,1,4,36907,,,,,,1,1,7.8035426690000005,18847,8879,8577,302,4,298
17669,10687,9102,0,0,36379,,,,,,1,1,7.512374419,18543,8773,8483,290,3,287
17669,11770,9486,4,0,34259,,,,,,1,1,7.004740576,18090,7941,7654,287,2,285
17669,11581,10289,0,2,35740,,,,,,1,1,7.285040588,18274,8561,8217,344,5,339
17669,8738,10186,0,1,37941,,,,,,1,1,7.893615691,19390,9145,8884,261,3,258
17669,10369,10482,0,4,35800,,,,,,1,1,7.370475259,18720,8387,8081,306,1,305
17669,10598,9623,0,0,34928,,,,,,1,1,7.105221515,18411,8106,7801,305,2,303
17669,9148,11160,0,0,36086,,,,,,1,1,7.374972709,18683,8539,8214,325,1,324
17669,9894,10428,0,0,36856,,,,,,1,1,7.510548086,18496,9041,8763,278,3,275
17669,11025,11342,2,4,35881,,,,,,1,1,7.333065821,18417,8548,8180,368,1,367
17669,10196,11549,0,0,35039,,,,,,1,1,7.160290223,18321,8205,7897,308,4,304
17669,10012,10814,6,2,35283,,,,,,1,1,7.171686662,18113,8433,8129,304,17,287
17669,10829,11754,2,2,34220,,,,,,1,1,6.986112618,17914,7984,7646,338,3,335
17669,9456,10514,0,0,37685,,,,,,1,1,7.719932936,19189,9100,8804,296,4,292
17669,10326,8851,2,0,37836,,,,,,1,1,7.740996214,19403,9056,8735,321,3,318
17669,10880,10394,0,0,37605,,,,,,1,1,7.669542583,19202,9016,8645,371,0,371
17669,9335,8955,0,0,36352,,,,,,1,1,7.371493553,18474,8800,8522,278,0,278
17669,11156,9635,0,2,35614,,,,,,1,1,7.222686734,18118,8597,8295,302,2,300
17669,9748,9048,0,4,35901,,,,,,1,1,7.317539443,19000,8316,8047,269,8,261
17669,12095,9659,6,0,36230,,,,,,1,1,7.577859346,18011,8937,8592,345,8,337
17669,11205,10971,0,2,35640,,,,,,1,1,7.347541669,17771,8761,8414,347,4,343
17669,10162,8765,2,0,35297,,,,,,1,1,7.144108492,18271,8373,8093,280,2,278
17669,11089,11550,0,4,35518,,,,,,1,1,7.50192907,18466,8364,8040,324,4,320
17669,9476,11230,0,2,34812,,,,,,1,1,7.196712268,18240,8147,7869,278,5,273
17669,9938,10639,0,0,35601,,,,,,1,1,7.4962436740000005,18511,8400,8110,290,3,287
17669,9045,11048,0,0,36310,,,,,,1,1,7.49437384,18816,8594,8288,306,4,302
17669,8687,10486,0,2,38008,,,,,,1,1,7.78921259,18999,9351,9044,307,3,304
17669,10869,9571,0,0,35288,,,,,,1,1,7.275091347,18370,8308,8006,302,2,300
17669,11478,10591,0,4,36679,,,,,,1,1,7.4980908809999995,18374,8983,8644,339,4,335
17669,10008,10977,0,2,36526,,,,,,1,1,7.576981004,18399,8905,8588,317,1,316
17669,9276,11403,0,0,37300,,,,,,1,1,7.590149921,18990,8998,8684,314,2,312
17669,10773,10762,0,0,36172,,,,,,1,1,7.388132395,18469,8683,8346,337,0,337
17669,10566,9857,2,0,35453,,,,,,1,1,7.341689224,18323,8412,8106,306,2,304
17669,12895,9967,6,0,35423,,,,,,1,1,7.299027167,17679,8688,8320,368,6,362
17669,10535,9986,0,2,37363,,,,,,1,1,7.682974655,19178,8915,8560,355,2,353
17669,11809,9792,0,2,37066,,,,,,1,1,7.759940513,19073,8820,8467,353,11,342
17669,9494,10974,2,1,34308,,,,,,1,1,7.163598666,17881,8060,7753,307,7,300
17669,11239,10795,2,0,34857,,,,,,1,1,7.262869606,18029,8258,7946,312,6,306
17669,9840,8900,0,2,36930,,,,,,1,1,7.707692396,19090,8777,8491,286,2,284
17669,10981,9751,2,0,35700,,,,,,1,1,7.316024805,18535,8428,8119,309,4,305
17669,10903,9988,2,2,33865,,,,,,1,1,6.989738398,17636,7972,7687,285,6,279
17669,11341,10426,0,0,36625,,,,,,1,1,7.6723715089999995,19152,8555,8192,363,5,358
17669,9961,11494,2,0,33643,,,,,,1,1,6.965915625,17337,8008,7718,290,2,288
17669,8651,9773,0,0,37513,,,,,,1,1,7.785475073,19368,8931,8648,283,0,283
17669,9280,10307,0,4,38438,,,,,,1,1,7.83454764,19244,9444,9138,306,3,303
17669,8137,10095,2,0,36487,,,,,,1,1,7.796542309,19153,8539,8283,256,6,250
17669,9047,10326,0,0,35790,,,,,,1,1,7.283633348,18396,8559,8283,276,0,276
17669,10070,12780,0,2,9909,,,,,,1,1,2.083890265,5202,2237,2004,233,0,233
17669,9712,10758,1,2,36881,,,,,,1,1,7.61694433,18973,8811,8525,286,4,282
17669,9404,11104,0,0,35754,,,,,,1,1,7.304186404,18576,8433,8121,312,1,311
17669,11056,10325,5,0,33619,,,,,,1,1,7.113561679,18079,7635,7365,270,3,267
17669,10913,10543,6,2,37013,,,,,,1,1,7.568323417,18891,8898,8572,326,0,326
17669,10242,10528,0,0,36438,,,,,,1,1,7.410630705,18805,8675,8392,283,0,283
17669,11635,11034,0,0,4390,,,,,,1,1,0.891666315,1990,1103,909,194,1,193
17669,9501,10378,1,0,39706,,,,,,1,1,8.036309464,19741,9820,9495,325,1,324
17669,11049,11201,2,0,33809,,,,,,1,1,6.978890184,17845,7827,7517,310,2,308
17669,10094,10775,4,0,35610,,,,,,1,1,7.180343516,18650,8343,8069,274,2,272
17669,11324,9101,3,0,36891,,,,,,1,1,7.528287119,18994,8815,8548,267,0,267
17669,10210,9359,3,2,37225,,,,,,1,1,7.642675935,18940,8996,8703,293,4,289
17669,10826,10937,1,0,35517,,,,,,1,1,7.238692913,18748,8216,7879,337,2,335
17669,9562,10626,0,3,35707,,,,,,1,1,7.247964473,18453,8485,8201,284,2,282
17669,11531,11149,0,0,3095,,,,,,1,1,0.628311782,1347,792,628,164,0,164
17669,10765,11042,0,2,36920,,,,,,1,1,7.513865744,18685,8954,8627,327,2,325
17669,10836,11176,4,4,32981,,,,,,1,1,6.788810332,17360,7654,7341,313,7,306
17669,10542,9894,0,0,35092,,,,,,1,1,7.127523973,18581,8103,7798,305,3,302
17669,10623,10684,2,1,37581,,,,,,1,1,7.669168919,19063,9090,8752,338,8,330
17669,10521,9685,0,0,36397,,,,,,1,1,7.339723604,18476,8812,8515,297,4,293
17669,12079,8918,3,2,33877,,,,,,1,1,7.01489917,17458,8054,7743,311,0,311
17669,10306,9920,0,0,35480,,,,,,1,1,7.180631101,18580,8302,8006,296,6,290
17669,10941,10178,0,3,35140,,,,,,1,1,7.163179991,17954,8444,8146,298,1,297
17669,10236,10833,0,2,35981,,,,,,1,1,7.318183203,18719,8483,8187,296,6,290
17669,10780,8820,2,0,36306,,,,,,1,1,7.384039976,18997,8513,8230,283,1,282
17669,9628,9453,0,2,36813,,,,,,1,1,7.449137161,19030,8755,8482,273,2,271
17669,9968,8507,2,0,35510,,,,,,1,1,7.25905005,18278,8488,8232,256,4,252
17669,9328,10888,0,4,36154,,,,,,1,1,7.334906933,18725,8568,8275,293,0,293
17669,9900,10264,2,0,35889,,,,,,1,1,7.589853172,18335,8626,8324,302,0,302
17669,8269,10987,0,2,37006,,,,,,1,1,7.585848839,19020,8857,8585,272,2,270
17669,10063,11333,1,0,36981,,,,,,1,1,7.542090623,18844,8888,8527,361,1,360
17669,10292,12377,0,0,19865,,,,,,1,1,4.046432147,9729,4907,4585,322,1,321
17669,10777,9572,0,0,35310,,,,,,1,1,7.239786625,18427,8307,8038,269,4,265
17669,9916,10729,0,2,35539,,,,,,1,1,7.163592158,18516,8376,8105,271,3,268
17669,11683,10765,2,0,34892,,,,,,1,1,7.075478251,18024,8275,7957,318,1,317
17669,10927,10069,0,0,36188,,,,,,1,1,7.369507924,18590,8659,8379,280,2,278
17669,9571,10612,2,0,36987,,,,,,1,1,7.490486522,18742,8971,8668,303,6,297
17669,9201,8844,2,0,36830,,,,,,1,1,7.55963608,19134,8729,8491,238,4,234
17669,8487,9844,0,3,38524,,,,,,1,1,7.889440102,19481,9373,9076,297,6,291
17669,11022,9888,0,0,33266,,,,,,1,1,6.824087893,17897,7539,7248,291,2,289
17669,11035,9978,0,0,34537,,,,,,1,1,7.042330571,17916,8170,7889,281,0,281
17669,9110,10144,0,0,38532,,,,,,1,1,7.898745752,19001,9619,9326,293,3,290
17669,8865,10287,0,0,37062,,,,,,1,1,7.467572185,19136,8818,8528,290,2,288
17669,9519,11657,0,4,34639,,,,,,1,1,7.132035889,17674,8329,8022,307,16,291
17669,9817,9269,2,2,36077,,,,,,1,1,7.350073254,18735,8533,8257,276,8,268
17669,9775,10021,0,0,34513,,,,,,1,1,7.125280641,18073,8080,7800,280,5,275
17669,11027,11095,0,0,32563,,,,,,1,1,6.653808185,17032,7607,7290,317,1,316
17669,10203,11471,2,4,34948,,,,,,1,1,7.079274954,17938,8338,8004,334,7,327
17669,9344,8593,0,0,36980,,,,,,1,1,7.497017714,19219,8757,8510,247,3,244
17669,10374,10100,0,1,37069,,,,,,1,1,7.527911052,19014,8869,8552,317,2,315
17669,10039,10231,4,0,36597,,,,,,1,1,7.473518018,18898,8705,8416,289,0,289
17669,11074,11596,0,2,12756,,,,,,1,1,2.581751707,6224,3118,2822,296,3,293
17669,8481,10554,0,0,37524,,,,,,1,1,7.620210184,18914,9159,8867,292,2,290
17669,9960,10091,4,2,36828,,,,,,1,1,7.496112311,18748,8877,8551,326,3,323
17669,8799,10213,0,0,37985,,,,,,1,1,7.792281848,19188,9266,9001,265,0,265
17669,10701,10785,0,2,34822,,,,,,1,1,7.12959984,18354,8083,7781,302,1,301
17669,9812,9487,0,2,36590,,,,,,1,1,7.541764706,18667,8817,8528,289,2,287
17669,11228,9217,3,0,35628,,,,,,1,1,7.260162179,18773,8281,7988,293,0,293
17669,10137,9631,0,0,35098,,,,,,1,1,7.253352818,18262,8286,8022,264,0,264
17669,10576,9802,1,0,34871,,,,,,1,1,7.158729879,18258,8165,7882,283,0,283
17669,9758,10627,0,2,35294,,,,,,1,1,7.194810929,18382,8320,8048,272,3,269
17669,10372,12261,0,2,36358,,,,,,1,1,7.355206374,18435,8787,8438,349,1,348
17669,9920,11774,2,0,34913,,,,,,1,1,7.194436539,18269,8146,7794,352,1,351
17669,11314,10644,0,0,33687,,,,,,1,1,7.097789336,17712,7835,7530,305,1,304
17669,10702,10720,4,1,36974,,,,,,1,1,7.555780202,18670,8980,8636,344,17,327
17669,9380,9052,0,0,38846,,,,,,1,1,7.844249155,19572,9490,9196,294,1,293
17669,9250,10740,0,2,37174,,,,,,1,1,7.504832375,18946,8960,8652,308,1,307
17669,11065,9689,6,2,37325,,,,,,1,1,7.52633446,18978,9012,8689,323,1,322
17669,9463,11441,0,2,35808,,,,,,1,1,7.325435777,18435,8545,8262,283,1,282
17669,9576,10267,2,0,36096,,,,,,1,1,7.382037889,18843,8468,8151,317,10,307
17669,10792,9939,0,2,35660,,,,,,1,1,7.241872759,18907,8233,7946,287,0,287
17669,10672,11191,0,6,34252,,,,,,1,1,7.000396341,17906,8031,7747,284,1,283
17669,9274,10514,0,2,35920,,,,,,1,1,7.277976829,18484,8594,8346,248,2,246
17669,10223,8637,0,0,38162,,,,,,1,1,7.7211101939999995,19448,9202,8892,310,1,309
17669,10999,9651,4,0,36032,,,,,,1,1,7.301347728,18197,8753,8424,329,9,320
17669,10425,9983,2,2,37471,,,,,,1,1,7.606670988,19325,8914,8596,318,3,315
17669,11690,11002,0,0,5197,,,,,,1,1,1.052972404,2380,1307,1104,203,0,203
17669,10678,10921,5,2,35649,,,,,,1,1,7.34632814,18240,8554,8253,301,8,293
17669,10084,9240,0,4,38818,,,,,,1,1,7.776760582,19350,9592,9308,284,5,279
17669,10459,9714,0,0,35247,,,,,,1,1,7.200228659,18142,8408,8119,289,1,288
17669,9848,11027,0,0,36466,,,,,,1,1,7.4217891,18605,8784,8491,293,1,292
17669,10475,10664,0,0,36672,,,,,,1,1,7.430368658,18709,8821,8500,321,2,319
17669,10942,8966,2,0,37951,,,,,,1,1,7.650527068,19119,9260,8948,312,2,310
17669,10053,11440,2,0,33599,,,,,,1,1,6.883283531,17208,8043,7738,305,1,304
17669,9259,10218,0,0,37697,,,,,,1,1,7.661903896,19441,8973,8663,310,3,307
17669,9328,10015,0,1,36277,,,,,,1,1,7.489535184,18795,8594,8300,294,0,294
17669,10751,10728,4,0,35798,,,,,,1,1,7.367174717,18221,8619,8280,339,7,332
17669,11167,10821,0,3,33746,,,,,,1,1,7.073190705,17937,7735,7396,339,0,339
17669,10534,9451,6,0,35864,,,,,,1,1,7.380857178,18644,8474,8202,272,1,271
17669,11457,11187,0,2,33738,,,,,,1,1,6.905140158,17254,8057,7687,370,7,363
17669,10876,9332,0,0,35012,,,,,,1,1,7.247653604,18286,8222,7940,282,1,281
17669,9539,9964,2,2,35532,,,,,,1,1,7.215457774,18482,8375,8075,300,4,296
17669,9362,11702,4,0,35367,,,,,,1,1,7.246660475,17915,8567,8249,318,12,306
17669,12368,10402,5,0,9161,,,,,,1,1,1.873123825,4385,2264,2016,248,3,245
17669,10423,11005,0,0,35058,,,,,,1,1,7.178271954,18145,8309,8014,295,2,293
17669,10123,11952,0,4,38187,,,,,,1,1,7.738505848,19245,9296,8946,350,10,340
17669,9040,11463,0,0,35082,,,,,,1,1,7.300267231,18480,8143,7827,316,8,308
17669,10293,9605,0,2,37799,,,,,,1,1,7.770529169,19313,9084,8766,318,15,303
17669,8604,10786,0,0,35086,,,,,,1,1,7.144500089,18299,8255,7978,277,2,275
17669,12297,10260,4,0,34119,,,,,,1,1,7.008730973,18031,7890,7582,308,6,302
17669,10488,10576,4,0,36284,,,,,,1,1,7.471769228,18517,8725,8408,317,8,309
17669,10196,10619,0,2,34177,,,,,,1,1,7.095391887,17988,7941,7634,307,3,304
17669,10289,9441,0,0,35470,,,,,,1,1,7.232417671,18788,8198,7912,286,5,281
17669,9829,10805,0,0,34327,,,,,,1,1,7.128448401,18118,7964,7683,281,0,281
17669,10708,9802,3,2,36282,,,,,,1,1,7.389779451,18311,8830,8519,311,1,310
17669,10737,10401,0,0,37445,,,,,,1,1,7.590890441,18723,9198,8872,326,0,326
17669,10713,9239,0,0,35869,,,,,,1,1,7.307474209,18710,8437,8152,285,4,281
17669,10825,12206,0,2,7394,,,,,,1,1,1.519619616,3592,1791,1571,220,3,217
17669,11307,11369,0,0,3335,,,,,,1,1,0.679019514,1551,810,646,164,0,164
17669,10144,11447,2,0,35561,,,,,,1,1,7.24703104,18105,8578,8278,300,3,297
17669,10798,10644,2,0,35946,,,,,,1,1,7.287833946,18465,8582,8265,317,4,313
17669,11214,9860,4,2,34785,,,,,,1,1,7.158215567,18199,8134,7816,318,11,307
17669,9081,9745,0,2,36057,,,,,,1,1,7.344153065,18439,8678,8416,262,1,261
17669,12590,9412,3,0,35119,,,,,,1,1,7.072556735,18064,8363,8034,329,1,328
17669,9421,10205,2,0,36628,,,,,,1,1,7.462627772,18899,8712,8407,305,3,302
17669,11961,9656,3,0,34353,,,,,,1,1,7.030210679,17972,8037,7730,307,0,307
17669,10796,9748,0,2,37152,,,,,,1,1,7.510098851,18742,9045,8725,320,2,318
17669,10107,10496,2,0,34527,,,,,,1,1,7.036712287,18036,8100,7809,291,3,288
17669,11433,11163,2,2,36792,,,,,,1,1,7.484087477,18793,8835,8506,329,6,323
17669,10779,9900,3,0,35795,,,,,,1,1,7.234374366,18574,8465,8174,291,1,290
17669,10715,9479,0,2,36618,,,,,,1,1,7.450285437,19092,8606,8292,314,6,308
17669,10744,9793,0,0,36355,,,,,,1,1,7.424197004,18706,8665,8346,319,0,319
17669,9918,9533,0,0,34375,,,,,,1,1,7.035994969,18172,7958,7671,287,2,285
17669,10899,8981,0,2,36986,,,,,,1,1,7.596277331,18700,9006,8732,274,0,274
17669,10193,12028,2,4,35956,,,,,,1,1,7.32472552,18076,8750,8370,380,2,378
17669,10607,11968,0,4,33782,,,,,,1,1,6.967372944,17523,7973,7660,313,6,307
17669,9898,9902,2,0,37702,,,,,,1,1,7.648528179,18951,9228,8933,295,1,294
17669,10530,9592,0,6,34553,,,,,,1,1,7.040904194,18363,7962,7696,266,3,263
17669,9743,11494,2,0,36057,,,,,,1,1,7.394607495,18496,8602,8245,357,2,355
17669,9329,10272,2,0,36942,,,,,,1,1,7.475744083,19181,8733,8438,295,3,292
17669,11696,10973,6,0,12064,,,,,,1,1,2.440671784,5926,2941,2685,256,3,253
17669,10918,11856,5,2,36494,,,,,,1,1,7.400461002,18142,8987,8609,378,9,369
17669,9541,11380,0,2,36953,,,,,,1,1,7.527976178,18869,8881,8559,322,1,321
17669,9544,11344,2,2,36355,,,,,,1,1,7.600754028,18964,8554,8271,283,1,282
17669,10916,9003,0,0,36698,,,,,,1,1,7.5328099349999995,18837,8768,8443,325,2,323
17669,11172,8575,3,0,36568,,,,,,1,1,7.426245992,18945,8679,8414,265,5,260
17669,10149,10297,0,0,37640,,,,,,1,1,7.773212166,19116,9104,8788,316,5,311
17669,12280,10227,2,0,34828,,,,,,1,1,7.189736444,18108,8167,7781,386,6,380
17669,10828,10044,2,0,36502,,,,,,1,1,7.444685315,18655,8763,8442,321,3,318
17669,10717,10114,2,0,34295,,,,,,1,1,6.9724457520000005,18070,7970,7685,285,2,283
17669,11277,10224,2,2,35549,,,,,,1,1,7.231958907,18435,8386,8044,342,14,328
17669,11998,10788,2,0,10928,,,,,,1,1,2.279187851,5567,2559,2316,243,1,242
17669,10090,10447,0,0,37657,,,,,,1,1,7.587003654,18918,9210,8891,319,4,315
17669,10875,10663,0,0,35420,,,,,,1,1,7.19446619,18360,8379,8077,302,2,300
17669,10194,11811,0,2,34669,,,,,,1,1,7.086605331,18206,8071,7750,321,6,315
17669,10567,9137,5,0,37887,,,,,,1,1,7.628539388,19247,9157,8831,326,14,312
17669,10852,9485,4,0,36117,,,,,,1,1,7.452774187,18661,8582,8290,292,3,289
17669,10123,12149,0,2,34257,,,,,,1,1,7.001783385,18131,7896,7562,334,5,329
17669,9772,9768,2,0,35860,,,,,,1,1,7.24353101,18807,8385,8102,283,2,281
17669,11334,9706,0,0,36227,,,,,,1,1,7.402477298,18640,8624,8285,339,2,337
17669,10918,11675,0,0,37051,,,,,,1,1,7.486616538,18638,9021,8650,371,1,370
17669,10878,11902,0,0,7033,,,,,,1,1,1.445047013,3423,1694,1472,222,0,222
17669,9501,11105,1,2,38554,,,,,,1,1,7.817531484,19499,9355,9010,345,1,344
17669,10061,10387,0,3,37750,,,,,,1,1,7.65436048,19116,9151,8819,332,3,329
17669,10338,10408,1,1,36159,,,,,,1,1,7.390960969,18486,8692,8403,289,3,286
17669,9489,11382,0,0,34205,,,,,,1,1,6.985015879,17940,7964,7627,337,2,335
17669,11571,10816,6,3,32043,,,,,,1,1,6.600087505,17407,7178,6898,280,5,275
17669,10927,9017,1,0,36280,,,,,,1,1,7.4168482319999995,18538,8713,8397,316,2,314
17669,10294,11128,0,2,33942,,,,,,1,1,7.044470147,17765,7936,7631,305,7,298
17669,10948,10738,2,2,35923,,,,,,1,1,7.374217064,18319,8644,8328,316,7,309
17669,10046,10958,0,0,34946,,,,,,1,1,7.120933665,18333,8160,7867,293,2,291
17669,9916,10097,0,2,35514,,,,,,1,1,7.248118032,18464,8379,8087,292,1,291
17669,9774,11116,0,3,36589,,,,,,1,1,7.397189128,18640,8794,8433,361,5,356
17669,11388,10192,0,0,37837,,,,,,1,1,7.731505283,18971,9271,8947,324,1,323
17669,9908,11025,0,2,36723,,,,,,1,1,7.4322803539999995,18548,8922,8591,331,0,331
17669,9591,11303,0,0,36562,,,,,,1,1,7.453876616,18512,8870,8560,310,1,309
17669,11212,10479,2,2,33004,,,,,,1,1,6.927372048,17455,7624,7323,301,3,298
17669,10338,11480,2,0,35423,,,,,,1,1,7.229539547,18297,8387,8035,352,0,352
17669,9668,10712,4,0,38548,,,,,,1,1,7.780228914,19146,9541,9221,320,10,310
17669,10122,10552,2,0,35336,,,,,,1,1,7.214644332,18082,8490,8216,274,0,274
17669,11273,10484,0,2,34512,,,,,,1,1,7.022787754,18146,8019,7691,328,0,328
17669,9557,10624,3,1,36433,,,,,,1,1,7.503124324,18657,8740,8444,296,11,285
17669,10588,9139,0,2,35960,,,,,,1,1,7.262538767,18318,8678,8392,286,7,279
17669,11952,10724,4,2,4794,,,,,,1,1,0.988126575,2179,1206,1003,203,2,201
17669,11168,10187,2,4,35499,,,,,,1,1,7.17406864,18014,8580,8255,325,4,321
17669,10618,9900,2,4,36630,,,,,,1,1,7.501251031,18610,8848,8524,324,14,310
17669,8734,11909,0,2,36167,,,,,,1,1,7.316899401,18664,8602,8303,299,1,298
17669,12029,9965,0,0,35355,,,,,,1,1,7.1342031519999995,18328,8351,8026,325,2,323
17669,10707,9147,0,0,35545,,,,,,1,1,7.309793826,18449,8409,8131,278,1,277
17669,9745,11230,2,2,37020,,,,,,1,1,7.590762694,18729,8983,8658,325,6,319
17669,11354,10366,2,0,35292,,,,,,1,1,7.161185134,18132,8427,8121,306,2,304
17669,10754,10608,4,0,34313,,,,,,1,1,7.045712446,17434,8281,7964,317,2,315
17669,11691,9550,0,0,34158,,,,,,1,1,6.952923541,17867,7999,7706,293,4,289
17669,10347,8033,0,0,38140,,,,,,1,1,7.68386296,19554,9155,8879,276,5,271
17669,10464,9024,2,0,35683,,,,,,1,1,7.226681741,18778,8294,7977,317,1,316
17669,8555,9775,0,0,36603,,,,,,1,1,7.378296038,18859,8741,8479,262,1,261
17669,10434,10684,0,4,35260,,,,,,1,1,7.211205468,18005,8452,8101,351,23,328
17669,11522,10429,6,0,34446,,,,,,1,1,7.105154138,17987,8066,7739,327,17,310
17669,10485,10214,1,2,37965,,,,,,1,1,7.663084166,19188,9232,8919,313,0,313
17669,11037,9563,0,0,37351,,,,,,1,1,7.590181944,19085,8977,8665,312,0,312
17669,10573,11548,0,2,38606,,,,,,1,1,7.832534643,19543,9354,8999,355,3,352
17669,10448,9439,0,0,35514,,,,,,1,1,7.254085313,18427,8406,8131,275,0,275
17669,10550,9399,4,0,37803,,,,,,1,1,7.804789084,19287,9109,8811,298,8,290
17669,10219,9006,2,0,34740,,,,,,1,1,7.204970793,18272,8090,7802,288,8,280
17669,11031,8703,0,0,33993,,,,,,1,1,6.92211797,17905,7913,7651,262,1,261
17669,9765,10766,2,1,37609,,,,,,1,1,7.612286126,19068,9111,8792,319,6,313
17669,10589,10685,0,2,36360,,,,,,1,1,7.417928713,18786,8631,8319,312,5,307
17669,10814,10015,0,2,36130,,,,,,1,1,7.506564906,18441,8696,8399,297,2,295
17669,11456,10795,0,0,35530,,,,,,1,1,7.287741647,18493,8343,7992,351,2,349
17669,9109,10993,2,4,35353,,,,,,1,1,7.177345784,18330,8383,8126,257,1,256
17669,9154,10978,0,0,37608,,,,,,1,1,7.603065778,18995,9152,8843,309,2,307
17669,10154,10162,0,0,35010,,,,,,1,1,7.102936638,18075,8326,8043,283,1,282
17669,10662,10487,2,0,37071,,,,,,1,1,7.538448428,18395,9164,8816,348,4,344
17669,8940,10684,2,2,37657,,,,,,1,1,7.78738489,19440,8967,8684,283,12,271
17669,9953,9421,0,0,36188,,,,,,1,1,7.382037547,18809,8543,8250,293,2,291
17669,11631,10702,0,3,35433,,,,,,1,1,7.385351981,18391,8349,8005,344,4,340
17669,10967,8778,0,0,36984,,,,,,1,1,7.48211696,18986,8824,8474,350,1,349
17669,8810,10726,0,3,37475,,,,,,1,1,7.619898269,19143,9006,8686,320,4,316
17669,8455,9585,2,0,36606,,,,,,1,1,7.484581048,18656,8846,8588,258,2,256
17669,10439,9704,0,0,35147,,,,,,1,1,7.29335028,18292,8286,8003,283,2,281
17669,8577,10229,2,2,37755,,,,,,1,1,7.883233756,19301,9089,8813,276,12,264
17669,10521,12377,0,2,7422,,,,,,1,1,1.5102085779999999,3552,1819,1587,232,1,231
17669,11319,9249,0,2,35675,,,,,,1,1,7.208352189,18509,8429,8121,308,3,305
17669,9183,11118,2,0,36864,,,,,,1,1,7.4758537910000005,18979,8787,8476,311,5,306
17669,10920,8913,0,0,36839,,,,,,1,1,7.478176913,18877,8816,8486,330,5,325
17669,11397,9582,0,2,37450,,,,,,1,1,7.728568453,18927,9116,8825,291,2,289
17669,10629,10716,7,0,36283,,,,,,1,1,7.39465483,18668,8645,8320,325,6,319
17669,11604,11065,4,0,29338,,,,,,1,1,5.925250401,15122,6949,6631,318,1,317
17669,10949,11525,2,3,34831,,,,,,1,1,7.104243339,18133,8183,7851,332,6,326
17669,9436,9822,0,4,37479,,,,,,1,1,7.568326122,19273,8961,8677,284,4,280
17669,9533,12035,0,0,34875,,,,,,1,1,7.204520674,18119,8217,7895,322,2,320
17669,10158,10632,2,0,37094,,,,,,1,1,7.597684875,19027,8866,8531,335,2,333
17669,9320,9425,2,0,34764,,,,,,1,1,7.108593425,18378,8059,7791,268,3,265
17669,11492,11157,0,2,34597,,,,,,1,1,7.009761086,17940,8146,7781,365,4,361
17669,8646,9486,0,0,37988,,,,,,1,1,7.757400351,19463,9121,8838,283,2,281
17669,10084,10381,4,2,35868,,,,,,1,1,7.290306491,18490,8544,8254,290,2,288
17669,9843,9819,7,0,35625,,,,,,1,1,7.198293859,18158,8593,8312,281,7,274
17669,10553,11779,0,2,35414,,,,,,1,1,7.3308351179999995,18443,8313,7968,345,8,337
17669,8840,10701,0,0,37143,,,,,,1,1,7.581687574,19105,8864,8554,310,1,309
17669,10381,10398,0,0,35944,,,,,,1,1,7.403020022,18591,8522,8213,309,1,308
17669,10575,9688,0,0,35552,,,,,,1,1,7.260959559,18440,8410,8118,292,2,290
17669,9929,11881,2,2,36111,,,,,,1,1,7.554010953,18149,8830,8528,302,0,302
17669,11293,10990,0,0,33757,,,,,,1,1,6.878267354,17848,7789,7458,331,0,331
17669,9717,9993,0,2,35402,,,,,,1,1,7.196007471,18409,8360,8087,273,2,271
17669,9747,11460,0,3,36195,,,,,,1,1,7.48725641,18343,8758,8422,336,3,333
17669,10808,9864,0,3,36971,,,,,,1,1,7.624489559,19338,8657,8338,319,2,317
17669,11346,11027,0,0,34768,,,,,,1,1,7.100979331,18176,8130,7798,332,3,329
17669,10869,9971,0,0,31962,,,,,,1,1,6.536186764,16998,7346,7074,272,1,271
17669,10812,9583,2,0,36707,,,,,,1,1,7.432928801,18645,8873,8557,316,4,312
17669,10073,10090,0,0,36902,,,,,,1,1,7.481298395,18864,8865,8557,308,0,308
17669,10475,11145,0,2,35903,,,,,,1,1,7.297575986,18592,8486,8147,339,1,338
17669,10234,10314,0,0,35762,,,,,,1,1,7.234466222,18505,8466,8141,325,7,318
17669,9813,9728,2,0,34213,,,,,,1,1,6.98399768,18054,7949,7688,261,3,258
17669,10639,9940,0,2,36475,,,,,,1,1,7.365389681,18880,8639,8322,317,2,315
17669,10963,9312,0,0,36813,,,,,,1,1,7.430151584,18802,8839,8506,333,1,332
17669,10266,10843,4,0,36250,,,,,,1,1,7.348816313,18484,8727,8415,312,10,302
17669,11304,10889,0,4,33600,,,,,,1,1,6.92562083,17332,7987,7693,294,13,281
17669,11043,11375,0,0,34778,,,,,,1,1,7.053549808,18175,8121,7760,361,2,359
17669,10316,11241,2,11,35340,,,,,,1,1,7.305412303,18235,8416,8143,273,5,268
17669,10013,10124,0,2,36839,,,,,,1,1,7.4903647079999995,18850,8838,8525,313,2,311
17669,9701,10289,1,0,38443,,,,,,1,1,7.893580818,19255,9428,9096,332,9,323
17669,10898,10531,4,2,36058,,,,,,1,1,7.4792414449999995,18712,8522,8220,302,6,296
17669,10926,9892,0,0,34764,,,,,,1,1,7.105478799,18153,8152,7845,307,2,305
17669,10134,10446,0,0,36211,,,,,,1,1,7.409382509,18693,8613,8321,292,0,292
17669,10759,11815,0,2,36090,,,,,,1,1,7.432886708,18147,8794,8439,355,2,353
17669,11275,10503,2,0,38096,,,,,,1,1,7.755331845,19215,9271,8932,339,0,339
17669,11142,10261,2,0,36744,,,,,,1,1,7.604161186,18992,8720,8408,312,1,311
17669,10085,11308,3,4,34414,,,,,,1,1,7.00198216,17788,8162,7860,302,10,292
17669,11050,9175,1,0,34976,,,,,,1,1,7.145696251,18323,8189,7914,275,3,272
17669,10703,9337,0,2,37067,,,,,,1,1,7.715953148,18907,8934,8642,292,7,285
17669,10507,9415,2,2,35759,,,,,,1,1,7.253437398,18399,8543,8269,274,13,261
17669,9106,11016,0,0,36876,,,,,,1,1,7.429642046,18977,8796,8489,307,1,306
17669,10259,10149,3,2,34859,,,,,,1,1,7.130224921,18200,8210,7971,239,2,237
17669,10932,10701,3,2,33724,,,,,,1,1,6.901031331,17743,7836,7527,309,5,304
17669,10050,8167,2,0,36699,,,,,,1,1,7.426320495,18940,8763,8530,233,7,226
17669,10463,9184,0,2,37127,,,,,,1,1,7.536859868,18887,8969,8667,302,0,302
17669,11025,10810,2,0,34560,,,,,,1,1,7.110113826,17965,8135,7810,325,5,320
17669,11016,9995,1,0,34886,,,,,,1,1,7.209183544,18229,8177,7874,303,3,300
17669,11859,9603,2,0,35373,,,,,,1,1,7.255273693,17994,8531,8214,317,2,315
17669,11099,8953,2,0,36281,,,,,,1,1,7.329201325,18864,8567,8284,283,1,282
17669,10996,10983,1,0,35980,,,,,,1,1,7.511373209,18560,8541,8203,338,4,334
17669,9768,10619,0,0,37756,,,,,,1,1,7.67494335,19168,9130,8802,328,3,325
17669,10294,10424,2,0,34587,,,,,,1,1,7.001240597,17990,8164,7895,269,0,269
17669,11081,9198,4,0,36419,,,,,,1,1,7.449744073,18830,8631,8304,327,2,325
17669,10379,10856,0,0,35967,,,,,,1,1,7.319066846,18344,8672,8393,279,0,279
17669,9597,12135,0,4,35756,,,,,,1,1,7.276391507,18495,8462,8125,337,4,333
17669,10522,9286,0,0,37265,,,,,,1,1,7.689804347,19186,8891,8594,297,1,296
17669,9694,10179,0,0,37725,,,,,,1,1,7.726301994,19294,9078,8803,275,2,273
17669,11928,10880,2,0,17435,,,,,,1,1,3.630505728,8982,4076,3775,301,4,297
17669,9924,11765,2,3,36229,,,,,,1,1,7.547531687,18205,8845,8511,334,1,333
17669,11265,11513,0,0,18374,,,,,,1,1,3.735032124,9548,4274,3996,278,1,277
17669,10485,11156,0,0,35301,,,,,,1,1,7.206620648,18286,8353,8044,309,1,308
17669,10152,9606,2,1,36984,,,,,,1,1,7.531080611,18867,8901,8586,315,1,314
17669,9444,10991,5,0,34722,,,,,,1,1,7.156626439,18540,7947,7659,288,2,286
17669,11609,11191,2,0,18224,,,,,,1,1,3.68188869,9228,4358,4078,280,3,277
17669,11286,8778,4,0,37956,,,,,,1,1,7.792170453,19158,9236,8910,326,8,318
17669,11125,8668,2,2,36276,,,,,,1,1,7.402017399,18814,8577,8269,308,2,306
17669,8934,9722,0,0,38488,,,,,,1,1,7.724909897,19554,9308,8990,318,1,317
17669,10010,10326,0,0,37383,,,,,,1,1,7.532326585,18725,9188,8906,282,0,282
17669,11446,11318,0,0,11508,,,,,,1,1,2.335052373,5726,2744,2450,294,2,292
17669,10125,10902,0,5,35048,,,,,,1,1,7.188356755,18350,8187,7863,324,11,313
17669,11164,10203,2,0,35975,,,,,,1,1,7.313929898,18362,8634,8289,345,4,341
17669,10713,10568,2,2,34643,,,,,,1,1,7.026479706,18102,8129,7846,283,8,275
17669,9944,8774,0,0,36696,,,,,,1,1,7.478501431,18875,8760,8459,301,5,296
17669,10927,10416,0,4,36934,,,,,,1,1,7.508958231,18832,8889,8565,324,4,320
17669,10332,10332,4,4,37133,,,,,,1,1,7.669292486,19119,8874,8608,266,1,265
17669,11523,11157,2,0,2491,,,,,,1,1,0.545196709,1111,616,468,148,1,147
17669,11352,11317,0,4,17707,,,,,,1,1,3.68536167,8962,4225,3930,295,5,290
17669,10920,11024,2,0,35635,,,,,,1,1,7.218609992,18517,8409,8109,300,0,300
17669,10281,9578,0,0,35951,,,,,,1,1,7.380402008,18813,8427,8143,284,3,281
17669,9406,10325,0,0,34541,,,,,,1,1,7.006361543,18084,8105,7858,247,1,246
17669,10591,10064,0,2,36091,,,,,,1,1,7.378358663,18680,8553,8248,305,1,304
17669,9258,9858,0,2,35917,,,,,,1,1,7.476841418,18207,8707,8411,296,0,296
17669,10601,10893,0,0,37165,,,,,,1,1,7.641237577,19029,8909,8591,318,2,316
17669,9687,11220,0,0,38842,,,,,,1,1,7.8430681490000005,19443,9516,9149,367,0,367
17669,9268,8487,0,0,36883,,,,,,1,1,7.5300656969999995,18998,8805,8530,275,3,272
17669,10885,9478,0,0,38071,,,,,,1,1,7.673127126,18902,9417,9082,335,3,332
17669,9780,10578,1,0,36544,,,,,,1,1,7.464232956,18836,8702,8398,304,2,302
17669,9770,9921,2,0,37790,,,,,,1,1,7.64741641,19034,9208,8868,340,3,337
17669,9873,10546,1,2,34170,,,,,,1,1,6.957669778,17978,7963,7697,266,1,265
17669,10160,8955,2,0,36709,,,,,,1,1,7.583070858,18738,8850,8579,271,3,268
17669,9282,10863,1,0,36955,,,,,,1,1,7.599421617,18942,8847,8528,319,1,318
17669,10301,10924,1,2,34465,,,,,,1,1,7.120292146,18294,7952,7685,267,2,265
17669,11243,11651,2,2,4612,,,,,,1,1,0.936654089,2118,1151,959,192,1,191
17669,7665,10535,0,0,37119,,,,,,1,1,7.519770907,19416,8712,8433,279,3,276
17669,10504,12166,0,0,17720,,,,,,1,1,3.670893775,8877,4267,3958,309,2,307
17669,8825,9915,2,4,37959,,,,,,1,1,7.656662109,19311,9180,8892,288,5,283
17669,10786,10599,0,2,35721,,,,,,1,1,7.291086315,18559,8406,8056,350,2,348
17669,10358,8884,0,2,37077,,,,,,1,1,7.607822887,18908,8945,8666,279,2,277
17669,9738,11032,1,4,34879,,,,,,1,1,7.131521211,18340,8114,7803,311,2,309
17669,10553,10568,0,0,37575,,,,,,1,1,7.567909802,19388,8932,8609,323,3,320
17669,9277,10223,2,2,37550,,,,,,1,1,7.589580738,19114,9073,8783,290,2,288
17669,10393,10172,5,0,37041,,,,,,1,1,7.703288253,18816,8949,8622,327,0,327
17669,9572,10119,2,0,34632,,,,,,1,1,7.074034647,18179,8089,7814,275,1,274
17669,12280,10757,0,0,12168,,,,,,1,1,2.433119601,6107,2904,2651,253,0,253
17669,11359,11058,0,2,35064,,,,,,1,1,6.9766297,17995,8361,8014,347,1,346
17669,10037,10265,2,2,35678,,,,,,1,1,7.161846144,18702,8347,8065,282,1,281
17669,10887,10116,1,0,37331,,,,,,1,1,6.843792011,18973,9016,8690,326,3,323
17669,8791,9914,0,2,37263,,,,,,1,1,7.54433195,19078,8962,8701,261,3,258
17669,10632,9032,4,0,35762,,,,,,1,1,6.380610049,18591,8451,8182,269,6,263
17669,11218,11489,0,2,11764,,,,,,1,1,2.372209497,5805,2841,2564,277,0,277
17669,10122,11157,0,0,35498,,,,,,1,1,5.93916473,18113,8527,8196,331,1,330
17669,10977,10956,0,0,36569,,,,,,1,1,5.84151902,18805,8715,8381,334,2,332
17669,8640,10402,0,2,36773,,,,,,1,1,6.025358335,18849,8829,8563,266,3,263
17669,8607,9613,1,2,37847,,,,,,1,1,5.9371434260000004,19514,9030,8757,273,3,270
17669,10080,10268,0,0,36498,,,,,,1,1,4.770407655,18973,8597,8266,331,2,329
17669,9501,8826,2,0,35197,,,,,,1,1,5.412433776,18734,8103,7846,257,1,256
17669,10418,10233,2,2,36404,,,,,,1,1,7.427859034,18457,8825,8528,297,1,296
17669,8398,10527,0,0,36725,,,,,,1,1,7.083488437,19125,8661,8383,278,2,276
17669,10139,9310,0,0,36097,,,,,,1,1,6.626311283,18713,8551,8269,282,4,278
17669,10299,11469,2,2,35403,,,,,,1,1,6.5390091,18266,8388,8027,361,7,354
17669,10300,9739,0,0,36945,,,,,,1,1,6.808203909,19004,8827,8540,287,1,286
17669,11275,10457,4,2,36130,,,,,,1,1,6.5182834849999995,18135,8830,8495,335,6,329
