key_bits,recovered_zeros_x,recovered_zeros_y,wrong_zeros_x,wrong_zeros_y,queries,traces,calibration_traces,threshold,tpr,tnr,attack_tpr,attack_tnr,duration_seconds,test_outcomes_0_false,test_outcomes_0_true,test_outcomes_1_false,test_outcomes_1_true,test_outcomes_2_false,test_outcomes_2_true
17669,10143,10547,0,0,1420,,,,,,1,1,0.32983701,566,367,247,120,0,120
17669,11435,9380,0,2,2753,,,,,,1,1,0.572855228,1183,717,581,136,0,136
17669,10681,9991,0,0,2922,,,,,,1,1,0.600774902,1340,709,545,164,0,164
17669,9816,10857,0,0,2984,,,,,,1,1,0.616182202,1328,750,594,156,0,156
17669,10075,10631,2,2,3137,,,,,,1,1,0.637592811,1439,771,615,156,2,154
17669,11007,9663,0,0,3056,,,,,,1,1,0.676704281,1346,780,630,150,0,150
17669,9223,11454,0,0,3491,,,,,,1,1,0.710103117,1542,888,715,173,0,173
17669,9426,11273,0,0,1865,,,,,,1,1,0.389191084,721,500,356,144,1,143
17669,10945,10059,2,0,4033,,,,,,1,1,0.821513109,1843,1000,810,190,2,188
17669,9572,11111,2,2,4030,,,,,,1,1,0.847810772,1880,983,799,184,2,182
17669,9827,10957,0,0,4253,,,,,,1,1,0.916891202,1914,1082,907,175,0,175
17669,10469,10201,0,0,4674,,,,,,1,1,0.955491616,2238,1127,945,182,1,181
17669,10749,9921,2,0,5411,,,,,,1,1,1.126953251,2388,1409,1204,205,3,202
17669,10115,10599,0,0,5605,,,,,,1,1,1.188324421,2615,1391,1183,208,0,208
17669,10711,10007,0,0,3658,,,,,,1,1,0.749858845,1660,909,729,180,0,180
17669,10534,10141,0,0,2197,,,,,,1,1,0.460536204,945,552,404,148,1,147
17669,11233,9521,0,0,6758,,,,,,1,1,1.393597257,3322,1611,1397,214,1,213
17669,11714,8969,0,0,3936,,,,,,1,1,0.813868559,1793,991,830,161,0,161
17669,10184,10708,0,2,4011,,,,,,1,1,0.831432579,1894,970,793,177,1,176
17669,10516,10177,0,0,3580,,,,,,1,1,0.759134286,1538,933,757,176,0,176
17669,10142,10579,0,0,921,,,,,,1,1,0.197601556,333,243,141,102,0,102
17669,10266,10410,2,0,3062,,,,,,1,1,0.626317524,1455,731,586,145,0,145
17669,10687,9982,0,0,2530,,,,,,1,1,0.515849524,1127,628,481,147,0,147
17669,9867,10803,0,0,6707,,,,,,1,1,1.428993438,3307,1605,1415,190,0,190
17669,9499,11175,0,2,9262,,,,,,1,1,1.9227924650000001,4563,2233,2000,233,2,231
17669,10981,9714,2,0,11984,,,,,,1,1,2.556161373,6207,2791,2596,195,0,195
17669,10338,10332,2,0,9219,,,,,,1,1,1.941870293,4693,2167,1975,192,2,190
17669,10910,9759,0,0,16578,,,,,,1,1,3.4881879319999998,8487,3910,3639,271,0,271
17669,10470,10199,2,0,7806,,,,,,1,1,1.623573855,3687,1946,1719,227,4,223
17669,11187,9519,2,0,1616,,,,,,1,1,0.438614669,662,413,285,128,1,127
17669,9620,11060,0,0,3165,,,,,,1,1,0.792853126,1484,770,629,141,0,141
17669,10339,10514,0,0,20093,,,,,,1,1,4.200352306,10317,4744,4456,288,2,286
17669,10488,10518,0,0,2936,,,,,,1,1,0.608756576,1317,732,577,155,0,155
17669,10422,10331,0,0,9128,,,,,,1,1,1.874407276,4310,2303,2091,212,0,212
17669,10549,9811,0,2,35210,,,,,,1,1,7.266124102,18490,8228,7964,264,4,260
17669,10611,9278,2,0,35378,,,,,,1,1,7.465930676,18625,8225,7922,303,4,299
17669,9514,10878,2,0,36209,,,,,,1,1,7.484466789,18260,8835,8556,279,2,277
17669,9721,9170,2,0,36958,,,,,,1,1,7.6352916749999995,19081,8782,8469,313,14,299
17669,10049,10622,0,0,2388,,,,,,1,1,0.491221994,995,624,479,145,2,143
17669,10896,9351,1,1,35481,,,,,,1,1,7.782021948,18654,8274,7995,279,1,278
17669,10446,9804,2,0,37299,,,,,,1,1,7.791022535,19092,8947,8634,313,6,307
17669,9989,10379,0,0,35967,,,,,,1,1,7.813018452,18647,8503,8189,314,2,312
17669,8118,11337,0,3,38727,,,,,,1,1,7.969278289,19285,9567,9259,308,4,304
17669,10199,9012,2,0,37718,,,,,,1,1,7.971548078,19425,8993,8686,307,1,306
17669,10287,10400,0,0,1816,,,,,,1,1,0.375812609,747,471,344,127,0,127
17669,10411,10277,2,0,1487,,,,,,1,1,0.314053464,633,372,262,110,0,110
17669,10565,9329,4,0,35975,,,,,,1,1,7.624487445,18427,8624,8324,300,4,296
17669,9504,10335,0,0,35975,,,,,,1,1,7.54741557,18896,8387,8082,305,1,304
17669,10341,8234,0,0,36786,,,,,,1,1,7.735107267,18950,8787,8525,262,2,260
17669,10405,9700,0,0,35993,,,,,,1,1,7.476735818,18329,8685,8391,294,3,291
17669,9889,10783,0,0,3591,,,,,,1,1,0.95042673,1573,922,748,174,1,173
17669,10098,9364,0,2,36505,,,,,,1,1,7.81215158,19006,8619,8358,261,3,258
17669,10462,10129,4,2,37252,,,,,,1,1,7.682748794,18823,9058,8745,313,4,309
17669,10798,9876,2,0,5657,,,,,,1,1,1.237201249,2719,1372,1178,194,4,190
17669,10030,10691,0,0,737,,,,,,1,1,0.156584942,247,201,113,88,0,88
17669,9068,10875,0,3,35399,,,,,,1,1,7.455871317,18628,8239,7946,293,5,288
17669,10296,10473,0,0,1999,,,,,,1,1,0.409772493,824,518,379,139,0,139
17669,9110,10144,0,0,38520,,,,,,1,1,8.114361141,19001,9615,9326,289,3,286
17669,9550,11129,0,0,11734,,,,,,1,1,2.394595407,5670,2908,2660,248,3,245
17669,10364,10507,0,2,9920,,,,,,1,1,2.148175405,4755,2460,2215,245,3,242
17669,10130,10455,2,2,37266,,,,,,1,1,7.802439695,19268,8842,8528,314,2,312
17669,9867,10807,0,2,10617,,,,,,1,1,2.173688647,5313,2531,2289,242,0,242
17669,9454,11571,0,3,8596,,,,,,1,1,1.751558824,4228,2065,1827,238,5,233
17669,8865,10287,0,0,37101,,,,,,1,1,7.560392742,19136,8831,8528,303,2,301
17669,10888,9079,0,0,37206,,,,,,1,1,7.892577641,18980,8954,8636,318,1,317
17669,9572,10906,0,2,37073,,,,,,1,1,7.623952459,18885,8936,8620,316,3,313
17669,9102,10464,0,2,37819,,,,,,1,1,7.914573218,19065,9235,8951,284,2,282
17669,8860,11823,0,0,2415,,,,,,1,1,0.511108683,1061,608,470,138,0,138
17669,11218,9528,0,0,2030,,,,,,1,1,0.53003297,894,501,367,134,0,134
17669,10675,10189,2,2,14790,,,,,,1,1,3.177630396,7187,3667,3398,269,1,268
17669,9404,11588,0,4,24537,,,,,,1,1,5.153250372,12732,5765,5490,275,3,272
17669,9042,11629,0,0,9910,,,,,,1,1,2.118795973,4819,2435,2214,221,0,221
17669,10480,10236,0,0,3632,,,,,,1,1,0.763649197,1669,897,728,169,1,168
17669,9757,10914,0,2,4396,,,,,,1,1,1.039045746,1994,1105,913,192,2,190
17669,10432,10238,0,0,14414,,,,,,1,1,2.922977817,7037,3553,3282,271,0,271
17669,10368,10338,0,0,9317,,,,,,1,1,2.01886939,4590,2246,2011,235,1,234
17669,10011,10511,0,0,37006,,,,,,1,1,7.645511782,18809,8944,8635,309,1,308
17669,10815,10213,0,0,2635,,,,,,1,1,0.558894296,1161,665,521,144,1,143
17669,10254,10678,2,1,18273,,,,,,1,1,3.8141332329999997,8982,4508,4233,275,10,265
17669,10342,9789,3,0,36895,,,,,,1,1,7.734415111,18919,8837,8535,302,4,298
17669,10716,10123,0,0,5004,,,,,,1,1,1.13674272,2268,1268,1068,200,0,200
17669,10494,10503,0,0,6663,,,,,,1,1,1.348549002,3153,1645,1425,220,0,220
17669,10547,10476,2,1,12529,,,,,,1,1,2.582327856,6437,2922,2674,248,4,244
17669,9864,10813,0,0,2795,,,,,,1,1,0.650800054,1227,700,532,168,1,167
17669,10596,10399,0,2,5734,,,,,,1,1,1.461886048,2709,1419,1232,187,2,185
17669,10471,10199,2,2,5364,,,,,,1,1,1.350793221,2542,1314,1120,194,4,190
17669,10789,10221,0,2,4744,,,,,,1,1,0.952028922,2137,1206,1011,195,2,193
17669,10293,10446,0,2,4992,,,,,,1,1,1.019221517,2356,1223,1033,190,3,187
17669,10091,10821,0,0,2468,,,,,,1,1,0.558272648,1139,594,453,141,0,141
17669,10490,9100,0,0,36134,,,,,,1,1,7.661128568,18444,8696,8398,298,3,295
17669,10096,10070,0,2,36921,,,,,,1,1,7.898917317,18932,8849,8558,291,3,288
17669,9319,10977,0,4,36526,,,,,,1,1,7.746354789,19013,8597,8278,319,3,316
17669,8873,9408,1,2,37414,,,,,,1,1,7.7846437680000005,19277,8937,8674,263,1,262
17669,10412,9028,4,2,37445,,,,,,1,1,7.721095409,19148,8980,8643,337,2,335
17669,10653,9786,2,0,37841,,,,,,1,1,7.853421795,18984,9265,8938,327,6,321
17669,10446,10225,0,0,4850,,,,,,1,1,0.990894598,2228,1227,1059,168,1,167
17669,10249,10018,0,4,36879,,,,,,1,1,7.760765827,18736,8922,8623,299,2,297
17669,9485,9459,2,0,37041,,,,,,1,1,7.759805954,18789,8995,8733,262,1,261
17669,9251,8511,3,0,38435,,,,,,1,1,7.898477482,19662,9261,9010,251,1,250
17669,10970,9756,0,0,2065,,,,,,1,1,0.442279186,879,528,398,130,0,130
17669,9737,9330,0,0,37877,,,,,,1,1,7.946491208,19277,9152,8856,296,1,295
17669,10952,9720,2,0,5880,,,,,,1,1,1.188105929,2793,1445,1248,197,1,196
17669,11007,10042,0,0,1094,,,,,,1,1,0.242682664,416,286,180,106,0,106
17669,10421,10257,0,0,1369,,,,,,1,1,0.295184449,549,352,236,116,0,116
17669,8550,9701,0,2,36581,,,,,,1,1,7.795362918,19228,8531,8240,291,10,281
17669,10004,10775,0,2,3712,,,,,,1,1,0.860399758,1671,941,782,159,2,157
17669,9334,9937,2,2,36988,,,,,,1,1,8.187885886,18966,8881,8621,260,1,259
17669,11215,8866,2,0,36595,,,,,,1,1,7.802159877,18616,8836,8529,307,3,304
17669,9250,10740,0,2,37165,,,,,,1,1,7.535048216,18946,8957,8652,305,1,304
17669,9785,10892,0,4,5354,,,,,,1,1,1.120052323,2435,1370,1191,179,5,174
17669,10592,9509,2,0,36453,,,,,,1,1,7.748542519,18733,8702,8386,316,6,310
17669,10809,10012,2,2,13855,,,,,,1,1,2.80962828,6721,3446,3204,242,1,241
17669,9372,11297,0,0,20251,,,,,,1,1,4.135141951,10287,4853,4595,258,2,256
17669,9761,11238,0,2,1385,,,,,,1,1,0.289217741,539,365,249,116,1,115
17669,10502,10302,0,0,925,,,,,,1,1,0.193602484,311,257,157,100,0,100
17669,10876,9332,0,0,34985,,,,,,1,1,7.19007216,18286,8213,7940,273,1,272
17669,8137,10095,2,0,36544,,,,,,1,1,7.463749179,19153,8558,8283,275,6,269
17669,9633,10889,2,0,34659,,,,,,1,1,7.802809688,18128,8116,7817,299,9,290
17669,9803,8757,0,0,38746,,,,,,1,1,8.440486971,19362,9554,9278,276,1,275
17669,10499,10177,1,2,7889,,,,,,1,1,1.664130277,3728,1972,1755,217,9,208
17669,10189,10577,0,0,4579,,,,,,1,1,0.959901595,2059,1165,975,190,0,190
17669,11479,9404,0,0,3817,,,,,,1,1,0.776102199,1792,929,762,167,0,167
17669,9104,9819,0,2,37092,,,,,,1,1,7.7568677600000004,18867,8965,8670,295,1,294
17669,10078,9989,0,0,35099,,,,,,1,1,7.397133441,18451,8188,7916,272,1,271
17669,10127,10556,0,2,2599,,,,,,1,1,0.543078541,1132,656,501,155,0,155
17669,9393,7828,0,0,38355,,,,,,1,1,7.896347189,19363,9358,9082,276,3,273
17669,10826,9781,2,0,37750,,,,,,1,1,8.395385255,19131,9151,8834,317,2,315
17669,10454,9687,4,1,38616,,,,,,1,1,8.034049624,19806,9227,8871,356,17,339
17669,9136,9123,2,1,38481,,,,,,1,1,7.894642547,19579,9301,9001,300,4,296
17669,11495,9126,3,2,35464,,,,,,1,1,8.25308103,18227,8464,8155,309,1,308
17669,9773,11162,0,0,3783,,,,,,1,1,0.776962801,1706,946,761,185,0,185
17669,9969,10162,4,5,37496,,,,,,1,1,8.14180156,19259,8962,8649,313,8,305
17669,10063,10085,2,2,37381,,,,,,1,1,8.479129908,19162,8963,8670,293,2,291
17669,10816,10180,0,2,11990,,,,,,1,1,2.76045199,6051,2856,2629,227,1,226
17669,10738,9025,4,0,34534,,,,,,1,1,7.524042916,18317,7970,7693,277,7,270
17669,10668,10347,0,2,8174,,,,,,1,1,1.757473974,3904,2015,1775,240,1,239
17669,10507,8899,0,2,37388,,,,,,1,1,7.799251964,19210,8944,8654,290,4,286
17669,9639,11030,0,0,4009,,,,,,1,1,0.775924877,1849,992,816,176,0,176
17669,10020,9149,2,0,37806,,,,,,1,1,7.76201732,19166,9173,8879,294,2,292
17669,11128,9233,1,0,35515,,,,,,1,1,7.689350903,18561,8333,8045,288,6,282
17669,10570,9536,2,2,37908,,,,,,1,1,8.34572818,19122,9224,8886,338,2,336
17669,10001,10400,2,0,37268,,,,,,1,1,7.850822217,18874,9046,8744,302,0,302
17669,9481,11198,0,0,8035,,,,,,1,1,1.655169841,3876,1970,1751,219,0,219
17669,10835,9834,0,0,9315,,,,,,1,1,1.937209097,4655,2215,1985,230,1,229
17669,9684,10986,0,0,3613,,,,,,1,1,0.802070608,1671,895,743,152,0,152
17669,9539,9964,2,2,35550,,,,,,1,1,7.916005768,18482,8381,8075,306,4,302
17669,10923,9846,4,0,4994,,,,,,1,1,1.016932468,2344,1237,1061,176,3,173
17669,9819,11006,0,2,5342,,,,,,1,1,1.105336072,2484,1324,1114,210,0,210
17669,10423,10075,0,0,35552,,,,,,1,1,7.481703637,18040,8599,8285,314,0,314
17669,11137,9532,3,0,21852,,,,,,1,1,4.526683419,11440,5075,4813,262,3,259
17669,9833,10952,2,8,20519,,,,,,1,1,4.251376291,10125,5057,4777,280,7,273
17669,8617,10954,0,0,36488,,,,,,1,1,7.840620916,18852,8677,8395,282,0,282
17669,10780,8820,2,0,36285,,,,,,1,1,7.526563591,18997,8506,8230,276,1,275
17669,9413,11415,2,0,1442,,,,,,1,1,0.299387294,603,365,256,109,1,108
17669,9564,11129,0,0,2839,,,,,,1,1,0.602390654,1218,732,575,157,1,156
17669,10290,8099,0,0,36579,,,,,,1,1,7.7097414109999995,18740,8793,8540,253,0,253
17669,9706,10698,2,0,36652,,,,,,1,1,7.611371328,18696,8812,8480,332,9,323
17669,10088,10733,0,0,2867,,,,,,1,1,0.585594996,1367,676,528,148,0,148
17669,10122,10552,0,0,14538,,,,,,1,1,2.935385773,7313,3487,3236,251,1,250
17669,10588,9348,4,2,38345,,,,,,1,1,7.870983163,19460,9292,8991,301,5,296
17669,8980,9279,2,2,38537,,,,,,1,1,8.069108896,19166,9540,9249,291,4,287
17669,9698,10979,0,0,5731,,,,,,1,1,1.178663188,2766,1392,1211,181,0,181
17669,10946,9724,0,0,5998,,,,,,1,1,1.279953329,2919,1437,1232,205,0,205
17669,10136,10546,0,2,3786,,,,,,1,1,0.781689482,1696,960,790,170,2,168
17669,10473,10205,0,0,1346,,,,,,1,1,0.280033362,537,343,220,123,0,123
17669,9906,9229,0,4,36180,,,,,,1,1,7.541075902,18884,8512,8240,272,2,270
17669,11055,9619,2,0,8294,,,,,,1,1,1.780824028,3942,2070,1858,212,4,208
17669,9236,11447,0,2,21573,,,,,,1,1,4.629946777,10942,5180,4909,271,3,268
17669,10187,10484,0,0,8400,,,,,,1,1,1.724691617,3996,2086,1854,232,0,232
17669,10027,10951,3,2,28097,,,,,,1,1,6.008633452,14503,6662,6392,270,7,263
17669,10255,10415,0,2,10493,,,,,,1,1,2.248631389,5213,2519,2277,242,2,240
17669,10379,10290,1,0,5838,,,,,,1,1,1.207699706,2809,1426,1249,177,0,177
17669,8813,10486,0,4,36991,,,,,,1,1,7.982123204,18954,8868,8567,301,8,293
17669,10680,9779,2,0,36277,,,,,,1,1,7.482706492,18461,8757,8455,302,1,301
17669,10422,10380,2,0,34479,,,,,,1,1,7.277586438,17816,8179,7874,305,2,303
17669,9929,10740,0,0,9239,,,,,,1,1,2.009634193,4592,2210,1983,227,0,227
17669,7964,10771,0,0,37143,,,,,,1,1,8.14671516,19094,8884,8603,281,3,278
17669,10231,10441,0,0,2222,,,,,,1,1,0.456220969,989,551,420,131,0,131
17669,10017,10096,0,4,38439,,,,,,1,1,8.284542877,19690,9228,8935,293,0,293
17669,10577,10097,0,0,3425,,,,,,1,1,0.723862688,1614,823,658,165,0,165
17669,10593,10159,0,0,945,,,,,,1,1,0.199319758,343,254,160,94,0,94
17669,9656,11185,4,2,3137,,,,,,1,1,0.640667114,1399,795,647,148,4,144
17669,10561,10036,0,0,35822,,,,,,1,1,7.94268039,18305,8608,8307,301,2,299
17669,10636,10259,0,0,5337,,,,,,1,1,1.076945673,2491,1331,1147,184,0,184
17669,8175,11577,2,5,35974,,,,,,1,1,7.371829748,18550,8577,8307,270,6,264
17669,9998,9898,0,0,36042,,,,,,1,1,7.458144203,18724,8504,8194,310,4,306
17669,11012,10001,0,0,8537,,,,,,1,1,1.7799295179999999,4101,2103,1873,230,0,230
17669,10544,8425,0,0,35868,,,,,,1,1,7.478070552,18326,8636,8366,270,8,262
17669,10883,9810,0,0,2326,,,,,,1,1,0.476984959,1083,548,401,147,0,147
17669,9598,11075,0,0,4624,,,,,,1,1,0.948439987,2232,1103,917,186,0,186
17669,10412,10259,0,0,3075,,,,,,1,1,0.682118574,1407,748,576,172,1,171
17669,10289,9441,0,0,35461,,,,,,1,1,7.383987836,18788,8195,7912,283,5,278
17669,9501,11184,0,0,3341,,,,,,1,1,0.942441479,1486,835,650,185,2,183
17669,11134,9679,0,0,3474,,,,,,1,1,0.713383332,1553,880,719,161,0,161
17669,9826,10849,0,4,5600,,,,,,1,1,1.326444435,2635,1382,1181,201,0,201
17669,10110,10561,4,0,6266,,,,,,1,1,1.2696519450000001,2954,1555,1353,202,3,199
17669,9664,11015,0,4,4792,,,,,,1,1,1.014951494,2301,1154,971,183,7,176
17669,11289,9397,2,0,2736,,,,,,1,1,0.561096737,1186,697,541,156,2,154
17669,10412,10259,2,2,13581,,,,,,1,1,3.088610502,6908,3219,2984,235,1,234
17669,11286,9383,0,0,2064,,,,,,1,1,0.4355842,887,521,386,135,0,135
17669,9909,10991,0,2,10293,,,,,,1,1,2.13900793,4975,2534,2284,250,3,247
17669,10039,10231,4,0,36579,,,,,,1,1,7.512186529,18898,8699,8416,283,0,283
17669,10788,9304,4,2,35831,,,,,,1,1,7.557119905,18526,8507,8216,291,5,286
17669,10235,10441,0,0,11197,,,,,,1,1,2.334846394,5616,2679,2456,223,0,223
17669,10689,8501,2,0,35878,,,,,,1,1,7.724955464,18755,8424,8149,275,2,273
17669,10716,9284,0,0,35845,,,,,,1,1,7.52524122,18643,8458,8172,286,3,283
17669,10754,10229,0,0,7818,,,,,,1,1,1.5761746620000001,3837,1882,1665,217,0,217
17669,9878,10271,0,0,36230,,,,,,1,1,7.701079543,18759,8589,8296,293,2,291
17669,9008,8830,0,0,37946,,,,,,1,1,7.9567082970000005,19322,9173,8895,278,2,276
17669,10514,10159,0,0,4470,,,,,,1,1,0.911024068,2062,1112,928,184,0,184
17669,10448,10291,1,0,12077,,,,,,1,1,2.437114858,6047,2899,2667,232,3,229
17669,10378,9698,0,0,36880,,,,,,1,1,7.688871245,19079,8745,8434,311,0,311
17669,11435,9236,0,0,8578,,,,,,1,1,1.769609024,4352,2006,1792,214,0,214
17669,10010,10712,0,0,1109,,,,,,1,1,0.230816389,404,303,204,99,0,99
17669,8957,10269,0,0,36411,,,,,,1,1,7.36643794,18870,8626,8337,289,2,287
17669,10074,10600,0,0,5018,,,,,,1,1,1.038932887,2322,1243,1033,210,0,210
17669,9154,10978,0,0,37680,,,,,,1,1,7.711406578,18995,9176,8843,333,2,331
17669,9709,10962,0,0,1446,,,,,,1,1,0.298691796,572,374,248,126,0,126
17669,9657,11041,2,0,4432,,,,,,1,1,0.900447021,2053,1111,954,157,0,157
17669,10807,9805,2,2,35192,,,,,,1,1,7.141145443,18248,8320,8016,304,5,299
17669,9137,10221,3,0,36356,,,,,,1,1,7.658052423,18672,8695,8401,294,4,290
17669,10124,10561,0,0,3974,,,,,,1,1,0.817055173,1815,994,823,171,0,171
17669,9228,10249,0,1,36009,,,,,,1,1,7.577721596,18730,8506,8239,267,0,267
17669,11057,9614,0,2,9387,,,,,,1,1,1.9358894420000001,4664,2257,2048,209,0,209
17669,10992,9698,0,0,3302,,,,,,1,1,0.7002147,1527,809,652,157,0,157
17669,11558,9112,0,0,3809,,,,,,1,1,0.83515626,1802,913,732,181,0,181
17669,9796,11100,0,2,15208,,,,,,1,1,3.087254505,7581,3682,3419,263,1,262
17669,9548,10312,0,0,35480,,,,,,1,1,7.654224724,18558,8312,8014,298,3,295
17669,10836,10113,0,2,19272,,,,,,1,1,3.911396362,9684,4667,4413,254,10,244
17669,10736,10199,0,0,4018,,,,,,1,1,0.820991916,1841,1002,829,173,1,172
17669,9070,9613,1,0,36479,,,,,,1,1,7.529597298,19070,8550,8241,309,3,306
17669,10451,10219,0,0,3883,,,,,,1,1,0.832962292,1772,957,760,197,0,197
17669,10143,10537,0,2,1856,,,,,,1,1,0.409809584,721,503,374,129,0,129
17669,10154,10517,2,3,5774,,,,,,1,1,1.180870617,2691,1449,1264,185,2,183
17669,9580,11133,0,4,2288,,,,,,1,1,0.465604651,938,602,456,146,0,146
17669,8881,10197,0,0,39523,,,,,,1,1,8.225754295,19972,9617,9300,317,0,317
17669,10271,8485,0,0,38448,,,,,,1,1,7.83647115,19271,9451,9176,275,3,272
17669,9990,10686,2,0,7244,,,,,,1,1,1.5035854450000001,3519,1758,1549,209,1,208
17669,11228,9217,3,0,35538,,,,,,1,1,7.280155017,18773,8251,7988,263,0,263
17669,10841,9833,0,0,5588,,,,,,1,1,1.202280677,2638,1370,1160,210,0,210
17669,9647,11240,2,0,1484,,,,,,1,1,0.352214893,614,377,261,116,1,115
17669,10412,10271,4,0,1444,,,,,,1,1,0.330294077,616,361,255,106,1,105
17669,10501,10171,0,0,3705,,,,,,1,1,0.820017952,1695,923,759,164,0,164
17669,9812,10868,0,0,10191,,,,,,1,1,2.194715498,4792,2587,2362,225,1,224
17669,10838,9737,0,2,35796,,,,,,1,1,7.646056569,18565,8463,8158,305,4,301
17669,10790,10194,0,0,35649,,,,,,1,1,7.249432668,18072,8632,8319,313,1,312
17669,10543,10127,0,0,2253,,,,,,1,1,0.463496963,958,573,424,149,0,149
17669,10310,10361,0,2,3528,,,,,,1,1,0.725114615,1601,878,707,171,2,169
17669,10171,10729,2,0,1933,,,,,,1,1,0.45634975,797,506,382,124,1,123
17669,10361,10309,0,0,1965,,,,,,1,1,0.453231241,841,500,376,124,0,124
17669,11021,9704,0,2,14442,,,,,,1,1,2.982208917,7421,3385,3134,251,0,251
17669,10074,10601,0,0,5608,,,,,,1,1,1.148726409,2566,1424,1230,194,0,194
17669,8578,9491,0,2,37953,,,,,,1,1,7.766253177,19089,9306,9054,252,2,250
17669,10229,9893,2,0,36115,,,,,,1,1,7.840817629,18742,8531,8220,311,2,309
17669,9823,11002,0,0,19935,,,,,,1,1,4.17654785,9969,4847,4575,272,1,271
17669,10280,9746,0,2,36847,,,,,,1,1,7.612102098,18807,8853,8519,334,2,332
17669,9692,10978,0,0,2039,,,,,,1,1,0.447578636,870,513,370,143,0,143
17669,11192,9441,0,2,35879,,,,,,1,1,7.608797325,18465,8539,8203,336,2,334
17669,10566,9857,2,0,35515,,,,,,1,1,7.467030516,18370,8422,8121,301,2,299
17669,9173,8282,0,0,36571,,,,,,1,1,7.750586385,19004,8672,8449,223,0,223
17669,10407,9901,0,0,36640,,,,,,1,1,7.913463628,18883,8718,8397,321,1,320
17669,10159,10849,0,0,2651,,,,,,1,1,0.550227855,1249,629,485,144,0,144
17669,10916,9003,0,0,36635,,,,,,1,1,7.859018389,18837,8747,8443,304,2,302
17669,10784,9938,0,0,2453,,,,,,1,1,0.501784493,1058,629,492,137,0,137
17669,10662,10019,0,0,1515,,,,,,1,1,0.326088552,650,370,245,125,0,125
17669,8993,10510,0,3,38709,,,,,,1,1,8.005928564,19475,9472,9182,290,1,289
17669,10999,9018,3,0,36470,,,,,,1,1,7.99029273,19154,8497,8175,322,2,320
17669,9830,10828,2,0,33773,,,,,,1,1,7.551261516,18208,7649,7382,267,4,263
17669,7844,10127,0,2,37726,,,,,,1,1,8.489328848,19272,9089,8813,276,1,275
17669,10811,10094,0,0,18149,,,,,,1,1,3.8071096840000003,9245,4318,4050,268,1,267
17669,11559,9190,0,0,2709,,,,,,1,1,0.630893797,1146,705,552,153,0,153
17669,10281,10371,4,2,35723,,,,,,1,1,7.817778122,18608,8406,8103,303,12,291
17669,9823,10518,0,0,33659,,,,,,1,1,7.182880593,17883,7740,7444,296,1,295
17669,9849,10836,0,0,2160,,,,,,1,1,0.48697949,958,538,412,126,0,126
17669,10365,10221,0,2,36390,,,,,,1,1,8.117884054,18543,8772,8469,303,8,295
17669,9805,11212,0,0,9526,,,,,,1,1,2.092579107,4588,2342,2088,254,0,254
17669,10816,10222,0,2,3471,,,,,,1,1,0.739097788,1574,863,692,171,2,169
17669,9964,11006,0,0,5273,,,,,,1,1,1.078135849,2476,1304,1115,189,0,189
17669,10288,10381,0,0,2093,,,,,,1,1,0.425378687,880,538,401,137,0,137
17669,10367,10660,0,0,6168,,,,,,1,1,1.275922418,2949,1514,1323,191,0,191
17669,10680,10293,3,0,27208,,,,,,1,1,5.591649705,13928,6490,6190,300,0,300
17669,10942,8966,2,0,37921,,,,,,1,1,7.7990237879999995,19119,9250,8948,302,2,300
17669,9877,10511,0,0,36386,,,,,,1,1,7.671504706,18866,8618,8334,284,1,283
17669,9661,11013,0,2,5190,,,,,,1,1,1.089155673,2457,1270,1077,193,0,193
17669,10092,9487,3,0,35966,,,,,,1,1,7.614893138,18606,8544,8272,272,1,271
17669,9587,11086,0,0,3156,,,,,,1,1,0.653779726,1389,806,651,155,0,155
17669,10379,10159,4,0,38340,,,,,,1,1,8.163065236,19578,9221,8901,320,0,320
17669,10598,9623,0,0,34868,,,,,,1,1,7.466349221,18411,8086,7801,285,2,283
17669,10324,10348,2,0,4366,,,,,,1,1,0.883340189,2034,1081,911,170,1,169
17669,11440,9229,0,2,14144,,,,,,1,1,2.902946955,7305,3311,3094,217,1,216
17669,10952,10056,0,2,35004,,,,,,1,1,7.499002487,18158,8279,7991,288,1,287
17669,10325,10669,0,2,6018,,,,,,1,1,1.301237448,2949,1446,1269,177,0,177
17669,10839,9840,0,2,2884,,,,,,1,1,0.59500453,1352,697,559,138,2,136
17669,10191,10482,0,2,5634,,,,,,1,1,1.163019087,2730,1358,1170,188,1,187
17669,10571,10100,0,4,4890,,,,,,1,1,1.017347367,2251,1228,1045,183,5,178
17669,10013,10479,0,2,35834,,,,,,1,1,7.452254477,18418,8537,8195,342,4,338
17669,9739,10838,0,0,37071,,,,,,1,1,7.7036398649999995,18669,9040,8718,322,3,319
17669,10815,9925,2,0,1639,,,,,,1,1,0.345205611,681,417,293,124,0,124
17669,10708,9802,3,2,36740,,,,,,1,1,7.795820049,18525,8940,8605,335,5,330
17669,10830,9843,0,0,1224,,,,,,1,1,0.254964464,516,300,192,108,0,108
17669,11164,9606,4,0,12065,,,,,,1,1,2.531726935,6011,2906,2664,242,3,239
17669,10024,8202,2,0,37870,,,,,,1,1,7.857604595,19352,9127,8863,264,3,261
17669,11172,9025,0,0,35580,,,,,,1,1,7.297010004,18591,8340,8031,309,4,305
17669,9770,11197,0,0,7293,,,,,,1,1,1.469944289,3443,1806,1568,238,1,237
17669,9471,10492,2,2,36893,,,,,,1,1,7.605954134,18780,8901,8590,311,1,310
17669,11136,9748,4,0,20168,,,,,,1,1,4.087211358,9974,4960,4686,274,5,269
17669,10359,10314,0,0,9688,,,,,,1,1,1.9523815,4657,2395,2154,241,0,241
17669,10157,10518,0,0,3305,,,,,,1,1,0.705851835,1491,816,634,182,0,182
17669,9894,10428,0,0,36904,,,,,,1,1,7.673995541,18496,9057,8763,294,3,291
17669,10951,9302,1,0,35791,,,,,,1,1,7.378213084,18221,8639,8347,292,2,290
17669,10992,9681,0,0,4365,,,,,,1,1,0.887492093,2014,1092,925,167,0,167
17669,9518,11152,0,2,4326,,,,,,1,1,0.898668088,2002,1079,913,166,1,165
17669,11519,9160,0,0,5939,,,,,,1,1,1.263210183,2678,1523,1308,215,0,215
17669,9809,11185,2,0,3188,,,,,,1,1,0.647823508,1427,799,636,163,3,160
17669,9800,11117,0,0,1366,,,,,,1,1,0.285041538,568,338,216,122,0,122
17669,8287,11605,0,2,36743,,,,,,1,1,7.740704591,18773,8840,8550,290,7,283
17669,9668,10712,4,0,38491,,,,,,1,1,8.189923899,19152,9520,9221,299,12,287
17669,11429,8548,3,0,36971,,,,,,1,1,7.614976592,18945,8859,8551,308,2,306
17669,9633,10520,2,2,36220,,,,,,1,1,7.652657234,18858,8524,8210,314,6,308
17669,10062,10613,0,0,9286,,,,,,1,1,1.933154359,4531,2263,2034,229,2,227
17669,10977,9705,4,0,2587,,,,,,1,1,0.548539923,1099,659,489,170,3,167
17669,10648,10055,2,0,12265,,,,,,1,1,2.471321998,6166,2933,2700,233,1,232
17669,9781,10426,0,0,36339,,,,,,1,1,7.540926197,18594,8715,8400,315,0,315
17669,9712,7907,0,0,38638,,,,,,1,1,7.891773673,19756,9314,9060,254,0,254
17669,10512,10170,0,0,2285,,,,,,1,1,0.464599329,976,584,443,141,0,141
17669,10202,10705,0,0,2013,,,,,,1,1,0.413160618,854,512,377,135,0,135
17669,8487,9844,0,3,38393,,,,,,1,1,8.09709476,19463,9334,9072,262,5,257
17669,9685,10985,0,0,742,,,,,,1,1,0.161259653,252,199,107,92,0,92
17669,9270,11400,0,0,33714,,,,,,1,1,6.7715598759999995,17086,8144,7804,340,2,338
17669,10569,10133,0,0,10593,,,,,,1,1,2.147428093,5286,2543,2322,221,0,221
17669,10428,10340,0,0,15172,,,,,,1,1,3.039065222,7545,3681,3416,265,2,263
17669,10712,10128,3,0,22834,,,,,,1,1,4.7214755109999995,11669,5435,5140,295,4,291
17669,9211,10362,2,0,37443,,,,,,1,1,7.875147456,18875,9118,8786,332,2,330
17669,10045,10640,0,0,2822,,,,,,1,1,0.596862464,1292,696,558,138,0,138
17669,11079,9590,4,0,13356,,,,,,1,1,2.778082149,6845,3133,2888,245,8,237
17669,9543,9257,0,0,36632,,,,,,1,1,7.760539682,18765,8784,8485,299,2,297
17669,10370,10324,0,0,2766,,,,,,1,1,0.573063023,1223,700,557,143,0,143
17669,10435,10248,2,2,1916,,,,,,1,1,0.392388567,831,478,349,129,1,128
17669,10141,9952,3,0,36000,,,,,,1,1,7.288947943,18501,8605,8316,289,4,285
17669,10164,10694,0,0,4343,,,,,,1,1,0.885330096,2077,1054,896,158,1,157
17669,9294,9708,0,3,37184,,,,,,1,1,7.783576003,19201,8848,8561,287,5,282
17669,10974,9646,2,2,38447,,,,,,1,1,7.755186483,19590,9258,8917,341,3,338
17669,9537,11339,2,2,31890,,,,,,1,1,6.551438246,16559,7523,7238,285,1,284
17669,9466,9714,0,0,37859,,,,,,1,1,7.667397168,19164,9184,8857,327,0,327
17669,9629,11167,0,0,3332,,,,,,1,1,0.685845773,1515,831,676,155,0,155
17669,11084,9598,0,2,14339,,,,,,1,1,2.92386478,7179,3467,3241,226,1,225
17669,10518,10171,2,2,4204,,,,,,1,1,0.855252493,1945,1035,846,189,4,185
17669,10337,10566,0,0,4662,,,,,,1,1,1.062583757,2193,1144,963,181,0,181
17669,10652,10018,0,0,1877,,,,,,1,1,0.416802076,765,486,346,140,0,140
17669,9723,10928,2,0,34642,,,,,,1,1,7.100443457,18002,8161,7843,318,3,315
17669,10788,9178,0,3,36103,,,,,,1,1,7.506385301,18553,8621,8313,308,6,302
17669,9677,11258,2,2,20243,,,,,,1,1,4.24116084,10470,4747,4468,279,2,277
17669,9973,9138,4,0,35577,,,,,,1,1,7.484035309,18348,8479,8208,271,2,269
17669,11324,9101,3,0,36921,,,,,,1,1,7.71184145,18994,8825,8548,277,0,277
17669,9838,9070,2,2,35761,,,,,,1,1,7.552009076,18676,8398,8109,289,11,278
17669,8555,10889,0,0,37368,,,,,,1,1,7.82611074,19068,8993,8679,314,10,304
17669,11322,9351,0,2,9098,,,,,,1,1,2.008664925,4425,2220,1987,233,5,228
17669,9460,11211,0,2,11676,,,,,,1,1,2.501938159,5911,2761,2518,243,0,243
17669,10788,9914,0,4,19870,,,,,,1,1,4.327628268,10224,4695,4439,256,1,255
17669,10563,10109,0,0,2131,,,,,,1,1,0.471034332,925,538,408,130,0,130
17669,10806,9886,0,0,1067,,,,,,1,1,0.228716613,409,280,182,98,0,98
17669,9078,11606,0,0,3537,,,,,,1,1,0.793386747,1716,835,684,151,0,151
17669,10169,10501,2,2,5040,,,,,,1,1,1.171102483,2412,1221,1035,186,1,185
17669,7995,9070,4,2,36933,,,,,,1,1,7.847671572,18943,8876,8638,238,3,235
17669,11604,8925,3,0,36315,,,,,,1,1,7.725191525,18320,8852,8561,291,0,291
17669,9312,11359,0,0,6131,,,,,,1,1,1.3276885649999999,2914,1503,1292,211,1,210
17669,10736,10017,0,0,5772,,,,,,1,1,1.200335674,2776,1395,1189,206,1,205
17669,9433,10467,0,0,35671,,,,,,1,1,7.338388141,18308,8531,8230,301,2,299
17669,9824,11077,0,0,2864,,,,,,1,1,0.581026578,1228,736,572,164,0,164
17669,10722,10326,0,0,2709,,,,,,1,1,0.566097233,1175,694,548,146,0,146
17669,9071,10515,2,0,35647,,,,,,1,1,7.300804391,18421,8467,8175,292,6,286
17669,10586,9600,0,0,35497,,,,,,1,1,7.335377592,18694,8246,7935,311,3,308
17669,10162,8765,2,0,35296,,,,,,1,1,7.632314684,18270,8373,8093,280,1,279
17669,9510,10899,0,0,37258,,,,,,1,1,7.840648001,18874,9022,8682,340,2,338
17669,8779,9262,0,3,38974,,,,,,1,1,8.496921291,19585,9558,9285,273,1,272
17669,9351,11318,0,4,5498,,,,,,1,1,1.133005686,2505,1394,1189,205,2,203
17669,9398,11272,2,0,5464,,,,,,1,1,1.197414115,2536,1365,1167,198,3,195
17669,10166,10505,0,0,17587,,,,,,1,1,3.546086167,8779,4264,3984,280,1,279
17669,10185,10514,0,0,3022,,,,,,1,1,0.629406369,1372,744,582,162,0,162
17669,10816,9855,2,0,5702,,,,,,1,1,1.159708785,2786,1361,1167,194,1,193
17669,9453,9795,0,0,36287,,,,,,1,1,8.005770476,18925,8540,8258,282,4,278
17669,10744,9572,2,0,38630,,,,,,1,1,8.118645768,19143,9590,9283,307,2,305
17669,10005,11037,0,2,2898,,,,,,1,1,0.599711551,1337,709,566,143,2,141
17669,9177,10075,2,0,35351,,,,,,1,1,8.530042624,18350,8362,8085,277,1,276
17669,8567,10821,2,0,38922,,,,,,1,1,8.143466402,19233,9681,9354,327,8,319
17669,10428,10243,0,0,8074,,,,,,1,1,1.743751011,3929,1966,1753,213,0,213
17669,10826,9259,0,4,36608,,,,,,1,1,8.153475373,18578,8868,8574,294,3,291
17669,10399,10358,0,0,1456,,,,,,1,1,0.39871683,574,380,258,122,0,122
17669,8651,9773,0,0,37489,,,,,,1,1,7.93540651,19368,8923,8648,275,0,275
17669,10396,10278,3,0,19785,,,,,,1,1,4.117770732,9776,4865,4586,279,3,276
17669,9362,11319,0,0,7538,,,,,,1,1,1.564120699,3771,1776,1561,215,0,215
17669,10353,10498,2,0,3090,,,,,,1,1,0.656552662,1383,768,597,171,2,169
17669,10999,10003,0,2,4800,,,,,,1,1,0.985851357,2250,1184,1002,182,0,182
17669,10058,10612,0,2,4964,,,,,,1,1,1.123533033,2363,1214,1041,173,1,172
17669,10331,10344,0,0,3121,,,,,,1,1,0.64178511,1460,768,643,125,0,125
17669,10238,10433,4,0,2861,,,,,,1,1,0.589085943,1284,711,556,155,6,149
17669,8807,10608,0,0,35686,,,,,,1,1,7.639821635,18542,8415,8101,314,4,310
17669,10670,10056,0,0,12119,,,,,,1,1,2.494140118,6109,2886,2648,238,1,237
17669,10169,10384,0,1,36249,,,,,,1,1,7.447926923,18746,8596,8285,311,0,311
17669,10152,10133,0,2,36182,,,,,,1,1,7.449092968,18714,8581,8275,306,3,303
17669,10777,9572,0,0,35436,,,,,,1,1,7.334480864,18427,8349,8038,311,4,307
17669,9587,8730,0,0,37310,,,,,,1,1,7.683441165,19015,9004,8717,287,3,284
17669,10364,9734,0,0,35239,,,,,,1,1,7.359686512,18372,8278,7967,311,3,308
17669,10572,10050,0,2,35572,,,,,,1,1,8.072521829,18503,8384,8083,301,3,298
17669,8674,11416,0,2,37578,,,,,,1,1,7.62630669,19048,9122,8836,286,4,282
17669,9887,10698,0,0,36459,,,,,,1,1,7.491625883,18519,8805,8475,330,5,325
17669,10125,10626,0,2,32869,,,,,,1,1,6.786433997,17147,7714,7420,294,2,292
17669,10708,9109,6,4,35055,,,,,,1,1,7.293204396,18047,8374,8114,260,8,252
17669,10977,9953,0,0,7270,,,,,,1,1,1.4676699819999999,3421,1817,1602,215,0,215
17669,11255,9414,0,0,5033,,,,,,1,1,1.038090728,2302,1271,1082,189,0,189
17669,10066,9591,4,0,36641,,,,,,1,1,7.665633653,18798,8775,8482,293,1,292
17669,10208,10574,2,0,23533,,,,,,1,1,4.802787987,12356,5447,5164,283,3,280
17669,9384,11288,0,0,1103,,,,,,1,1,0.230832689,424,285,176,109,0,109
17669,10338,10331,0,0,8006,,,,,,1,1,1.608700261,3666,2047,1801,246,0,246
17669,10382,9607,2,0,35745,,,,,,1,1,7.3379392,18649,8392,8080,312,2,310
17669,10311,10371,0,0,2442,,,,,,1,1,0.499442814,1051,621,472,149,0,149
17669,11092,9879,0,2,10100,,,,,,1,1,2.095836035,4944,2476,2272,204,2,202
17669,9551,11118,2,0,7601,,,,,,1,1,1.577673087,3667,1854,1628,226,0,226
17669,10251,10421,2,0,5543,,,,,,1,1,1.188749334,2624,1354,1143,211,1,210
17669,10645,10298,0,0,5927,,,,,,1,1,1.206995182,2859,1437,1243,194,0,194
17669,10145,10843,3,1,23536,,,,,,1,1,4.80605368,11790,5726,5432,294,9,285
17669,10551,10269,2,0,33563,,,,,,1,1,6.973037193,17140,8050,7727,323,0,323
17669,9667,9498,0,4,36475,,,,,,1,1,7.407499359,18996,8601,8324,277,0,277
17669,10541,10420,0,2,3149,,,,,,1,1,0.650009758,1470,762,607,155,2,153
17669,9429,9791,5,0,34997,,,,,,1,1,7.482277744,18035,8354,8100,254,2,252
17669,9721,11218,0,0,3021,,,,,,1,1,0.61796877,1351,746,568,178,0,178
17669,10845,8230,2,0,39003,,,,,,1,1,8.049131437,19683,9515,9225,290,7,283
17669,9978,10704,2,0,4646,,,,,,1,1,0.970977574,2237,1107,912,195,0,195
17669,11195,9372,0,2,34471,,,,,,1,1,7.481720486,18091,8050,7770,280,12,268
17669,10015,10964,0,0,23813,,,,,,1,1,4.937014489,11745,5909,5659,250,0,250
17669,9333,11033,0,2,37275,,,,,,1,1,7.897046314,18967,8986,8650,336,4,332
17669,10698,9991,0,0,1492,,,,,,1,1,0.308781888,604,387,273,114,1,113
17669,10591,10081,2,2,2166,,,,,,1,1,0.501277948,945,540,399,141,3,138
17669,10361,10260,2,2,35420,,,,,,1,1,7.21656065,18029,8550,8259,291,5,286
17669,10613,10037,0,0,35575,,,,,,1,1,7.404935267,18417,8432,8138,294,1,293
17669,10374,10100,0,1,36949,,,,,,1,1,7.560029059,18990,8835,8546,289,2,287
17669,10900,9780,0,0,1802,,,,,,1,1,0.384466764,734,468,336,132,0,132
17669,10175,10500,0,0,6982,,,,,,1,1,1.414375937,3381,1701,1502,199,0,199
17669,8714,10986,0,0,36015,,,,,,1,1,7.592555534,18351,8682,8382,300,2,298
17669,10624,10425,0,0,1581,,,,,,1,1,0.375122322,669,399,285,114,0,114
17669,10413,10261,2,0,34837,,,,,,1,1,7.636283704,17883,8328,8030,298,0,298
17669,10797,9107,2,0,36024,,,,,,1,1,7.60074717,18644,8551,8273,278,2,276
17669,11316,9373,2,0,8451,,,,,,1,1,1.9778259660000002,4245,1989,1761,228,3,225
17669,8946,9186,0,0,36813,,,,,,1,1,7.919046303,19040,8756,8495,261,2,259
17669,8927,8964,0,0,38885,,,,,,1,1,8.119591089,19877,9354,9054,300,1,299
17669,11544,9126,2,0,9153,,,,,,1,1,1.9092722009999998,4446,2243,2022,221,3,218
17669,10105,10565,0,0,1768,,,,,,1,1,0.357446962,714,461,329,132,0,132
17669,11337,8526,2,1,37459,,,,,,1,1,7.642873871,18962,9105,8818,287,2,285
17669,9946,10733,0,0,2310,,,,,,1,1,0.473217512,996,587,447,140,0,140
17669,9218,10993,2,4,34375,,,,,,1,1,7.298651201,18247,7927,7653,274,3,271
17669,10937,9611,2,0,34015,,,,,,1,1,7.158054698,18067,7834,7554,280,0,280
17669,11294,9720,0,0,4875,,,,,,1,1,1.015610066,2348,1175,998,177,1,176
17669,9148,11160,0,0,36005,,,,,,1,1,7.7853018899999995,18683,8512,8214,298,1,297
17669,9379,9695,2,2,36709,,,,,,1,1,7.748761043,18981,8721,8435,286,6,280
17669,9830,10841,0,0,12694,,,,,,1,1,2.76009822,6418,3020,2784,236,0,236
17669,10459,9882,0,3,36099,,,,,,1,1,7.774077433,18685,8566,8284,282,4,278
17669,9969,10713,2,0,3806,,,,,,1,1,0.885070054,1821,909,742,167,2,165
17669,7981,8355,0,0,39531,,,,,,1,1,8.456774308,19977,9636,9354,282,2,280
17669,11198,9502,0,2,4099,,,,,,1,1,0.844874199,1816,1052,873,179,1,178
17669,10533,10043,3,2,36742,,,,,,1,1,7.807216307,18679,8876,8565,311,3,308
17669,10644,10114,2,0,2977,,,,,,1,1,0.604733568,1298,762,607,155,2,153
17669,10653,10027,0,0,2754,,,,,,1,1,0.559962753,1268,669,521,148,0,148
17669,10702,10252,2,0,1754,,,,,,1,1,0.441121103,767,427,294,133,1,132
17669,10923,9583,0,0,36974,,,,,,1,1,7.806042622,18890,8885,8571,314,0,314
17669,9497,11277,3,2,22620,,,,,,1,1,4.851645189,11563,5390,5113,277,2,275
17669,7951,9949,0,0,38868,,,,,,1,1,8.608478907,19806,9391,9111,280,1,279
17669,8962,10956,0,0,38188,,,,,,1,1,8.381988734,18913,9470,9135,335,1,334
17669,10198,10678,0,0,2857,,,,,,1,1,0.662926756,1268,711,544,167,0,167
17669,9158,10676,0,0,36574,,,,,,1,1,8.120561054,19037,8622,8329,293,1,292
17669,9560,9700,0,2,37134,,,,,,1,1,7.676825047,18980,8913,8585,328,4,324
17669,10204,10221,0,0,35373,,,,,,1,1,7.634354973,18365,8344,8024,320,4,316
17669,11279,9413,0,0,1510,,,,,,1,1,0.337617193,607,391,270,121,0,121
17669,10794,10250,0,3,21795,,,,,,1,1,4.750732392,10988,5263,4982,281,2,279
17669,9758,10627,0,2,35330,,,,,,1,1,7.328416983,18382,8332,8048,284,3,281
17669,10361,8125,0,0,37561,,,,,,1,1,7.7784832139999995,19179,9050,8768,282,2,280
17669,9352,10099,2,0,36161,,,,,,1,1,7.702600464,18716,8580,8295,285,5,280
17669,10904,9767,0,0,7053,,,,,,1,1,1.473311657,3581,1626,1406,220,0,220
17669,10736,9657,2,2,35766,,,,,,1,1,7.600810257,18583,8447,8158,289,3,286
17669,11913,8473,0,0,35562,,,,,,1,1,7.682849167,18234,8508,8196,312,2,310
17669,9322,8946,2,0,38105,,,,,,1,1,8.277949938,19078,9372,9089,283,5,278
17669,9918,10895,3,0,3688,,,,,,1,1,0.791735888,1694,912,742,170,1,169
17669,9997,10687,0,0,1944,,,,,,1,1,0.409067035,876,471,345,126,0,126
17669,8846,11823,0,0,14459,,,,,,1,1,2.947804339,7160,3511,3234,277,1,276
17669,10082,9496,2,1,34803,,,,,,1,1,7.495743047,18223,8148,7864,284,11,273
17669,11349,9415,0,2,4513,,,,,,1,1,0.926343553,2004,1163,980,183,4,179
17669,10239,7962,0,0,36531,,,,,,1,1,7.797096138,19165,8555,8299,256,4,252
17669,8738,10186,0,1,37986,,,,,,1,1,8.146030028,19390,9160,8884,276,3,273
17669,10405,10445,3,0,23721,,,,,,1,1,4.927779234,11937,5749,5463,286,0,286
17669,10956,9716,0,0,19026,,,,,,1,1,3.879925377,9246,4752,4476,276,1,275
17669,10033,10938,0,0,1705,,,,,,1,1,0.348732238,723,428,302,126,0,126
17669,10600,10073,0,0,6717,,,,,,1,1,1.393397145,3395,1568,1382,186,0,186
17669,10884,10156,0,0,2530,,,,,,1,1,0.516429846,1108,635,483,152,0,152
17669,9932,10738,2,2,6756,,,,,,1,1,1.381204296,3215,1676,1487,189,3,186
17669,10210,9359,3,2,37280,,,,,,1,1,7.944942286,18935,9020,8715,305,5,300
17669,9658,10186,2,3,38010,,,,,,1,1,8.005919332,19211,9242,8927,315,2,313
17669,9507,10574,0,2,38607,,,,,,1,1,8.030858138,19557,9382,9096,286,9,277
17669,10285,10316,4,0,35439,,,,,,1,1,7.266338927,18552,8317,8064,253,5,248
17669,9339,10759,0,0,35179,,,,,,1,1,7.330979689,18386,8249,7954,295,2,293
17669,9929,10872,0,2,10025,,,,,,1,1,2.040421394,5103,2350,2128,222,0,222
17669,10485,10190,0,0,5100,,,,,,1,1,1.037817957,2406,1258,1080,178,1,177
17669,9995,10545,2,2,36438,,,,,,1,1,7.581330085,18791,8661,8336,325,3,322
17669,9501,10378,1,0,39715,,,,,,1,1,8.191009437,19741,9823,9495,328,1,327
17669,10671,10021,0,0,3999,,,,,,1,1,0.817137139,1855,971,769,202,0,202
17669,10127,10779,2,0,2341,,,,,,1,1,0.505963359,994,600,453,147,0,147
17669,9324,11229,4,0,33779,,,,,,1,1,6.959164651,17830,7836,7559,277,6,271
17669,9364,11312,2,0,4848,,,,,,1,1,1.022083751,2301,1185,1008,177,4,173
17669,10214,9978,0,0,37254,,,,,,1,1,7.651001604,19245,8849,8538,311,2,309
17669,8807,10122,0,2,35266,,,,,,1,1,7.531692628,18391,8289,7992,297,8,289
17669,10058,10620,0,4,8181,,,,,,1,1,1.788439559,3912,2029,1818,211,8,203
17669,10879,10021,0,0,12216,,,,,,1,1,2.548798405,6126,2936,2718,218,1,217
17669,11254,8956,2,3,37772,,,,,,1,1,7.732347876,19379,9050,8757,293,6,287
17669,9328,10015,0,1,36288,,,,,,1,1,7.445694197,18795,8597,8298,299,1,298
17669,10651,10045,0,2,4230,,,,,,1,1,0.96521296,1977,1046,885,161,2,159
17669,10577,10437,0,0,8695,,,,,,1,1,1.926441807,4363,2057,1839,218,0,218
17669,9157,10237,0,0,36744,,,,,,1,1,7.498895682,18941,8761,8480,281,3,278
17669,10855,9817,3,0,3010,,,,,,1,1,0.634003929,1268,790,628,162,0,162
17669,10645,10398,2,0,14408,,,,,,1,1,2.914732459,7270,3447,3203,244,1,243
17669,10234,9841,2,0,37572,,,,,,1,1,7.731426344,19208,9020,8696,324,5,319
17669,9977,11072,2,0,19764,,,,,,1,1,4.0701948,10001,4737,4448,289,1,288
17669,10600,9458,0,0,35700,,,,,,1,1,7.404668394,18719,8340,8039,301,2,299
17669,9380,9052,0,0,38876,,,,,,1,1,8.284420478,19572,9500,9196,304,1,303
17669,9335,8955,0,0,36298,,,,,,1,1,7.485307544,18474,8782,8522,260,0,260
17669,10144,10536,0,2,1103,,,,,,1,1,0.261295089,403,295,185,110,0,110
17669,9568,11173,2,3,12269,,,,,,1,1,2.5369257210000002,6222,2910,2683,227,1,226
17669,11856,8849,5,0,23519,,,,,,1,1,4.783366953,12357,5459,5215,244,6,238
17669,9771,8009,0,0,38496,,,,,,1,1,7.932349226,19640,9291,9017,274,3,271
17669,10173,9825,1,0,36686,,,,,,1,1,7.656138383,18617,8888,8595,293,3,290
17669,10293,10447,4,0,19046,,,,,,1,1,3.9976400549999997,9415,4668,4373,295,2,293
17669,9851,10557,2,0,35282,,,,,,1,1,7.270782328,18354,8328,8056,272,0,272
17669,11003,8909,2,0,37241,,,,,,1,1,7.681456315,18990,8977,8680,297,2,295
17669,10317,10356,3,0,2972,,,,,,1,1,0.638850244,1369,728,581,147,0,147
17669,11469,8684,4,2,36569,,,,,,1,1,7.53314405,18715,8759,8423,336,10,326
17669,8639,9996,0,11,37379,,,,,,1,1,7.627914918,19116,8997,8728,269,3,266
17669,10949,9723,2,0,17846,,,,,,1,1,3.792691902,9118,4237,3983,254,2,252
17669,10598,9873,2,0,34456,,,,,,1,1,7.427831078,18021,8079,7802,277,2,275
17669,8085,10256,0,0,36629,,,,,,1,1,7.488451765,18876,8735,8452,283,0,283
17669,10578,9485,4,2,36934,,,,,,1,1,7.824954091,18997,8822,8529,293,5,288
17669,9570,11076,2,0,34433,,,,,,1,1,7.189048893,18062,8040,7749,291,0,291
17669,9734,10847,2,2,36799,,,,,,1,1,7.590812987,18838,8818,8493,325,4,321
17669,11215,8960,0,2,34415,,,,,,1,1,7.168311828,18142,8008,7751,257,1,256
17669,10107,10496,2,0,34623,,,,,,1,1,7.127592423,18071,8130,7838,292,7,285
17669,9479,9623,0,0,38742,,,,,,1,1,7.932049986,19023,9725,9456,269,3,266
17669,10194,10849,2,0,4528,,,,,,1,1,0.984600544,2123,1114,937,177,1,176
17669,10459,9714,0,0,35274,,,,,,1,1,7.78440439,18142,8417,8119,298,1,297
17669,9874,10873,2,0,30739,,,,,,1,1,6.583873342,15465,7491,7199,292,4,288
17669,9812,9487,0,2,36554,,,,,,1,1,7.486413241,18686,8800,8532,268,2,266
17669,10622,10406,2,0,4799,,,,,,1,1,1.024800778,2355,1137,967,170,1,169
17669,10750,10275,0,2,4577,,,,,,1,1,0.944451355,2141,1130,954,176,0,176
17669,11013,9661,2,2,7762,,,,,,1,1,1.671150778,3763,1894,1683,211,5,206
17669,9953,10013,0,5,38092,,,,,,1,1,7.813321501,19500,9135,8813,322,8,314
17669,8994,11409,0,2,35137,,,,,,1,1,7.25957808,18621,8103,7793,310,1,309
17669,10318,10501,0,0,5673,,,,,,1,1,1.201893861,2659,1406,1204,202,1,201
17669,11621,9395,0,2,4638,,,,,,1,1,1.265133719,2187,1131,942,189,2,187
17669,10376,10295,0,0,8718,,,,,,1,1,1.9782114819999999,4047,2205,1944,261,0,261
17669,9946,9676,2,2,37638,,,,,,1,1,8.254346806,19264,9038,8740,298,11,287
17669,10796,9748,0,2,37151,,,,,,1,1,7.74752167,18737,9047,8727,320,2,318
17669,10182,9946,2,2,35846,,,,,,1,1,7.809198551,18416,8569,8277,292,8,284
17669,10583,10278,0,0,9999,,,,,,1,1,2.174381465,4826,2480,2267,213,0,213
17669,9940,9956,0,0,36842,,,,,,1,1,8.153560084,18698,8918,8610,308,2,306
17669,8963,10282,0,2,34500,,,,,,1,1,7.388961521,18533,7869,7640,229,0,229
17669,10124,10710,0,2,11120,,,,,,1,1,2.485330746,5394,2727,2455,272,1,271
17669,10395,10279,0,0,6520,,,,,,1,1,1.343686852,3141,1587,1382,205,0,205
17669,8569,10498,0,1,38455,,,,,,1,1,8.052831211,19512,9316,9005,311,6,305
17669,10310,10382,2,0,1209,,,,,,1,1,0.261727047,484,308,199,109,0,109
17669,10888,9854,0,0,2071,,,,,,1,1,0.432190665,894,518,377,141,0,141
17669,9493,10626,0,0,35147,,,,,,1,1,7.336332161,18361,8246,7952,294,3,291
17669,8504,9854,0,0,36431,,,,,,1,1,7.515680461,18973,8599,8339,260,4,256
17669,7595,9782,0,1,39137,,,,,,1,1,8.167237886,19842,9503,9214,289,2,287
17669,11086,9588,0,0,5189,,,,,,1,1,1.050419327,2326,1336,1145,191,0,191
17669,10773,9905,5,0,3852,,,,,,1,1,0.821144474,1715,984,815,169,1,168
17669,9253,10352,1,3,37787,,,,,,1,1,8.002178631,19020,9242,8959,283,0,283
17669,10535,9986,0,2,36934,,,,,,1,1,7.64509307,19037,8800,8503,297,1,296
17669,9878,9736,7,2,35339,,,,,,1,1,7.334825361,18475,8305,8051,254,4,250
17669,9596,11382,0,0,9177,,,,,,1,1,1.86512345,4545,2209,1995,214,0,214
17669,10589,10355,0,0,4587,,,,,,1,1,0.936505093,2216,1099,926,173,0,173
17669,10833,9839,0,0,1983,,,,,,1,1,0.410080421,853,498,364,134,0,134
17669,9016,11765,2,2,16564,,,,,,1,1,3.656101791,7969,4134,3807,327,12,315
17669,8455,9958,2,2,36670,,,,,,1,1,7.833844296,18989,8720,8479,241,6,235
17669,9468,11319,2,0,1308,,,,,,1,1,0.32583008,499,344,223,121,0,121
17669,9145,9960,0,2,36323,,,,,,1,1,7.619153711,18787,8631,8357,274,5,269
17669,9681,10881,0,0,36927,,,,,,1,1,7.575346243,18834,8888,8571,317,0,317
17669,10371,10554,0,0,7020,,,,,,1,1,1.431340311,3364,1724,1516,208,0,208
17669,10496,9551,2,0,35879,,,,,,1,1,7.445200224,18627,8469,8155,314,7,307
17669,9702,10968,0,0,13142,,,,,,1,1,2.905632817,6328,3279,3023,256,0,256
17669,10743,9053,2,0,37816,,,,,,1,1,7.707576457,18968,9260,8932,328,1,327
17669,10622,9636,2,2,37669,,,,,,1,1,7.859022848,19353,9011,8717,294,5,289
17669,10279,10201,0,2,35719,,,,,,1,1,7.289910143,18628,8393,8088,305,7,298
17669,11311,9533,0,0,7712,,,,,,1,1,1.8005992640000001,3810,1850,1648,202,2,200
17669,10713,9239,0,0,35980,,,,,,1,1,7.306246053,18710,8474,8152,322,4,318
17669,10624,10179,0,0,5249,,,,,,1,1,1.176308229,2497,1285,1103,182,0,182
17669,9619,9271,2,2,35410,,,,,,1,1,7.172889005,18498,8304,8000,304,14,290
17669,7620,11961,2,0,36450,,,,,,1,1,7.52334283,18880,8644,8362,282,3,279
17669,11395,9300,0,0,1845,,,,,,1,1,0.406686781,790,462,331,131,0,131
17669,10032,10641,2,0,2973,,,,,,1,1,0.601874928,1229,796,644,152,2,150
17669,10486,8254,2,0,37188,,,,,,1,1,7.874293102,19028,8942,8666,276,10,266
17669,10355,10317,5,0,33841,,,,,,1,1,6.953153429,16975,8289,8001,288,5,283
17669,10316,10383,0,0,1916,,,,,,1,1,0.40778183,788,497,363,134,0,134
17669,10090,10447,0,0,37657,,,,,,1,1,7.75064882,18918,9210,8891,319,4,315
17669,9329,10272,2,0,36897,,,,,,1,1,7.690788057,19172,8720,8435,285,1,284
17669,9526,11230,2,0,16840,,,,,,1,1,3.5176122420000002,8503,4048,3807,241,0,241
17669,10663,10024,2,2,2310,,,,,,1,1,0.567597465,1052,553,401,152,0,152
17669,12095,8582,0,0,6389,,,,,,1,1,1.455399043,2903,1637,1425,212,1,211
17669,9120,9852,0,2,35601,,,,,,1,1,7.591247502,18660,8335,8064,271,1,270
17669,9852,10832,0,0,4857,,,,,,1,1,1.055715774,2273,1191,989,202,0,202
17669,9723,11199,0,2,6613,,,,,,1,1,1.463034832,3347,1535,1339,196,0,196
17669,9947,9229,0,0,38460,,,,,,1,1,7.923768394,19207,9484,9199,285,2,283
17669,9714,9893,0,2,36650,,,,,,1,1,7.867046797,18738,8795,8473,322,0,322
17669,10408,10261,0,4,9477,,,,,,1,1,1.992009004,4754,2248,2021,227,2,225
17669,11196,9479,2,0,6347,,,,,,1,1,1.38875209,3073,1536,1334,202,4,198
17669,9753,10918,0,0,19925,,,,,,1,1,4.027980125,10088,4786,4521,265,1,264
17669,10755,9919,0,0,3423,,,,,,1,1,0.701376957,1473,894,732,162,0,162
17669,11084,9770,0,0,2382,,,,,,1,1,0.487561617,992,625,485,140,0,140
17669,10298,9615,2,0,35536,,,,,,1,1,7.500458096,18351,8453,8174,279,2,277
17669,10594,10081,0,0,3931,,,,,,1,1,0.809812871,1807,976,804,172,0,172
17669,10550,10129,0,2,1874,,,,,,1,1,0.387080856,750,495,361,134,1,133
17669,9449,11319,0,0,11348,,,,,,1,1,2.414860068,5738,2693,2469,224,2,222
17669,10754,9915,0,0,2219,,,,,,1,1,0.451920878,978,551,412,139,0,139
17669,9562,10626,0,3,35820,,,,,,1,1,7.53969439,18505,8512,8221,291,7,284
17669,10328,9710,0,0,37719,,,,,,1,1,7.797756591,19095,9151,8829,322,5,317
17669,12001,8870,6,0,2906,,,,,,1,1,0.623027369,1294,725,563,162,0,162
17669,11946,8726,3,0,7948,,,,,,1,1,1.7209760969999999,3773,1981,1768,213,0,213
17669,10291,10396,2,0,3074,,,,,,1,1,0.625296989,1358,769,591,178,3,175
17669,10365,10305,0,0,19878,,,,,,1,1,4.22332301,9877,4863,4588,275,1,274
17669,10430,9831,2,8,35568,,,,,,1,1,7.666128902,18314,8474,8168,306,13,293
17669,11172,8575,3,0,36272,,,,,,1,1,7.878170874,18827,8591,8328,263,4,259
17669,10180,9897,0,2,37343,,,,,,1,1,7.908333439,18993,9005,8665,340,6,334
17669,10185,10605,0,2,23551,,,,,,1,1,5.133420926,12243,5514,5234,280,1,279
17669,10152,10517,0,0,15858,,,,,,1,1,3.266206956,8330,3639,3389,250,0,250
17669,10272,10426,0,2,10253,,,,,,1,1,2.292025071,5067,2478,2248,230,0,230
17669,9446,11262,2,0,3402,,,,,,1,1,0.688150364,1530,849,675,174,2,172
17669,10722,9951,0,2,11205,,,,,,1,1,2.204312468,5672,2649,2414,235,2,233
17669,10102,10412,0,0,36902,,,,,,1,1,8.132444432,19076,8734,8376,358,1,357
17669,9506,10009,2,2,37808,,,,,,1,1,7.825501554,19287,9103,8788,315,3,312
17669,9903,10767,0,0,4933,,,,,,1,1,1.113493726,2392,1185,1014,171,0,171
17669,9866,10448,2,2,38737,,,,,,1,1,8.449817514,19341,9543,9233,310,4,306
17669,8980,9920,4,1,36311,,,,,,1,1,7.952083627,18522,8770,8521,249,3,246
17669,9660,10907,0,0,35757,,,,,,1,1,7.694510128,18450,8497,8184,313,0,313
17669,9456,11215,0,2,2201,,,,,,1,1,0.453378778,921,573,439,134,0,134
17669,10328,10342,0,2,7502,,,,,,1,1,1.5286501129999999,3593,1850,1641,209,6,203
17669,10229,10735,0,0,1014,,,,,,1,1,0.214398731,372,267,159,108,0,108
17669,10402,10012,0,4,36762,,,,,,1,1,7.852346545,19147,8643,8314,329,10,319
17669,9368,11305,0,0,3214,,,,,,1,1,0.676556024,1539,761,608,153,0,153
17669,10374,9215,2,0,38095,,,,,,1,1,8.051399388,19550,9127,8836,291,2,289
17669,11071,8738,0,0,36843,,,,,,1,1,7.796778527,18760,8904,8629,275,3,272
17669,10436,10247,0,0,2805,,,,,,1,1,0.57331913,1243,699,535,164,0,164
17669,10448,9439,0,0,35568,,,,,,1,1,7.639254776,18427,8424,8131,293,0,293
17669,9970,10896,4,0,3938,,,,,,1,1,0.803472207,1811,983,822,161,0,161
17669,10311,10656,2,0,12783,,,,,,1,1,2.631545814,6267,3141,2907,234,2,232
17669,9953,9421,0,0,36149,,,,,,1,1,7.546686993,18809,8530,8250,280,2,278
17669,9822,10848,2,0,6185,,,,,,1,1,1.274338673,2886,1547,1342,205,5,200
17669,9869,10824,0,2,7349,,,,,,1,1,1.5493872180000001,3469,1830,1610,220,4,216
17669,10825,8353,2,0,37908,,,,,,1,1,7.838113198,18966,9331,9051,280,6,274
17669,10323,10379,0,2,1933,,,,,,1,1,0.393929976,785,508,376,132,0,132
17669,10326,8851,2,0,37731,,,,,,1,1,7.912212055,19336,9032,8701,331,3,328
17669,10683,9508,0,2,36282,,,,,,1,1,7.636606799,18942,8522,8226,296,0,296
17669,10110,10559,2,2,22254,,,,,,1,1,4.680591841,11191,5399,5134,265,4,261
17669,10467,10271,0,4,4846,,,,,,1,1,0.977604839,2201,1222,1021,201,2,199
17669,10347,8033,0,0,38083,,,,,,1,1,7.977077792,19554,9136,8879,257,5,252
17669,10149,10297,0,0,37634,,,,,,1,1,7.756997945,19116,9102,8788,314,5,309
17669,9817,9269,2,2,36114,,,,,,1,1,7.43347574,18737,8546,8261,285,9,276
17669,10221,10661,2,0,14066,,,,,,1,1,2.883295161,6980,3406,3132,274,2,272
17669,10964,9707,1,2,14551,,,,,,1,1,3.097852718,7383,3454,3194,260,3,257
17669,9778,10904,0,2,4614,,,,,,1,1,0.960979143,2084,1170,980,190,2,188
17669,9318,11355,0,2,7205,,,,,,1,1,1.501452078,3451,1783,1595,188,0,188
17669,11478,8803,2,0,35182,,,,,,1,1,7.551644972,18203,8343,8050,293,0,293
17669,11573,8990,0,1,37065,,,,,,1,1,7.670141542,18810,8979,8682,297,2,295
17669,10338,10406,1,1,32969,,,,,,1,1,6.992853701,16780,7933,7610,323,3,320
17669,9690,10568,4,0,35741,,,,,,1,1,7.245748398,18510,8466,8167,299,1,298
17669,9557,10624,3,1,36573,,,,,,1,1,7.601769515,18700,8778,8461,317,13,304
17669,9829,10805,0,0,34324,,,,,,1,1,7.082973623,18118,7963,7683,280,0,280
17669,9112,11566,0,4,4777,,,,,,1,1,0.994553026,2112,1225,1010,215,5,210
17669,10800,9869,0,0,22813,,,,,,1,1,4.7248175759999995,11428,5546,5253,293,1,292
17669,9792,10877,0,2,1324,,,,,,1,1,0.277064027,531,341,230,111,2,109
17669,11004,9668,0,0,4523,,,,,,1,1,0.914188696,2104,1109,908,201,0,201
17669,9553,11011,2,0,35424,,,,,,1,1,7.540704233,18252,8427,8109,318,3,315
17669,10175,8937,3,2,34864,,,,,,1,1,7.191530084,18151,8227,7968,259,1,258
17669,10707,9147,0,0,35506,,,,,,1,1,7.494857676,18449,8396,8131,265,1,264
17669,10211,10458,0,2,3662,,,,,,1,1,0.740663439,1633,933,770,163,0,163
17669,10321,10416,0,2,1975,,,,,,1,1,0.418335417,809,511,367,144,0,144
17669,8734,11909,0,2,36016,,,,,,1,1,7.535321619,18597,8556,8249,307,1,306
17669,9528,11286,0,2,6671,,,,,,1,1,1.344323831,3106,1670,1445,225,4,221
17669,11684,9292,2,0,2037,,,,,,1,1,0.422827218,872,519,392,127,1,126
17669,9432,11237,0,2,6278,,,,,,1,1,1.276987048,2996,1543,1347,196,0,196
17669,10382,10026,0,0,37256,,,,,,1,1,7.834190606,18866,9027,8691,336,2,334
17669,10428,10243,0,0,7237,,,,,,1,1,1.4811360439999999,3347,1840,1630,210,0,210
17669,10022,10648,0,0,2820,,,,,,1,1,0.579519992,1271,695,536,159,0,159
17669,10020,10971,0,2,7101,,,,,,1,1,1.456912873,3515,1691,1487,204,2,202
17669,9047,10326,0,0,35781,,,,,,1,1,7.275876678,18396,8556,8283,273,0,273
17669,10927,9017,1,0,36145,,,,,,1,1,7.621463149,18518,8672,8389,283,2,281
17669,9799,10902,0,2,7742,,,,,,1,1,1.716767908,3776,1879,1671,208,1,207
17669,9207,10964,0,2,35183,,,,,,1,1,7.407290589,18275,8318,8046,272,3,269
17669,10306,9920,0,0,35513,,,,,,1,1,7.757969571,18580,8313,8006,307,6,301
17669,9840,8900,0,2,37056,,,,,,1,1,7.611112708,19171,8804,8527,277,2,275
17669,10148,10642,0,2,16639,,,,,,1,1,3.53663429,8363,4000,3724,276,1,275
17669,10754,9916,0,0,1532,,,,,,1,1,0.317241242,614,398,276,122,0,122
17669,10920,8913,0,0,36680,,,,,,1,1,7.607903971,18877,8763,8486,277,5,272
17669,10686,9868,0,0,36789,,,,,,1,1,7.571671619,18952,8765,8458,307,3,304
17669,9916,10097,0,2,35620,,,,,,1,1,7.440651107,18471,8418,8105,313,1,312
17669,9469,11217,0,2,26447,,,,,,1,1,5.8516325590000005,13850,6171,5916,255,3,252
17669,10967,8778,0,0,36897,,,,,,1,1,7.696443979,18986,8795,8474,321,1,320
17669,10209,10473,0,0,4485,,,,,,1,1,0.941333244,2077,1112,928,184,0,184
17669,9484,11187,0,2,1378,,,,,,1,1,0.296448744,550,361,255,106,0,106
17669,11535,9480,0,0,7269,,,,,,1,1,1.478939561,3603,1736,1542,194,0,194
17669,10280,10389,0,4,5099,,,,,,1,1,1.057125887,2286,1310,1117,193,3,190
17669,10200,10471,2,0,18725,,,,,,1,1,3.820017614,9248,4598,4317,281,2,279
17669,9953,10819,4,0,6425,,,,,,1,1,1.41432865,3066,1579,1378,201,7,194
17669,10135,10557,0,0,10662,,,,,,1,1,2.383721429,5183,2627,2402,225,0,225
17669,10259,10149,3,2,34994,,,,,,1,1,7.626251444,18243,8244,7981,263,2,261
17669,10985,9689,0,0,4018,,,,,,1,1,0.837125587,1841,995,808,187,0,187
17669,10549,9468,2,4,36398,,,,,,1,1,7.540455103,18953,8581,8298,283,2,281
17669,9018,10203,4,0,38529,,,,,,1,1,7.992636599,19444,9394,9097,297,2,295
17669,10154,10162,0,0,35124,,,,,,1,1,7.218703011,18075,8364,8043,321,1,320
17669,9572,9736,0,0,38819,,,,,,1,1,8.123241002,19413,9551,9247,304,4,300
17669,9373,11296,0,0,7585,,,,,,1,1,1.611522189,3566,1908,1705,203,0,203
17669,9994,10839,0,0,1778,,,,,,1,1,0.387347757,715,467,338,129,0,129
17669,8940,10684,2,2,37544,,,,,,1,1,7.787504998,19367,8945,8658,287,12,275
17669,8555,9775,0,0,36615,,,,,,1,1,7.703805992,18859,8745,8479,266,1,265
17669,10630,10051,0,0,1714,,,,,,1,1,0.365546723,734,424,292,132,0,132
17669,9764,9431,0,2,35098,,,,,,1,1,7.52807329,18506,8170,7918,252,2,250
17669,10269,10598,0,0,4133,,,,,,1,1,0.838294527,1879,1030,836,194,1,193
17669,9700,10991,0,0,2064,,,,,,1,1,0.42955405,902,510,368,142,0,142
17669,10336,10708,0,0,12442,,,,,,1,1,2.550319327,6043,3069,2808,261,0,261
17669,9741,11226,2,2,34212,,,,,,1,1,7.192232018,17325,8293,7992,301,2,299
17669,10385,9376,2,0,37495,,,,,,1,1,7.727562814,19185,9012,8726,286,1,285
17669,9312,9402,0,4,36583,,,,,,1,1,7.5595378570000005,19358,8484,8227,257,2,255
17669,8975,11695,0,0,4277,,,,,,1,1,0.874458467,1965,1064,880,184,1,183
17669,10542,9894,0,0,35047,,,,,,1,1,7.370187843,18581,8088,7798,290,3,287
17669,9775,10021,0,0,34576,,,,,,1,1,7.478001997,18073,8101,7800,301,5,296
17669,9628,9453,0,2,36924,,,,,,1,1,7.900481768,19060,8794,8518,276,2,274
17669,9933,10761,6,2,9713,,,,,,1,1,2.064238238,4796,2343,2112,231,7,224
17669,9624,10810,1,2,35756,,,,,,1,1,7.718671796,18582,8452,8182,270,3,267
17669,9642,9345,0,0,36698,,,,,,1,1,7.853923602,19026,8697,8419,278,3,275
17669,9867,11075,0,0,3410,,,,,,1,1,0.736946936,1544,854,696,158,0,158
17669,9942,10734,2,2,3670,,,,,,1,1,0.772312618,1629,934,761,173,2,171
17669,9712,10758,1,2,36905,,,,,,1,1,7.664058358,18973,8819,8525,294,4,290
17669,9717,9993,0,2,35324,,,,,,1,1,7.238505622,18360,8339,8053,286,2,284
17669,10883,9671,0,0,36429,,,,,,1,1,7.590865732,18516,8809,8514,295,0,295
17669,9912,10896,0,0,3481,,,,,,1,1,0.748521408,1591,859,687,172,0,172
17669,9054,11617,0,4,10782,,,,,,1,1,2.325092614,5416,2574,2356,218,6,212
17669,11148,9525,0,2,4547,,,,,,1,1,0.946862368,2128,1116,929,187,3,184
17669,10439,9704,0,0,35108,,,,,,1,1,7.3690576629999995,18292,8273,8003,270,2,268
17669,8810,10726,0,3,37346,,,,,,1,1,7.877103386,19081,8978,8669,309,3,306
17669,10719,9956,0,0,5709,,,,,,1,1,1.169404766,2743,1377,1165,212,0,212
17669,10243,10429,0,2,4453,,,,,,1,1,0.896382229,2085,1098,926,172,0,172
17669,9456,10514,0,0,37715,,,,,,1,1,7.689415243,19189,9110,8804,306,4,302
17669,10431,9543,0,0,37616,,,,,,1,1,8.158227889,19326,8985,8665,320,2,318
17669,10593,10079,2,0,17550,,,,,,1,1,3.899294025,8547,4355,4062,293,2,291
17669,10544,10126,0,4,8071,,,,,,1,1,1.684923624,3909,1976,1766,210,2,208
17669,10332,10332,4,4,37492,,,,,,1,1,7.860522113,19234,8988,8706,282,1,281
17669,9666,11010,0,2,2508,,,,,,1,1,0.570992552,1126,616,466,150,3,147
17669,9812,10591,0,0,35789,,,,,,1,1,7.271566399,18791,8336,8010,326,2,324
17669,10307,10596,0,0,1136,,,,,,1,1,0.236420048,422,302,192,110,0,110
17669,10610,10171,0,0,1839,,,,,,1,1,0.378557378,818,445,314,131,0,131
17669,9843,9819,7,0,35847,,,,,,1,1,7.828831069,18273,8650,8376,274,6,268
17669,9377,11126,0,0,36446,,,,,,1,1,7.793859423,18628,8758,8456,302,2,300
17669,10157,10514,2,0,18412,,,,,,1,1,3.835162416,9303,4427,4172,255,2,253
17669,8577,10229,2,2,37865,,,,,,1,1,7.705397124,19310,9124,8817,307,15,292
17669,10963,9312,0,0,36825,,,,,,1,1,7.651608678,18802,8843,8506,337,1,336
17669,10464,9024,2,0,35276,,,,,,1,1,7.312460344,18658,8181,7925,256,0,256
17669,10324,10347,0,0,11728,,,,,,1,1,2.457698422,5922,2781,2537,244,1,243
17669,10653,10213,0,0,3994,,,,,,1,1,0.86777217,1857,993,842,151,0,151
17669,11106,9616,0,0,4276,,,,,,1,1,0.863845777,1957,1067,882,185,1,184
17669,11210,9708,0,2,4108,,,,,,1,1,1.031789392,1930,1003,831,172,1,171
17669,10655,9181,2,2,36294,,,,,,1,1,7.563524428,18712,8649,8365,284,1,283
17669,10700,9860,4,2,38279,,,,,,1,1,8.346503155,19170,9394,9073,321,6,315
17669,9576,10267,2,0,36015,,,,,,1,1,7.454582134,18839,8441,8147,294,4,290
17669,10112,10576,0,2,1835,,,,,,1,1,0.394752267,823,448,332,116,0,116
17669,9693,11112,0,0,2332,,,,,,1,1,0.477596914,1041,580,449,131,0,131
17669,11224,9813,2,0,2533,,,,,,1,1,0.55654903,1093,643,489,154,1,153
17669,9045,11048,0,0,36292,,,,,,1,1,7.695776336,18816,8588,8288,300,4,296
17669,10444,9955,0,2,38014,,,,,,1,1,7.853627578,18971,9346,8995,351,2,349
17669,9328,10888,0,4,36271,,,,,,1,1,7.463014575,18769,8600,8298,302,0,302
17669,11050,9175,1,0,34921,,,,,,1,1,7.506661672,18312,8173,7910,263,3,260
17669,10223,8637,0,0,38135,,,,,,1,1,7.78170411,19448,9193,8892,301,1,300
17669,10084,10381,4,2,35857,,,,,,1,1,7.413082927,18491,8541,8257,284,3,281
17669,10219,9006,2,0,34735,,,,,,1,1,7.276172932,18284,8087,7810,277,8,269
17669,8646,9486,0,0,37976,,,,,,1,1,8.043072453,19463,9117,8838,279,2,277
17669,10547,10189,2,0,6792,,,,,,1,1,1.431811395,3485,1562,1379,183,1,182
17669,9494,10974,2,1,34270,,,,,,1,1,7.419045204,17903,8044,7765,279,4,275
17669,8269,10987,0,2,37012,,,,,,1,1,7.56903413,19056,8855,8609,246,2,244
17669,10291,10005,1,4,34658,,,,,,1,1,7.453192651,18285,8045,7762,283,3,280
17669,9071,11624,0,0,1122,,,,,,1,1,0.231825302,418,299,193,106,0,106
17669,10197,10475,2,0,4203,,,,,,1,1,0.864315198,1998,1021,858,163,1,162
17669,9938,10639,0,0,35532,,,,,,1,1,7.493647854,18511,8377,8110,267,3,264
17669,10385,10284,2,0,16870,,,,,,1,1,3.466736793,8541,4038,3785,253,0,253
17669,11099,8953,2,0,36302,,,,,,1,1,7.458327232,18864,8574,8284,290,1,289
17669,9211,11459,0,0,2779,,,,,,1,1,0.566045326,1253,682,520,162,0,162
17669,10634,9222,2,0,39650,,,,,,1,1,8.200267124,19899,9704,9361,343,0,343
17669,10333,10046,2,0,34751,,,,,,1,1,7.3443751,18239,8113,7827,286,5,281
17669,10013,10124,0,2,37146,,,,,,1,1,7.840205768,18949,8923,8572,351,2,349
17669,10293,10430,2,5,16119,,,,,,1,1,3.384786127,8227,3839,3625,214,6,208
17669,10877,10041,4,0,19958,,,,,,1,1,4.116149512,10100,4789,4509,280,2,278
17669,11381,9570,0,2,28189,,,,,,1,1,5.709244712,14086,6899,6594,305,1,304
17669,8455,9585,2,0,36603,,,,,,1,1,7.666592059,18656,8845,8588,257,2,255
17669,8840,10701,0,0,37137,,,,,,1,1,8.054886716,19105,8862,8554,308,1,307
17669,10211,10483,0,0,1448,,,,,,1,1,0.29326452,586,371,251,120,0,120
17669,10550,9399,4,0,37704,,,,,,1,1,8.044877844,19255,9079,8788,291,4,287
17669,10922,9789,0,2,5901,,,,,,1,1,1.36637423,2754,1479,1290,189,3,186
17669,10482,10214,1,2,36140,,,,,,1,1,7.532346142,18206,8817,8517,300,0,300
17669,10773,9896,0,0,9505,,,,,,1,1,2.367471164,4856,2212,1987,225,0,225
17669,10687,9102,0,0,36376,,,,,,1,1,7.758744955,18543,8772,8483,289,3,286
17669,8942,8023,0,0,37823,,,,,,1,1,7.995797076,19561,9006,8756,250,4,246
17669,10152,9606,2,1,36963,,,,,,1,1,7.791059805,18890,8889,8594,295,2,293
17669,8604,10786,0,0,35146,,,,,,1,1,7.886460936,18299,8275,7978,297,2,295
17669,8481,10554,0,0,37437,,,,,,1,1,8.176631175,18914,9130,8867,263,2,261
17669,10571,10098,0,0,1736,,,,,,1,1,0.365627688,757,421,284,137,0,137
17669,10869,9571,0,0,35300,,,,,,1,1,7.499571457,18370,8312,8006,306,2,304
17669,12036,8648,2,0,2952,,,,,,1,1,0.589665158,1329,737,588,149,1,148
17669,10507,9415,2,2,35667,,,,,,1,1,7.65921066,18342,8525,8250,275,12,263
17669,9968,8507,2,0,35535,,,,,,1,1,7.649073948,18316,8488,8245,243,4,239
17669,9701,10289,1,0,38443,,,,,,1,1,8.142169864,19255,9428,9096,332,9,323
17669,10653,10360,0,0,2835,,,,,,1,1,0.608136423,1229,727,575,152,1,151
17669,10470,10200,0,0,2360,,,,,,1,1,0.480379452,1096,563,425,138,0,138
17669,10458,10211,0,0,28882,,,,,,1,1,6.204779953,14334,7126,6830,296,1,295
17669,8799,10213,0,0,37958,,,,,,1,1,8.407832371,19188,9257,9001,256,0,256
17669,9404,11104,0,0,35760,,,,,,1,1,7.910873284,18576,8435,8121,314,1,313
17669,10639,9940,0,2,36622,,,,,,1,1,8.067372031,18986,8667,8365,302,3,299
17669,10209,10807,0,2,2763,,,,,,1,1,0.566131314,1157,728,578,150,0,150
17669,10703,9337,0,2,37143,,,,,,1,1,7.87677318,18911,8960,8648,312,9,303
17669,10919,9888,0,0,25868,,,,,,1,1,5.56758857,13458,6056,5758,298,2,296
17669,10534,9451,6,0,36118,,,,,,1,1,7.778681059,18786,8527,8249,278,1,277
17669,10591,10079,0,0,3412,,,,,,1,1,0.704335524,1617,828,689,139,0,139
17669,10913,9760,0,0,1628,,,,,,1,1,0.343272123,664,423,305,118,0,118
17669,11110,9847,2,0,16383,,,,,,1,1,3.4539195400000002,8299,3905,3631,274,0,274
17669,11127,9546,2,0,1112,,,,,,1,1,0.235676933,395,303,192,111,1,110
17669,10813,9862,0,0,6987,,,,,,1,1,1.420928704,3370,1705,1498,207,0,207
17669,10016,10626,5,2,35822,,,,,,1,1,7.805368614,18749,8389,8094,295,8,287
17669,10235,10520,0,0,28774,,,,,,1,1,6.23247928,14779,6858,6579,279,0,279
17669,10134,10446,0,0,36169,,,,,,1,1,7.920079304,18693,8599,8321,278,0,278
17669,10295,10375,4,0,5684,,,,,,1,1,1.158068229,2697,1392,1189,203,4,199
17669,10899,8981,0,2,37201,,,,,,1,1,8.299431442,18821,9051,8773,278,1,277
17669,10598,10381,2,2,4408,,,,,,1,1,0.899457549,2086,1079,915,164,1,163
17669,9963,10999,0,0,6340,,,,,,1,1,1.3257587929999999,3027,1564,1379,185,0,185
17669,11319,9249,0,2,35642,,,,,,1,1,7.545341853,18509,8418,8121,297,3,294
17669,10352,10436,0,0,2126,,,,,,1,1,0.437794715,918,530,382,148,1,147
17669,9436,9822,0,4,37516,,,,,,1,1,7.92593263,19275,8973,8678,295,4,291
17669,10853,9822,0,0,5436,,,,,,1,1,1.122448486,2651,1301,1118,183,0,183
17669,10349,10456,0,4,18685,,,,,,1,1,3.774316616,9610,4410,4155,255,1,254
17669,9183,11118,2,0,36821,,,,,,1,1,7.984488479,18989,8773,8487,286,4,282
17669,11159,9512,0,0,7087,,,,,,1,1,1.446491301,3352,1762,1551,211,0,211
17669,10261,10409,2,0,21312,,,,,,1,1,4.433601285,10959,5044,4779,265,0,265
17669,10930,9952,0,0,2535,,,,,,1,1,0.523234427,1137,625,477,148,0,148
17669,10982,10055,0,0,12190,,,,,,1,1,2.488866882,5920,2998,2724,274,2,272
17669,10082,10587,2,0,12166,,,,,,1,1,2.461657828,5953,2976,2715,261,0,261
17669,9106,11016,0,0,36936,,,,,,1,1,7.862438892,18977,8816,8489,327,1,326
17669,8687,10486,0,2,38040,,,,,,1,1,7.839616502,18996,9363,9045,318,3,315
17669,10212,10718,0,0,5995,,,,,,1,1,1.226235139,2846,1474,1273,201,0,201
17669,9768,10619,0,0,37756,,,,,,1,1,7.637661029,19168,9130,8802,328,3,325
17669,10576,9802,1,0,34926,,,,,,1,1,7.418378515,18253,8185,7882,303,0,303
17669,10262,10690,0,0,3192,,,,,,1,1,0.64866006,1505,773,632,141,0,141
17669,9700,11247,0,0,16165,,,,,,1,1,3.286905327,8125,3894,3642,252,1,251
17669,10828,10043,2,0,34825,,,,,,1,1,7.376363214,17764,8373,8058,315,3,312
17669,10788,9898,0,0,1809,,,,,,1,1,0.374543222,749,463,329,134,0,134
17669,10234,10314,0,0,35759,,,,,,1,1,7.337803604,18505,8465,8141,324,7,317
17669,8934,9722,0,0,38404,,,,,,1,1,7.98700889,19554,9280,8990,290,1,289
17669,9900,10264,2,0,35895,,,,,,1,1,7.236720872,18335,8628,8324,304,0,304
17669,10231,10486,2,0,2878,,,,,,1,1,0.599827218,1334,690,526,164,0,164
17669,9977,10933,0,2,19307,,,,,,1,1,3.9250605,9590,4723,4452,271,0,271
17669,9827,10915,0,0,5064,,,,,,1,1,1.026879088,2365,1246,1039,207,0,207
17669,10425,9983,2,2,37066,,,,,,1,1,7.676413722,19128,8819,8519,300,1,299
17669,11125,8668,2,2,36202,,,,,,1,1,7.386695121,18802,8548,8244,304,3,301
17669,10750,9919,0,2,18857,,,,,,1,1,3.899679668,9772,4412,4151,261,0,261
17669,10806,9863,0,3,35175,,,,,,1,1,7.178752862,18337,8252,7918,334,2,332
17669,11184,9824,0,0,2106,,,,,,1,1,0.431020278,951,513,384,129,1,128
17669,9858,10812,2,0,18628,,,,,,1,1,3.890379597,9344,4505,4231,274,11,263
17669,11012,9693,2,0,999,,,,,,1,1,0.213732112,377,258,152,106,1,105
17669,9656,11017,0,3,8837,,,,,,1,1,1.788859354,4295,2159,1935,224,1,223
17669,10272,10418,0,0,2762,,,,,,1,1,0.560456866,1197,704,547,157,0,157
17669,9503,11299,0,0,3023,,,,,,1,1,0.616956744,1348,757,596,161,1,160
17669,10633,10285,0,2,27872,,,,,,1,1,5.670417119,14075,6750,6453,297,7,290
17669,10061,10387,0,3,37975,,,,,,1,1,7.960379883,19264,9183,8838,345,3,342
17669,9694,10179,0,0,37782,,,,,,1,1,7.784998226,19294,9097,8803,294,2,292
17669,10393,10172,5,0,36994,,,,,,1,1,7.51071889,18799,8937,8616,321,0,321
17669,9650,11232,0,4,10854,,,,,,1,1,2.214051368,5447,2581,2336,245,6,239
17669,10008,10662,4,0,8332,,,,,,1,1,1.682784169,4262,1939,1747,192,0,192
17669,11286,8778,4,0,38206,,,,,,1,1,7.7370550940000005,19261,9305,8970,335,8,327
17669,9406,10325,0,0,34643,,,,,,1,1,7.124485276,18084,8139,7858,281,1,280
17669,10812,9583,2,0,36660,,,,,,1,1,7.529724607,18645,8857,8556,301,2,299
17669,9584,11085,0,0,8507,,,,,,1,1,1.711058961,3974,2137,1878,259,0,259
17669,10077,10618,0,0,2489,,,,,,1,1,0.51223497,1087,628,482,146,0,146
17669,10618,9900,2,4,36535,,,,,,1,1,7.707687204,18606,8814,8513,301,12,289
17669,9748,9048,0,4,35793,,,,,,1,1,7.336175183,18938,8294,8027,267,10,257
17669,10576,10204,0,0,2938,,,,,,1,1,0.632795428,1339,722,567,155,0,155
17669,10010,10326,0,0,37428,,,,,,1,1,7.578790443,18725,9203,8906,297,0,297
17669,10521,9685,0,0,36403,,,,,,1,1,7.587084229,18476,8814,8515,299,4,295
17669,10554,9409,2,2,38353,,,,,,1,1,7.979918319,19354,9345,9036,309,14,295
17669,10073,10090,0,0,36947,,,,,,1,1,7.632963753,18864,8880,8557,323,0,323
17669,9731,11022,1,4,29487,,,,,,1,1,6.051130346,15434,6867,6548,319,3,316
17669,9315,11389,0,4,4692,,,,,,1,1,0.970192813,2118,1193,1005,188,10,178
17669,10281,9578,0,0,35984,,,,,,1,1,7.312560757,18813,8438,8143,295,3,292
17669,10125,10901,0,5,34243,,,,,,1,1,7.1574345,17992,7977,7680,297,9,288
17669,9813,9728,2,0,34192,,,,,,1,1,7.017150496,18054,7942,7688,254,3,251
17669,10953,9724,0,4,2882,,,,,,1,1,0.585914017,1288,716,554,162,4,158
17669,9960,10091,4,2,36819,,,,,,1,1,7.512260698,18758,8870,8549,321,3,318
17669,10608,10067,2,0,12801,,,,,,1,1,2.6187381739999998,6559,3010,2788,222,1,221
17669,10358,8884,0,2,37107,,,,,,1,1,7.627057862,18908,8955,8666,289,2,287
17669,11219,9764,3,0,30838,,,,,,1,1,6.317440576,15563,7472,7141,331,2,329
17669,9274,10514,0,2,35919,,,,,,1,1,7.287755241,18474,8593,8334,259,2,257
17669,10361,10315,0,2,4299,,,,,,1,1,0.872293728,2027,1049,875,174,0,174
17669,10293,9605,0,2,37736,,,,,,1,1,7.670242528,19312,9060,8756,304,11,293
17669,9992,10713,0,0,1550,,,,,,1,1,0.323586937,624,401,277,124,0,124
17669,10068,10620,0,2,2800,,,,,,1,1,0.609457468,1301,684,553,131,0,131
17669,9501,11105,1,2,38545,,,,,,1,1,7.85670472,19499,9352,9010,342,1,341
17669,10289,10380,2,0,3968,,,,,,1,1,0.840055578,1860,976,820,156,1,155
17669,11159,9513,4,0,6645,,,,,,1,1,1.345564851,3107,1672,1478,194,4,190
17669,9898,9902,2,0,37967,,,,,,1,1,7.957595463,19101,9279,8971,308,2,306
17669,9572,10119,2,0,34703,,,,,,1,1,7.330660972,18214,8105,7826,279,1,278
17669,10774,9895,3,0,30494,,,,,,1,1,6.28149326,15748,7223,6923,300,1,299
17669,9282,10863,1,0,36958,,,,,,1,1,7.580049645,18961,8843,8532,311,1,310
17669,10106,10683,0,4,4556,,,,,,1,1,0.928951878,2183,1104,939,165,1,164
17669,10418,10233,2,2,36471,,,,,,1,1,7.781663622,18479,8843,8537,306,1,305
17669,9571,10612,2,0,37010,,,,,,1,1,7.800643302,18744,8977,8665,312,5,307
17669,11028,9646,6,2,19143,,,,,,1,1,3.932781899,9519,4687,4437,250,0,250
17669,9875,10795,0,0,19908,,,,,,1,1,4.020474016,9868,4884,4612,272,0,272
17669,10463,9184,0,2,37178,,,,,,1,1,7.700482288,18887,8986,8667,319,0,319
17669,9780,10578,1,0,36609,,,,,,1,1,7.6739931,18890,8710,8411,299,2,297
17669,9280,10307,0,4,38357,,,,,,1,1,7.744027859,19244,9417,9138,279,3,276
17669,10421,10251,2,0,10420,,,,,,1,1,2.112209304,5276,2461,2239,222,3,219
17669,8825,9915,2,4,38571,,,,,,1,1,7.832705411,19537,9353,9025,328,5,323
17669,9203,11482,0,4,3256,,,,,,1,1,0.660538425,1411,841,678,163,0,163
17669,10159,10618,2,0,2042,,,,,,1,1,0.420590292,904,501,365,136,2,134
17669,10567,9137,5,0,37650,,,,,,1,1,7.614131334,19162,9084,8764,320,15,305
17669,9225,11651,2,0,15382,,,,,,1,1,3.171147821,7565,3772,3499,273,7,266
17669,10901,9986,2,2,32107,,,,,,1,1,6.56663167,16608,7590,7271,319,6,313
17669,10772,9900,0,2,7228,,,,,,1,1,1.47716689,3480,1773,1571,202,1,201
17669,11037,9563,0,0,37369,,,,,,1,1,7.691248672,19085,8983,8665,318,0,318
17669,9328,11341,0,0,3328,,,,,,1,1,0.69587708,1524,819,653,166,0,166
17669,10461,10214,0,0,4316,,,,,,1,1,0.874922999,2011,1051,848,203,0,203
17669,9109,10993,2,4,35850,,,,,,1,1,7.379457414,18525,8515,8220,295,7,288
17669,9164,11507,0,0,2493,,,,,,1,1,0.516464583,1097,620,464,156,1,155
17669,9575,11208,0,0,2251,,,,,,1,1,0.463486531,970,568,423,145,0,145
17669,7665,10535,0,0,37107,,,,,,1,1,7.771348339,19416,8708,8433,275,3,272
17669,10744,9793,0,0,36355,,,,,,1,1,7.390296234,18706,8665,8346,319,0,319
17669,10084,9240,0,4,38833,,,,,,1,1,7.850238591,19352,9598,9313,285,6,279
17669,10372,10300,2,2,7539,,,,,,1,1,1.5729320709999999,3714,1801,1578,223,8,215
17669,10715,9479,0,2,36681,,,,,,1,1,7.5152312420000005,19092,8627,8292,335,6,329
17669,9259,10218,0,0,37679,,,,,,1,1,7.670462367,19441,8967,8663,304,3,301
17669,10354,10337,0,0,7489,,,,,,1,1,1.512710739,3668,1800,1579,221,0,221
17669,9656,11113,2,0,4669,,,,,,1,1,0.943553177,2146,1173,996,177,0,177
17669,9898,10825,0,0,1130,,,,,,1,1,0.23497234,429,298,193,105,0,105
17669,10862,10164,0,0,2856,,,,,,1,1,0.589385077,1295,702,545,157,0,157
17669,9918,9533,0,0,34348,,,,,,1,1,7.062707422,18172,7949,7671,278,2,276
17669,10530,9592,0,6,34642,,,,,,1,1,7.14390154,18371,7991,7702,289,3,286
17669,9081,9745,0,2,36075,,,,,,1,1,7.418123537,18435,8685,8415,270,1,269
17669,10218,10775,1,2,7092,,,,,,1,1,1.530498245,3454,1719,1519,200,2,198
17669,10575,9688,0,0,35549,,,,,,1,1,7.353371495,18440,8409,8118,291,2,289
17669,10795,9883,0,2,4742,,,,,,1,1,1.152129752,2264,1148,966,182,0,182
17669,9444,10991,5,0,34626,,,,,,1,1,7.211368957,18485,7928,7643,285,2,283
17669,9040,11463,0,0,35019,,,,,,1,1,7.271165902,18480,8122,7827,295,8,287
17669,10062,10624,2,0,4828,,,,,,1,1,0.993002781,2243,1193,994,199,0,199
17669,10121,10548,2,0,33490,,,,,,1,1,7.343360031,17049,8062,7745,317,0,317
17669,10931,9848,0,0,5130,,,,,,1,1,1.148049001,2340,1309,1137,172,0,172
17669,9201,8844,2,0,36836,,,,,,1,1,7.693976969,19134,8731,8491,240,4,236
17669,10609,10069,0,0,1516,,,,,,1,1,0.329119849,587,396,259,137,0,137
17669,10852,9485,4,0,36106,,,,,,1,1,7.650737722,18635,8581,8272,309,3,306
17669,9944,8774,0,0,36681,,,,,,1,1,7.726314823,18875,8755,8459,296,5,291
17669,9277,10223,2,2,36965,,,,,,1,1,7.865536736,18751,8959,8663,296,0,296
17669,10290,10393,0,0,5237,,,,,,1,1,1.114382286,2523,1271,1099,172,0,172
17669,9258,9858,0,2,35997,,,,,,1,1,7.8178183820000005,18240,8728,8427,301,0,301
17669,8607,9613,1,2,37853,,,,,,1,1,8.0395132,19494,9039,8758,281,3,278
17669,9320,9425,2,0,34774,,,,,,1,1,7.509320149,18378,8064,7796,268,3,265
17669,10800,10041,4,0,9644,,,,,,1,1,2.008170025,4736,2352,2148,204,4,200
17669,11513,9443,0,0,4937,,,,,,1,1,1.007526503,2372,1195,1020,175,0,175
17669,10621,10055,2,0,6425,,,,,,1,1,1.334584857,2972,1615,1392,223,0,223
17669,10490,10193,0,0,1163,,,,,,1,1,0.251582849,494,281,174,107,1,106
17669,8398,10527,0,0,36752,,,,,,1,1,7.85054876,19125,8670,8383,287,2,285
17669,9916,10729,0,2,35825,,,,,,1,1,7.752325022,18643,8448,8162,286,3,283
17669,10588,9139,0,2,36014,,,,,,1,1,8.060941377,18321,8696,8395,301,10,291
17669,9421,10205,2,0,36720,,,,,,1,1,7.700780209,18958,8727,8419,308,3,305
17669,10853,9828,1,2,2196,,,,,,1,1,0.450463094,989,535,398,137,1,136
17669,9772,9768,2,0,35952,,,,,,1,1,7.9027749069999995,18864,8406,8130,276,2,274
17669,9765,10766,2,1,37544,,,,,,1,1,7.904747958,19052,9093,8787,306,6,300
17669,10322,10371,0,0,1649,,,,,,1,1,0.340077248,656,438,321,117,0,117
17669,10395,10275,0,0,2134,,,,,,1,1,0.436022739,926,532,388,144,0,144
17669,10139,9310,0,0,36118,,,,,,1,1,7.786525568,18713,8558,8269,289,4,285
17669,10885,9478,0,0,37993,,,,,,1,1,8.243150782,18902,9391,9082,309,3,306
17669,11106,9916,4,0,7261,,,,,,1,1,1.4608863429999999,3401,1825,1615,210,3,207
17669,9268,8487,0,0,36919,,,,,,1,1,8.672122625,18998,8817,8530,287,3,284
17669,10779,10176,0,0,2668,,,,,,1,1,0.545692077,1133,688,529,159,0,159
17669,10300,9739,0,0,37026,,,,,,1,1,7.768804392,19004,8854,8540,314,1,313
17669,9344,8593,0,0,37010,,,,,,1,1,7.684488326,19219,8767,8510,257,3,254
17669,8791,9914,0,2,37501,,,,,,1,1,8.054649195,19191,9018,8744,274,3,271
17669,9501,8826,2,0,35311,,,,,,1,1,7.2798402190000004,18734,8141,7846,295,1,294
17669,10632,9032,4,0,35882,,,,,,1,1,7.468559393,18595,8490,8183,307,7,300
17669,10553,10467,0,0,15671,,,,,,1,1,2.985075948,7781,3811,3543,268,1,267
17669,9770,9921,2,0,37680,,,,,,1,1,8.036718037,19034,9172,8870,302,6,296
17669,10999,9651,4,0,35855,,,,,,1,1,7.379594767,18176,8692,8397,295,5,290
17669,10050,8167,2,0,36704,,,,,,1,1,7.45058798,18935,8766,8529,237,7,230
17669,10259,10726,0,0,8810,,,,,,1,1,1.783187038,4298,2162,1974,188,0,188
17669,10160,8955,2,0,36745,,,,,,1,1,7.561420347,18738,8862,8579,283,3,280
17669,10037,10265,2,2,35830,,,,,,1,1,6.976998759,18763,8386,8091,295,1,294
17669,10844,10076,1,0,17874,,,,,,1,1,3.196117794,8937,4335,4068,267,3,264
17669,10137,9631,0,0,35128,,,,,,1,1,7.202967446,18262,8296,8022,274,0,274
17669,11031,8703,0,0,34005,,,,,,1,1,5.5830269359999996,17905,7917,7651,266,1,265
17669,10522,9286,0,0,37244,,,,,,1,1,5.975579398,19186,8884,8594,290,1,289
17669,11081,9198,4,0,36371,,,,,,1,1,5.931540347,18813,8615,8287,328,2,326
17669,9873,10546,1,2,34160,,,,,,1,1,5.480239036,18007,7951,7700,251,2,249
17669,8640,10402,0,2,36827,,,,,,1,1,5.537586331,18900,8837,8584,253,3,250
17669,10591,10064,0,2,36094,,,,,,1,1,5.474351358,18680,8554,8248,306,1,305
17669,10080,10268,0,0,36492,,,,,,1,1,5.762345829,18973,8595,8266,329,2,327
