key_bits,recovered_zeros_x,recovered_zeros_y,wrong_zeros_x,wrong_zeros_y,queries,traces,calibration_traces,threshold,tpr,tnr,attack_tpr,attack_tnr,duration_seconds,test_outcomes_0_false,test_outcomes_0_true,test_outcomes_1_false,test_outcomes_1_true,test_outcomes_2_false,test_outcomes_2_true
17669,11022,9888,0,0,33341,,,,,,1,1,6.802515537,17897,7564,7248,316,2,314
17669,10053,11440,2,0,33578,,,,,,1,1,6.85135747,17208,8036,7738,298,1,297
17669,10848,11286,0,0,34304,,,,,,1,1,7.026891,17591,8190,7857,333,2,331
17669,11859,9603,2,0,35261,,,,,,1,1,7.107703504,17951,8504,8202,302,2,300
17669,11742,10467,0,2,35191,,,,,,1,1,7.117741202,18008,8441,8140,301,2,299
17669,10701,10785,0,2,34947,,,,,,1,1,7.118661015,18390,8126,7821,305,1,304
17669,9853,11346,2,2,34886,,,,,,1,1,7.180281845,18279,8118,7747,371,17,354
17669,10061,12227,2,2,34427,,,,,,1,1,7.229739416,17940,8090,7783,307,2,305
17669,11156,9635,0,2,35632,,,,,,1,1,7.270693522,18118,8603,8295,308,2,306
17669,10516,10759,2,0,36129,,,,,,1,1,7.318788354,18575,8612,8282,330,2,328
17669,10611,9278,2,0,35315,,,,,,1,1,7.378902153,18625,8204,7922,282,4,278
17669,10896,9351,1,1,35443,,,,,,1,1,7.4534058309999995,18631,8267,7989,278,1,277
17669,10902,10424,4,0,36259,,,,,,1,1,7.512690389,18595,8676,8364,312,6,306
17669,11142,10261,2,0,36651,,,,,,1,1,7.553970177,18945,8700,8394,306,1,305
17669,9812,9487,0,2,36495,,,,,,1,1,7.563697951,18649,8785,8509,276,2,274
17669,11397,9582,0,2,37486,,,,,,1,1,7.571829494,18927,9128,8825,303,2,301
17669,11500,10477,2,0,36100,,,,,,1,1,7.615771629,18531,8618,8285,333,1,332
17669,9514,10878,2,0,36228,,,,,,1,1,7.634221243,18261,8841,8556,285,6,279
17669,10446,9804,2,0,37283,,,,,,1,1,7.726262852,19089,8942,8632,310,4,306
17669,11338,11019,2,2,37221,,,,,,1,1,7.772614462,18932,8963,8600,363,4,359
17669,11337,8526,2,1,37403,,,,,,1,1,7.776610036,18936,9092,8809,283,2,281
17669,10378,9698,0,0,36868,,,,,,1,1,7.784640227,19079,8741,8434,307,0,307
17669,10199,9012,2,0,37722,,,,,,1,1,8.001587118,19465,8986,8701,285,1,284
17669,10588,9348,4,2,38551,,,,,,1,1,8.420463954,19547,9343,9025,318,5,313
17669,11965,10908,2,0,33190,,,,,,1,1,6.900355222,17605,7644,7347,297,4,293
17669,10798,10644,2,0,35905,,,,,,1,1,7.326653759,18438,8578,8267,311,4,307
17669,10869,9971,0,0,31977,,,,,,1,1,6.723712647,16998,7351,7074,277,1,276
17669,10459,9714,0,0,35253,,,,,,1,1,7.192882786,18142,8410,8119,291,1,290
17669,10003,11079,0,0,35513,,,,,,1,1,7.264708305,18446,8374,8055,319,1,318
17669,9981,11955,0,0,35675,,,,,,1,1,7.4927645,18098,8630,8313,317,3,314
17669,11049,10704,0,1,35708,,,,,,1,1,7.455211512,18478,8451,8123,328,5,323
17669,10899,11023,2,2,34536,,,,,,1,1,7.267565804,18183,8016,7695,321,1,320
17669,9415,11981,0,6,34050,,,,,,1,1,7.233710468,17877,7945,7662,283,3,280
17669,9380,9052,0,0,38900,,,,,,1,1,7.900116625,19572,9508,9196,312,1,311
17669,10341,8234,0,0,36789,,,,,,1,1,7.565289308,18950,8788,8525,263,2,261
17669,10485,11156,0,0,35304,,,,,,1,1,7.30935317,18286,8354,8044,310,1,309
17669,11393,10831,2,0,33362,,,,,,1,1,7.191882871,17427,7830,7555,275,0,275
17669,10377,10543,0,0,36314,,,,,,1,1,7.4364515319999995,18750,8619,8293,326,4,322
17669,10096,10070,0,2,36985,,,,,,1,1,7.556464517,18966,8864,8573,291,3,288
17669,10475,10664,0,0,36747,,,,,,1,1,7.512588512,18709,8846,8500,346,2,344
17669,10826,10280,0,3,36174,,,,,,1,1,7.382725942,18545,8651,8324,327,2,325
17669,10565,9329,4,0,36038,,,,,,1,1,7.468152529,18488,8628,8334,294,4,290
17669,8651,9773,0,0,37528,,,,,,1,1,7.975755187,19368,8936,8648,288,0,288
17669,10820,10876,0,0,37579,,,,,,1,1,7.633605509,19038,9101,8762,339,3,336
17669,10407,9901,0,0,36550,,,,,,1,1,7.499618543,18883,8688,8397,291,1,290
17669,10490,9100,0,0,36134,,,,,,1,1,7.484703896,18444,8696,8398,298,3,295
17669,9666,11616,2,0,37902,,,,,,1,1,7.889308515,18983,9278,8915,363,5,358
17669,9878,10271,0,0,36224,,,,,,1,1,7.423506012,18759,8587,8296,291,2,289
17669,11499,11340,3,4,33916,,,,,,1,1,6.922893962,17575,7999,7656,343,8,335
17669,11172,8575,3,0,36234,,,,,,1,1,7.398916712,18796,8583,8311,272,4,268
17669,11457,11187,0,2,33603,,,,,,1,1,6.91706855,17254,8012,7687,325,7,318
17669,9106,11016,0,0,36954,,,,,,1,1,7.444206606,18977,8822,8489,333,1,332
17669,10379,10400,2,0,32019,,,,,,1,1,6.554861736,16990,7393,7150,243,1,242
17669,10737,10401,0,0,37442,,,,,,1,1,7.532085068,18723,9197,8872,325,0,325
17669,9504,10335,0,0,35936,,,,,,1,1,7.335984094,18896,8374,8082,292,1,291
17669,9068,10875,0,3,35370,,,,,,1,1,7.304958346,18598,8237,7939,298,7,291
17669,10592,9509,2,0,36477,,,,,,1,1,7.416157359,18726,8711,8382,329,6,323
17669,10130,10455,2,2,37313,,,,,,1,1,7.616246627,19308,8851,8548,303,2,301
17669,10462,10129,4,2,37096,,,,,,1,1,7.494752192,18740,9020,8704,316,4,312
17669,10324,10933,1,2,36970,,,,,,1,1,7.474758086,18985,8825,8490,335,3,332
17669,10713,9239,0,0,35881,,,,,,1,1,7.286485761,18710,8441,8152,289,4,285
17669,11656,11235,1,0,36417,,,,,,1,1,7.439998167,18568,8757,8422,335,1,334
17669,11286,8778,4,0,37936,,,,,,1,1,7.620225331,19145,9237,8920,317,6,311
17669,8873,9408,1,2,37388,,,,,,1,1,7.622635775,19257,8934,8671,263,1,262
17669,12215,10297,1,0,35888,,,,,,1,1,7.37501675,18508,8530,8210,320,2,318
17669,10236,10833,0,2,36085,,,,,,1,1,7.529238647,18721,8518,8190,328,7,321
17669,11495,9126,3,2,35521,,,,,,1,1,7.357217025,18267,8477,8177,300,2,298
17669,10454,9687,4,1,38624,,,,,,1,1,7.914951263,19771,9238,8861,377,20,357
17669,10412,9028,4,2,37583,,,,,,1,1,7.758460746,19240,9023,8726,297,2,295
17669,8550,9701,0,2,36545,,,,,,1,1,7.493179419,19227,8520,8242,278,6,272
17669,11025,11342,2,4,35534,,,,,,1,1,7.247203048,18299,8458,8139,319,0,319
17669,11008,10070,0,2,38880,,,,,,1,1,7.940966222,19301,9607,9242,365,4,361
17669,11969,11381,3,0,35161,,,,,,1,1,7.482360839,18277,8260,7896,364,4,360
17669,10608,12107,2,2,33448,,,,,,1,1,7.173566732,17435,7824,7459,365,13,352
17669,9667,11666,2,3,34801,,,,,,1,1,7.374080326,18270,8107,7790,317,8,309
17669,10046,10958,0,0,34904,,,,,,1,1,7.873327666,18333,8146,7867,279,2,277
17669,10796,9748,0,2,37233,,,,,,1,1,7.868021563,18767,9068,8738,330,2,328
17669,10796,11392,2,0,36274,,,,,,1,1,7.713559075,18518,8721,8407,314,3,311
17669,10010,10326,0,0,37461,,,,,,1,1,7.866243498,18725,9214,8906,308,0,308
17669,9329,10272,2,0,36958,,,,,,1,1,7.787832358,19181,8738,8437,301,2,299
17669,9251,8511,3,0,38444,,,,,,1,1,8.350364241,19662,9264,9010,254,1,253
17669,10514,10369,0,2,38153,,,,,,1,1,8.187465905,19412,9213,8898,315,1,314
17669,10653,9786,2,0,37813,,,,,,1,1,8.451946281,18981,9257,8939,318,7,311
17669,9517,11718,0,0,37822,,,,,,1,1,8.1558966,18895,9307,8994,313,2,311
17669,10011,10511,0,0,36994,,,,,,1,1,8.040610711,18809,8940,8635,305,1,304
17669,10918,11856,5,2,36957,,,,,,1,1,8.125663923,18367,9088,8674,414,9,405
17669,9282,10863,1,0,36959,,,,,,1,1,8.129761619,18945,8848,8530,318,1,317
17669,7964,10771,0,0,37134,,,,,,1,1,7.783588248,19094,8881,8603,278,3,275
17669,9136,9123,2,1,38555,,,,,,1,1,8.148974774,19599,9323,9013,310,4,306
17669,10566,9857,2,0,35415,,,,,,1,1,7.6767340950000005,18363,8391,8121,270,2,268
17669,10374,10100,0,1,36964,,,,,,1,1,8.032831782,18971,8844,8539,305,2,303
17669,11160,9551,3,0,35297,,,,,,1,1,8.054914496,18570,8214,7915,299,5,294
17669,9894,10428,0,0,36922,,,,,,1,1,8.347934355,18496,9063,8763,300,3,297
17669,9851,10557,2,0,35327,,,,,,1,1,7.979374435,18354,8343,8056,287,0,287
17669,9969,10162,4,5,37708,,,,,,1,1,8.087004558,19338,9021,8693,328,13,315
17669,10020,9149,2,0,37750,,,,,,1,1,8.178156935,19165,9153,8874,279,3,276
17669,11081,9198,4,0,36417,,,,,,1,1,7.684391761,18807,8633,8289,344,2,342
17669,9489,11382,0,0,34085,,,,,,1,1,7.032059998,17940,7924,7627,297,2,295
17669,10194,11811,0,2,34642,,,,,,1,1,7.428775546,18207,8062,7751,311,6,305
17669,11215,8866,2,0,36500,,,,,,1,1,7.464318805,18604,8805,8519,286,2,284
17669,8617,10954,0,0,36557,,,,,,1,1,7.753415989,18852,8700,8395,305,0,305
17669,11571,10816,6,3,32013,,,,,,1,1,6.593260801,17381,7176,6896,280,3,277
17669,10090,10447,0,0,37603,,,,,,1,1,7.599746422,18918,9192,8891,301,4,297
17669,10905,10413,2,0,36017,,,,,,1,1,7.709404392,18378,8655,8326,329,2,327
17669,12074,11958,2,2,32511,,,,,,1,1,6.777890134,17258,7465,7142,323,2,321
17669,8825,9915,2,4,38291,,,,,,1,1,8.000907839,19458,9274,8989,285,5,280
17669,10586,11291,0,4,35838,,,,,,1,1,7.454225154,18312,8602,8280,322,4,318
17669,9633,10889,2,0,34610,,,,,,1,1,7.269132423,18117,8101,7810,291,7,284
17669,11498,9826,2,0,36238,,,,,,1,1,7.464032299,18486,8716,8396,320,2,318
17669,11364,11093,2,3,36698,,,,,,1,1,7.565455407,18560,8892,8538,354,4,350
17669,9444,10991,5,0,34633,,,,,,1,1,7.253059631,18500,7926,7645,281,2,279
17669,11049,11201,2,0,33770,,,,,,1,1,7.1353180290000005,17824,7820,7514,306,2,304
17669,11410,10390,0,0,36826,,,,,,1,1,7.5399228449999995,18802,8846,8514,332,0,332
17669,9758,10627,0,2,35342,,,,,,1,1,7.296333687,18382,8336,8048,288,3,285
17669,10042,12784,2,0,33042,,,,,,1,1,7.164039754,17485,7617,7294,323,0,323
17669,10916,11040,5,0,35189,,,,,,1,1,7.286579593,18176,8342,8013,329,0,329
17669,10017,10096,0,4,38490,,,,,,1,1,7.87484674,19690,9245,8935,310,0,310
17669,10733,10136,3,0,36947,,,,,,1,1,7.638161248,19010,8806,8481,325,5,320
17669,10680,9779,2,0,36129,,,,,,1,1,7.621373127,18382,8725,8428,297,1,296
17669,9925,11312,0,1,36140,,,,,,1,1,7.588857488,18458,8671,8331,340,1,339
17669,10205,11107,2,4,35086,,,,,,1,1,7.169849104,17912,8432,8122,310,7,303
17669,11398,11997,0,0,34506,,,,,,1,1,7.275623072,17913,8135,7812,323,1,322
17669,10591,10064,0,2,36100,,,,,,1,1,8.148111614,18680,8556,8248,308,1,307
17669,11354,10366,2,0,35354,,,,,,1,1,7.168393933,18137,8448,8127,321,3,318
17669,11083,9956,0,2,35680,,,,,,1,1,7.473625289,18578,8383,8047,336,0,336
17669,10347,8033,0,0,38116,,,,,,1,1,7.8253246050000005,19554,9147,8879,268,5,263
17669,10338,11480,2,0,35390,,,,,,1,1,7.431671161,18267,8381,8020,361,0,361
17669,10053,12397,4,2,34245,,,,,,1,1,7.32420428,17890,8014,7687,327,17,310
17669,10991,11895,0,4,33722,,,,,,1,1,7.06591231,17579,7913,7596,317,1,316
17669,11473,12228,2,4,34596,,,,,,1,1,7.238955944,17856,8194,7842,352,11,341
17669,10342,9789,3,0,36913,,,,,,1,1,7.66169254,18919,8843,8535,308,4,304
17669,11090,10446,0,2,36662,,,,,,1,1,7.563529346,18811,8754,8411,343,5,338
17669,10001,10400,2,0,37176,,,,,,1,1,7.6937314,18860,9016,8732,284,0,284
17669,10581,10804,2,2,35646,,,,,,1,1,7.428453925,18510,8410,8094,316,13,303
17669,10394,11395,0,0,34779,,,,,,1,1,7.287090038,18415,8042,7762,280,1,279
17669,10063,11333,1,0,36924,,,,,,1,1,7.661896902,18840,8870,8526,344,1,343
17669,8980,9279,2,2,38448,,,,,,1,1,7.901589635,19088,9530,9230,300,8,292
17669,11809,11276,0,2,34270,,,,,,1,1,6.987545199,17989,7980,7659,321,0,321
17669,9328,10015,0,1,36259,,,,,,1,1,7.61464738,18796,8588,8301,287,2,285
17669,9770,9921,2,0,37682,,,,,,1,1,8.026316803,19035,9173,8872,301,3,298
17669,10586,9600,0,0,35539,,,,,,1,1,7.447094191,18694,8260,7935,325,3,322
17669,10569,10610,0,0,37083,,,,,,1,1,7.761308059,18982,8892,8575,317,2,315
17669,8881,10197,0,0,39478,,,,,,1,1,8.100783938,19972,9602,9300,302,0,302
17669,7595,9782,0,1,39116,,,,,,1,1,8.37750303,19842,9496,9214,282,2,280
17669,8734,11909,0,2,35770,,,,,,1,1,7.343539825,18488,8490,8188,302,1,301
17669,11986,11379,0,0,35014,,,,,,1,1,7.199639771,18330,8163,7805,358,4,354
17669,10636,10744,1,4,37037,,,,,,1,1,7.650461312,18627,9045,8725,320,17,303
17669,10448,9439,0,0,35514,,,,,,1,1,7.22567025,18427,8406,8131,275,0,275
17669,9953,9421,0,0,36134,,,,,,1,1,7.514132395,18809,8525,8250,275,2,273
17669,9856,11465,0,1,34778,,,,,,1,1,7.07903715,18280,8090,7772,318,1,317
17669,10967,8778,0,0,36888,,,,,,1,1,7.424648361,18986,8792,8474,318,1,317
17669,10887,10116,1,0,37370,,,,,,1,1,7.736449648,19026,9015,8701,314,3,311
17669,10574,11205,2,0,35019,,,,,,1,1,7.148283593,18321,8187,7863,324,4,320
17669,10970,10100,4,2,36494,,,,,,1,1,7.45938283,18448,8864,8546,318,4,314
17669,10078,9989,0,0,35189,,,,,,1,1,7.146107732,18451,8218,7916,302,1,301
17669,8607,9613,1,2,37862,,,,,,1,1,7.7012148,19526,9033,8763,270,3,267
17669,9258,11466,0,2,36213,,,,,,1,1,7.331498697,18441,8738,8442,296,6,290
17669,10826,10937,1,0,35600,,,,,,1,1,7.195650674,18767,8239,7884,355,2,353
17669,9070,9613,1,0,36196,,,,,,1,1,7.35577316,18926,8488,8194,294,3,291
17669,10716,9284,0,0,35878,,,,,,1,1,7.470026324,18643,8469,8172,297,3,294
17669,10826,9781,2,0,37590,,,,,,1,1,7.793993887,19028,9119,8795,324,2,322
17669,10258,10613,0,0,37759,,,,,,1,1,7.7690783549999995,19061,9166,8800,366,1,365
17669,12825,10920,7,0,36326,,,,,,1,1,7.552257647,18362,8798,8430,368,8,360
17669,10162,8765,2,0,35345,,,,,,1,1,7.192266166,18275,8389,8097,292,1,291
17669,10601,10893,0,0,37120,,,,,,1,1,7.662004248,19029,8894,8591,303,2,301
17669,11075,9741,0,2,34767,,,,,,1,1,7.019639168,18285,8099,7815,284,4,280
17669,10431,11336,0,4,36404,,,,,,1,1,7.47349358,18560,8760,8436,324,12,312
17669,11471,10134,5,0,36839,,,,,,1,1,7.608247946,18445,9029,8693,336,4,332
17669,11430,12725,2,5,34011,,,,,,1,1,6.945380666,17360,8147,7790,357,1,356
17669,9619,9271,2,2,35737,,,,,,1,1,7.249337744,18682,8381,8088,293,14,279
17669,9706,10698,2,0,36668,,,,,,1,1,7.40224583,18698,8818,8484,334,9,325
17669,10629,10716,7,0,36370,,,,,,1,1,7.3844795340000005,18688,8669,8325,344,6,338
17669,9557,10624,3,1,36668,,,,,,1,1,7.430254946,18742,8797,8465,332,12,320
17669,10573,11548,0,2,38664,,,,,,1,1,7.970212773,19543,9375,9004,371,4,367
17669,9104,9819,0,2,37150,,,,,,1,1,7.580525555,18907,8982,8703,279,1,278
17669,8640,10402,0,2,37042,,,,,,1,1,7.692031621,18998,8891,8629,262,3,259
17669,10030,11147,0,2,39083,,,,,,1,1,7.999431656,19456,9627,9254,373,6,367
17669,10797,10597,0,4,36147,,,,,,1,1,7.33124461,18248,8767,8402,365,5,360
17669,11147,11267,0,0,37232,,,,,,1,1,7.579185675,18731,9079,8736,343,1,342
17669,10139,9310,0,0,36112,,,,,,1,1,7.563051113,18713,8556,8269,287,4,283
17669,10085,11023,2,2,34751,,,,,,1,1,7.16206937,18244,8090,7763,327,3,324
17669,8957,10269,0,0,36402,,,,,,1,1,7.575240851,18870,8623,8337,286,2,284
17669,9961,11494,2,0,33618,,,,,,1,1,7.060231587,17320,7998,7696,302,1,301
17669,10107,10496,2,0,34494,,,,,,1,1,7.112632398,18033,8088,7803,285,3,282
17669,8487,9844,0,3,38486,,,,,,1,1,7.811496345,19504,9354,9080,274,3,271
17669,9873,10546,1,2,34209,,,,,,1,1,7.025307265,18011,7968,7706,262,1,261
17669,8813,10486,0,4,36922,,,,,,1,1,7.50767747,18954,8845,8567,278,8,270
17669,9137,10221,3,0,36305,,,,,,1,1,7.507930023,18672,8678,8401,277,4,273
17669,10386,10814,0,0,34233,,,,,,1,1,6.960519312,17873,8034,7742,292,3,289
17669,10848,10514,0,0,36680,,,,,,1,1,7.425222892,19000,8683,8369,314,2,312
17669,8118,11337,0,3,39036,,,,,,1,1,8.178001853,19384,9667,9349,318,8,310
17669,11190,10581,0,0,35573,,,,,,1,1,7.203872772,18581,8329,7995,334,3,331
17669,9717,9993,0,2,35325,,,,,,1,1,7.1918767,18383,8338,8072,266,2,264
17669,9660,10907,0,0,35670,,,,,,1,1,7.420226196,18450,8468,8184,284,0,284
17669,10475,11145,0,2,35968,,,,,,1,1,7.31314094,18594,8507,8147,360,4,356
17669,10689,8501,2,0,35900,,,,,,1,1,7.399300356,18771,8429,8158,271,2,269
17669,10589,10685,0,2,36384,,,,,,1,1,7.38801507,18789,8637,8316,321,4,317
17669,10571,10997,0,3,35564,,,,,,1,1,7.208553718,18390,8406,8044,362,12,350
17669,10422,10382,2,0,36025,,,,,,1,1,7.27338591,18638,8538,8227,311,2,309
17669,10149,10297,0,0,37631,,,,,,1,1,7.660900328,19116,9101,8788,313,5,308
17669,10229,9893,2,0,35306,,,,,,1,1,7.327643268,18413,8290,7977,313,2,311
17669,11913,8473,0,0,35547,,,,,,1,1,7.315089215,18234,8503,8196,307,2,305
17669,12021,10527,0,2,37672,,,,,,1,1,7.583738196,18800,9263,8917,346,0,346
17669,10892,12425,6,2,36135,,,,,,1,1,7.298382644,18144,8808,8433,375,8,367
17669,10196,10619,0,2,34132,,,,,,1,1,7.014134948,17988,7926,7634,292,3,289
17669,10204,11516,0,0,34777,,,,,,1,1,7.316237269,17977,8227,7881,346,6,340
17669,9277,10223,2,2,37029,,,,,,1,1,7.697173537,18777,8975,8673,302,0,302
17669,11429,8548,3,0,36818,,,,,,1,1,7.596274777,18876,8818,8512,306,2,304
17669,9433,10467,0,0,35602,,,,,,1,1,7.395899747,18308,8508,8230,278,2,276
17669,7844,10127,0,2,37717,,,,,,1,1,7.768073863,19272,9086,8813,273,1,272
17669,11109,10922,0,4,36821,,,,,,1,1,7.580982496,18573,8967,8653,314,1,313
17669,11573,8990,0,1,37142,,,,,,1,1,7.459200538,18809,9005,8682,323,2,321
17669,8993,10510,0,3,38784,,,,,,1,1,7.981572623,19510,9490,9196,294,1,293
17669,10872,10859,0,0,38025,,,,,,1,1,7.754624217,19324,9176,8827,349,0,349
17669,10926,11310,0,4,37327,,,,,,1,1,7.854994878,18916,9029,8676,353,5,348
17669,8569,10498,0,1,38493,,,,,,1,1,7.75420091,19512,9329,9006,323,8,315
17669,11854,12323,0,2,6179,,,,,,1,1,1.302105133,2923,1504,1256,248,0,248
17669,9609,11629,2,0,32691,,,,,,1,1,6.847635526,17498,7443,7136,307,1,306
17669,11050,9175,1,0,34992,,,,,,1,1,7.136772549,18364,8184,7924,260,3,257
17669,10259,10149,3,2,35161,,,,,,1,1,7.249735494,18374,8269,8020,249,2,247
17669,10746,10684,0,2,34785,,,,,,1,1,7.204130887,18025,8227,7921,306,2,304
17669,10814,10015,0,2,36179,,,,,,1,1,7.346929932,18445,8712,8402,310,2,308
17669,9906,9229,0,4,36027,,,,,,1,1,7.308134578,18765,8491,8211,280,2,278
17669,10383,11610,0,0,33560,,,,,,1,1,6.994980834,17747,7758,7461,297,0,297
17669,10013,10479,0,2,35413,,,,,,1,1,7.202110846,18298,8404,8097,307,4,303
17669,9916,10097,0,2,35460,,,,,,1,1,7.325121501,18410,8375,8075,300,1,299
17669,9548,10312,0,0,35444,,,,,,1,1,7.386004789,18558,8300,8014,286,3,283
17669,10683,9508,0,2,35917,,,,,,1,1,7.303117198,18747,8430,8120,310,0,310
17669,11022,11960,0,2,33057,,,,,,1,1,6.784498235,17280,7745,7458,287,0,287
17669,9877,10511,0,0,36359,,,,,,1,1,7.428866999,18866,8609,8334,275,1,274
17669,10299,11469,2,2,35230,,,,,,1,1,7.167208285,18224,8334,7996,338,5,333
17669,11305,10271,0,1,36438,,,,,,1,1,7.484637557,18900,8600,8262,338,0,338
17669,10628,10177,0,0,34764,,,,,,1,1,7.157855417,18196,8130,7822,308,0,308
17669,9743,11494,2,0,35953,,,,,,1,1,7.529687997,18491,8569,8245,324,5,319
17669,10416,10307,3,0,35965,,,,,,1,1,7.596331614,18133,8765,8463,302,4,298
17669,9992,11027,0,4,36201,,,,,,1,1,7.5537608469999995,18365,8739,8381,358,2,356
17669,10549,9468,2,4,36453,,,,,,1,1,7.400121321,18938,8605,8300,305,3,302
17669,11928,10346,0,0,35652,,,,,,1,1,7.299220532,18322,8490,8140,350,2,348
17669,10271,8485,0,0,38454,,,,,,1,1,7.880269713,19271,9453,9176,277,3,274
17669,9947,9229,0,0,38469,,,,,,1,1,7.755129448,19207,9487,9199,288,2,286
17669,9485,9459,2,0,37187,,,,,,1,1,7.618569196,18907,9015,8765,250,2,248
17669,11626,12587,2,3,30622,,,,,,1,1,6.356597164,15426,7426,7082,344,1,343
17669,10382,10026,0,0,37169,,,,,,1,1,7.602595912,18866,8998,8691,307,2,305
17669,10152,9606,2,1,36985,,,,,,1,1,7.7246633110000005,18892,8898,8601,297,1,296
17669,10332,10332,4,4,37519,,,,,,1,1,7.6899333930000005,19238,8995,8704,291,1,290
17669,10920,8913,0,0,36761,,,,,,1,1,7.536248597,18877,8790,8486,304,5,299
17669,10521,10477,1,0,35018,,,,,,1,1,7.353878155,18407,8156,7857,299,1,298
17669,10434,10684,0,4,35206,,,,,,1,1,7.127791991,18005,8432,8095,337,22,315
17669,9335,8955,0,0,36295,,,,,,1,1,7.656892967,18474,8781,8522,259,0,259
17669,10281,10371,4,2,35721,,,,,,1,1,7.388267549,18643,8391,8095,296,8,288
17669,9207,10964,0,2,35346,,,,,,1,1,7.344622367,18298,8367,8053,314,3,311
17669,12050,11520,2,0,37083,,,,,,1,1,7.572884171,18940,8887,8518,369,3,366
17669,10617,10554,2,0,34775,,,,,,1,1,7.071495866,18206,8132,7827,305,4,301
17669,10736,11165,0,0,33696,,,,,,1,1,7.139852996,17779,7814,7525,289,1,288
17669,10406,10687,2,3,36105,,,,,,1,1,7.303220166,18416,8687,8372,315,7,308
17669,10300,9739,0,0,37062,,,,,,1,1,7.457784374,19004,8866,8540,326,1,325
17669,10338,10408,1,1,36336,,,,,,1,1,7.578567838,18545,8744,8441,303,3,300
17669,10548,10857,0,0,37929,,,,,,1,1,7.809793691,19319,9128,8774,354,1,353
17669,11511,9656,0,4,33645,,,,,,1,1,6.990130274,17688,7846,7581,265,4,261
17669,12200,10531,4,3,34527,,,,,,1,1,7.178915833,17748,8222,7887,335,6,329
17669,9333,11033,0,2,37284,,,,,,1,1,7.632969006,18959,8991,8648,343,3,340
17669,9812,10591,0,0,35696,,,,,,1,1,7.580782946,18791,8305,8010,295,2,293
17669,11101,10576,0,0,35423,,,,,,1,1,7.208428578,18162,8462,8125,337,3,334
17669,10880,10394,0,0,37524,,,,,,1,1,7.597369602,19202,8989,8645,344,0,344
17669,10738,9025,4,0,34879,,,,,,1,1,7.180727255,18461,8061,7765,296,6,290
17669,11192,9441,0,2,35755,,,,,,1,1,7.295056615,18422,8506,8185,321,2,319
17669,10742,11036,2,0,34526,,,,,,1,1,7.223418988,18140,8035,7719,316,3,313
17669,10819,10415,0,1,33022,,,,,,1,1,6.872468885,17615,7553,7252,301,3,298
17669,11043,11375,0,0,34712,,,,,,1,1,7.210923965,18175,8099,7760,339,2,337
17669,9768,10619,0,0,37684,,,,,,1,1,7.763010886,19168,9106,8802,304,3,301
17669,11712,10535,3,2,33341,,,,,,1,1,6.781308689,17700,7671,7372,299,1,298
17669,10439,9704,0,0,35204,,,,,,1,1,7.18009944,18292,8305,8003,302,2,300
17669,10707,9147,0,0,35548,,,,,,1,1,7.459900673,18449,8410,8131,279,1,278
17669,9228,10249,0,1,36118,,,,,,1,1,7.277189916,18793,8528,8259,269,0,269
17669,10981,9751,2,0,35626,,,,,,1,1,7.476373019,18487,8407,8082,325,4,321
17669,9823,10518,0,0,33641,,,,,,1,1,6.997649957,17883,7734,7444,290,1,289
17669,9543,9257,0,0,36602,,,,,,1,1,7.466691005,18765,8774,8485,289,2,287
17669,10436,10417,0,0,36677,,,,,,1,1,7.593265808,18516,8921,8602,319,1,318
17669,9501,8826,2,0,35221,,,,,,1,1,7.164016807,18734,8111,7846,265,1,264
17669,9697,11280,2,2,35218,,,,,,1,1,7.499791281,18376,8264,7950,314,4,310
17669,12029,9965,0,0,35397,,,,,,1,1,7.6927830870000005,18328,8365,8026,339,2,337
17669,10869,10321,0,0,35338,,,,,,1,1,7.400767216,18391,8315,7998,317,5,312
17669,9781,10426,0,0,36312,,,,,,1,1,7.696007732,18594,8706,8400,306,0,306
17669,11770,9486,4,0,34276,,,,,,1,1,7.433461555,18054,7951,7631,320,4,316
17669,12091,10650,2,6,37698,,,,,,1,1,7.97489513,18681,9325,8958,367,15,352
17669,11615,10714,0,0,37246,,,,,,1,1,7.633942006,18909,8995,8648,347,1,346
17669,10379,10159,4,0,37852,,,,,,1,1,7.840496909,19341,9088,8753,335,0,335
17669,11341,10426,0,0,36658,,,,,,1,1,7.417654426,19152,8566,8192,374,5,369
17669,10258,11395,2,0,36435,,,,,,1,1,7.514057031,18800,8640,8285,355,0,355
17669,9471,10492,2,2,36823,,,,,,1,1,7.432633117,18747,8880,8564,316,1,315
17669,10726,10317,2,2,35197,,,,,,1,1,7.100408303,18218,8344,8053,291,3,288
17669,9312,9402,0,4,36536,,,,,,1,1,7.648407447,19306,8475,8195,280,1,279
17669,10920,11024,2,0,35732,,,,,,1,1,7.360034966,18548,8442,8142,300,0,300
17669,11099,8953,2,0,36263,,,,,,1,1,7.449721701,18864,8561,8284,277,1,276
17669,9642,9345,0,0,36701,,,,,,1,1,7.54630632,19026,8698,8419,279,3,276
17669,11353,10890,2,2,35325,,,,,,1,1,7.216344077,18284,8354,8021,333,3,330
17669,8646,9486,0,0,37952,,,,,,1,1,7.749302215,19463,9109,8838,271,2,269
17669,8940,10684,2,2,37642,,,,,,1,1,7.76282065,19420,8966,8676,290,9,281
17669,10803,9932,0,4,35773,,,,,,1,1,7.236766968,18769,8364,8088,276,2,274
17669,10194,11753,0,0,36676,,,,,,1,1,7.4603878550000005,18689,8823,8482,341,3,338
17669,10410,12358,4,2,36776,,,,,,1,1,7.396911792,18814,8788,8402,386,15,371
17669,10535,9986,0,2,37071,,,,,,1,1,7.646753022,19087,8835,8521,314,1,313
17669,11604,8925,3,0,36304,,,,,,1,1,7.3237214139999995,18323,8846,8557,289,0,289
17669,8398,10527,0,0,36785,,,,,,1,1,7.527234346,19125,8681,8383,298,2,296
17669,10154,10162,0,0,35064,,,,,,1,1,7.091151542,18075,8344,8043,301,1,300
17669,11528,10461,2,4,35143,,,,,,1,1,7.317411516,17803,8511,8193,318,2,316
17669,10183,10549,2,0,36581,,,,,,1,1,7.466644291,18887,8683,8355,328,4,324
17669,10549,9811,0,2,35282,,,,,,1,1,7.321938459,18490,8252,7964,288,4,284
17669,9466,9714,0,0,37847,,,,,,1,1,7.718643799,19164,9180,8857,323,0,323
17669,10730,10700,4,4,34936,,,,,,1,1,7.096738527,18180,8231,7937,294,4,290
17669,12079,8918,3,2,33725,,,,,,1,1,6.8467593749999995,17429,8013,7743,270,0,270
17669,10634,9222,2,0,39683,,,,,,1,1,8.196889551,19899,9715,9361,354,0,354
17669,10034,10955,3,2,34333,,,,,,1,1,7.135467128,17840,8106,7825,281,7,274
17669,11230,10017,0,0,35777,,,,,,1,1,7.256290098,18573,8449,8143,306,4,302
17669,10496,10439,1,1,35649,,,,,,1,1,7.347166798,18601,8376,8080,296,4,292
17669,9126,12103,0,5,35119,,,,,,1,1,7.2735637650000005,18496,8165,7872,293,8,285
17669,11359,11058,0,2,34943,,,,,,1,1,7.147522699,17978,8324,8007,317,1,316
17669,10703,9337,0,2,37149,,,,,,1,1,7.5452098020000005,18915,8959,8643,316,9,307
17669,10218,11621,2,2,36182,,,,,,1,1,7.425385233,18581,8645,8334,311,4,307
17669,11492,11157,0,2,34508,,,,,,1,1,7.143065206,17945,8116,7785,331,5,326
17669,9913,11662,0,1,37466,,,,,,1,1,7.577803801,18746,9196,8868,328,1,327
17669,10152,10133,0,2,36038,,,,,,1,1,7.338536686,18675,8540,8257,283,3,280
17669,9860,11233,0,2,35515,,,,,,1,1,7.267763543,18404,8401,8092,309,2,307
17669,9562,10626,0,3,35764,,,,,,1,1,7.303421114,18477,8500,8213,287,2,285
17669,8555,10889,0,0,37395,,,,,,1,1,7.5286962939999995,19068,9002,8679,323,10,313
17669,9701,10289,1,0,38422,,,,,,1,1,8.049404572,19255,9421,9096,325,9,316
17669,9887,10698,0,0,36498,,,,,,1,1,7.526070118,18519,8818,8475,343,5,338
17669,11275,10457,4,2,36235,,,,,,1,1,7.512352879,18151,8865,8511,354,3,351
17669,9843,9819,7,0,35761,,,,,,1,1,7.217162736,18238,8624,8349,275,7,268
17669,11405,11801,4,0,34625,,,,,,1,1,7.08464771,17808,8224,7855,369,5,364
17669,11046,11070,0,1,35320,,,,,,1,1,7.324862797,18166,8409,8073,336,1,335
17669,11326,11010,1,1,35588,,,,,,1,1,7.47990091,18274,8509,8213,296,0,296
17669,10878,10426,2,2,34264,,,,,,1,1,6.981346517,17741,8106,7795,311,16,295
17669,10141,9952,3,0,36171,,,,,,1,1,7.461277523,18476,8667,8306,361,1,360
17669,9817,9269,2,2,36051,,,,,,1,1,7.392614498,18728,8525,8252,273,10,263
17669,10807,9805,2,2,35120,,,,,,1,1,7.157330477,18230,8301,8013,288,6,282
17669,10481,10230,0,0,38553,,,,,,1,1,7.832543991,19191,9525,9213,312,1,311
17669,10944,12054,2,0,32645,,,,,,1,1,6.67969266,17452,7446,7145,301,0,301
17669,10122,11157,0,0,35513,,,,,,1,1,7.254236636,18113,8532,8196,336,1,335
17669,11092,10848,2,0,36191,,,,,,1,1,7.430061117,18749,8549,8205,344,1,343
17669,10963,9312,0,0,36831,,,,,,1,1,7.547663846,18802,8845,8506,339,1,338
17669,11125,8668,2,2,36335,,,,,,1,1,7.437515808,18875,8577,8271,306,4,302
17669,10766,10629,1,4,36892,,,,,,1,1,7.466062701,18804,8882,8558,324,6,318
17669,11088,10901,1,3,36331,,,,,,1,1,7.417173128,18425,8784,8446,338,2,336
17669,10294,10424,2,0,34571,,,,,,1,1,7.086677969,17974,8159,7880,279,0,279
17669,9507,10574,0,2,38623,,,,,,1,1,7.956875736,19557,9388,9098,290,7,283
17669,10169,10384,0,1,36261,,,,,,1,1,7.362226081,18746,8600,8285,315,0,315
17669,12896,9970,6,0,37313,,,,,,1,1,7.645169655,18626,9151,8766,385,7,378
17669,11197,10184,0,6,35332,,,,,,1,1,7.330410443,18108,8471,8189,282,5,277
17669,11186,10163,0,0,37937,,,,,,1,1,7.884708232,19407,9092,8746,346,2,344
17669,9211,10362,2,0,37872,,,,,,1,1,7.860007483,19093,9217,8872,345,2,343
17669,11306,11583,0,2,36001,,,,,,1,1,7.48065852,18540,8550,8189,361,2,359
17669,10013,10124,0,2,36722,,,,,,1,1,7.428114967,18820,8797,8489,308,2,306
17669,10463,10971,0,2,36291,,,,,,1,1,7.426338622,18546,8709,8382,327,8,319
17669,10812,12330,0,4,36693,,,,,,1,1,7.618477227,18716,8799,8420,379,12,367
17669,11581,10289,0,2,35752,,,,,,1,1,7.398934955,18275,8568,8227,341,9,332
17669,9510,11635,0,2,36469,,,,,,1,1,7.412795654,18889,8631,8313,318,3,315
17669,9177,10075,2,0,35347,,,,,,1,1,7.192659884,18357,8360,8090,270,3,267
17669,9463,11441,0,2,35848,,,,,,1,1,7.339777098,18449,8556,8269,287,3,284
17669,10687,9102,0,0,36358,,,,,,1,1,7.47362485,18543,8766,8483,283,3,280
17669,10369,10482,0,4,35885,,,,,,1,1,7.362574471,18758,8419,8130,289,1,288
17669,9973,9138,4,0,35622,,,,,,1,1,7.302635614,18348,8494,8208,286,2,284
17669,9406,10325,0,0,34628,,,,,,1,1,7.025875674,18084,8134,7858,276,1,275
17669,10999,9018,3,0,36618,,,,,,1,1,7.619428732,19187,8542,8195,347,2,345
17669,11273,10484,0,2,34416,,,,,,1,1,7.235870971,18146,7987,7691,296,0,296
17669,10476,10432,0,0,37603,,,,,,1,1,7.709240076,19051,9109,8775,334,4,330
17669,9938,10639,0,0,35595,,,,,,1,1,7.317975321,18511,8398,8110,288,3,285
17669,10358,10907,0,3,34647,,,,,,1,1,7.001204642,18190,8069,7750,319,1,318
17669,10413,10261,2,0,36172,,,,,,1,1,7.290911468,18561,8653,8348,305,1,304
17669,11271,10780,0,0,36126,,,,,,1,1,7.307831181,18416,8657,8261,396,5,391
17669,9148,11160,0,0,36023,,,,,,1,1,7.249330146,18683,8518,8214,304,1,303
17669,10306,9920,0,0,35546,,,,,,1,1,7.314171578,18580,8324,8006,318,6,312
17669,10937,9791,0,0,35431,,,,,,1,1,7.285604375,18463,8326,8010,316,0,316
17669,10663,10483,2,0,37842,,,,,,1,1,8.026169646,19226,9134,8786,348,4,344
17669,10080,10268,0,0,36384,,,,,,1,1,7.346147898,18973,8559,8266,293,2,291
17669,10913,10543,6,2,37228,,,,,,1,1,7.600341226,19029,8945,8636,309,0,309
17669,10134,10446,0,0,36190,,,,,,1,1,7.433808924,18693,8606,8321,285,0,285
17669,11445,10340,0,0,34172,,,,,,1,1,6.9594905350000005,17666,8086,7752,334,3,331
17669,10196,11549,0,0,35021,,,,,,1,1,7.151328435,18321,8199,7897,302,4,298
17669,9334,9937,2,2,37050,,,,,,1,1,7.495523773,18989,8898,8633,265,1,264
17669,9989,10379,0,0,35997,,,,,,1,1,7.267404093,18647,8513,8189,324,2,322
17669,10845,8230,2,0,38943,,,,,,1,1,7.977354832,19676,9495,9218,277,4,273
17669,10123,11952,0,4,38266,,,,,,1,1,8.148003329,19249,9324,8955,369,15,354
17669,10008,10977,0,2,36526,,,,,,1,1,7.75869844,18399,8905,8588,317,1,316
17669,8687,10486,0,2,37985,,,,,,1,1,8.194819052,18993,9346,9046,300,2,298
17669,9411,11974,0,0,35053,,,,,,1,1,7.2638105490000004,18296,8219,7900,319,3,316
17669,10102,10412,0,0,36767,,,,,,1,1,7.581725722,19076,8689,8376,313,1,312
17669,10951,9302,1,0,35818,,,,,,1,1,7.483019162,18221,8648,8347,301,2,299
17669,10219,9006,2,0,34625,,,,,,1,1,7.351820516,18272,8051,7800,251,6,245
17669,9404,11104,0,0,35730,,,,,,1,1,7.313022522,18576,8425,8121,304,1,303
17669,9845,11129,0,2,35945,,,,,,1,1,7.376996992,18547,8550,8252,298,4,294
17669,9510,10899,0,0,37276,,,,,,1,1,7.641305369,18874,9028,8682,346,2,344
17669,11167,10821,0,3,33995,,,,,,1,1,7.133773504,18064,7797,7460,337,0,337
17669,10736,9657,2,2,35546,,,,,,1,1,7.443379534,18392,8419,8103,316,3,313
17669,10521,11357,4,0,35782,,,,,,1,1,7.486067682,18277,8589,8262,327,2,325
17669,11790,12101,4,2,33087,,,,,,1,1,7.034403287,17771,7482,7130,352,4,348
17669,9775,10021,0,0,34495,,,,,,1,1,7.494996104,18073,8074,7800,274,5,269
17669,10507,9415,2,2,35595,,,,,,1,1,7.422990294,18304,8506,8227,279,9,270
17669,10733,10585,0,2,36449,,,,,,1,1,7.729890176,18658,8724,8381,343,6,337
17669,9102,10464,0,2,37858,,,,,,1,1,7.886818895,19065,9248,8951,297,2,295
17669,11128,9233,1,0,35494,,,,,,1,1,7.247521569,18513,8340,8039,301,5,296
17669,11035,9978,0,0,34621,,,,,,1,1,7.3331011759999996,17916,8198,7889,309,0,309
17669,9694,10179,0,0,37812,,,,,,1,1,7.733170352,19294,9107,8803,304,2,302
17669,10326,8851,2,0,37846,,,,,,1,1,7.871332453,19408,9057,8733,324,3,321
17669,11002,10369,2,0,34684,,,,,,1,1,7.174745147,18083,8147,7840,307,7,300
17669,9158,10676,0,0,36580,,,,,,1,1,7.691943962,19037,8624,8329,295,1,294
17669,11785,11048,6,0,35989,,,,,,1,1,7.507166678,18231,8702,8348,354,5,349
17669,10654,10291,0,2,37920,,,,,,1,1,7.866460731,19378,9113,8797,316,10,306
17669,9748,9048,0,4,35831,,,,,,1,1,7.547689124,18970,8297,8030,267,6,261
17669,10200,10546,0,0,37700,,,,,,1,1,7.760744194,19281,9043,8710,333,1,332
17669,10382,10766,2,2,35798,,,,,,1,1,7.438320787,18287,8605,8304,301,5,296
17669,10788,9178,0,3,36134,,,,,,1,1,7.402195398,18565,8631,8324,307,10,297
17669,10949,11525,2,3,34719,,,,,,1,1,7.337131443,18089,8151,7823,328,2,326
17669,9900,10264,2,0,35901,,,,,,1,1,7.472516985,18335,8630,8324,306,0,306
17669,10382,9607,2,0,35414,,,,,,1,1,7.376423513,18472,8324,8030,294,1,293
17669,10365,10221,0,2,36385,,,,,,1,1,7.433265175,18545,8771,8473,298,4,294
17669,12590,9412,3,0,35279,,,,,,1,1,7.394040174,18113,8418,8088,330,1,329
17669,10224,11254,3,0,35691,,,,,,1,1,7.469106977,18328,8522,8203,319,10,309
17669,10598,9873,2,0,34809,,,,,,1,1,7.520679706,18141,8176,7860,316,2,314
17669,11635,10319,0,0,33809,,,,,,1,1,6.9795668,17692,7892,7559,333,1,332
17669,11314,10644,0,0,33786,,,,,,1,1,6.881845057,17712,7868,7530,338,1,337
17669,10649,10812,0,2,36840,,,,,,1,1,7.528419403,18657,8938,8631,307,2,305
17669,9576,10267,2,0,36014,,,,,,1,1,7.539510186,18834,8442,8146,296,5,291
17669,10539,11483,0,0,34637,,,,,,1,1,7.276986633,18122,8114,7827,287,1,286
17669,9998,9898,0,0,36027,,,,,,1,1,7.353003489,18724,8499,8194,305,4,301
17669,8934,9722,0,0,38425,,,,,,1,1,7.720717689,19554,9287,8990,297,1,296
17669,9840,8900,0,2,36754,,,,,,1,1,7.603778118,18984,8742,8456,286,2,284
17669,10249,10018,0,4,36641,,,,,,1,1,7.641518188,18599,8863,8547,316,2,314
17669,9687,11220,0,0,38830,,,,,,1,1,8.22460651,19443,9512,9149,363,0,363
17669,8807,10122,0,2,35187,,,,,,1,1,7.279583526,18390,8263,7992,271,4,267
17669,10927,9017,1,0,36199,,,,,,1,1,7.3751812900000004,18502,8694,8385,309,2,307
17669,11226,10484,3,3,37975,,,,,,1,1,7.793315492,19300,9163,8814,349,2,347
17669,9280,10307,0,4,38429,,,,,,1,1,7.84263253,19244,9441,9138,303,3,300
17669,9886,11871,0,4,35970,,,,,,1,1,7.3200592,18564,8536,8202,334,2,332
17669,11089,11550,0,4,35516,,,,,,1,1,7.254465796,18457,8364,8033,331,3,328
17669,10355,10827,2,4,35444,,,,,,1,1,7.166778289,18438,8343,8023,320,3,317
17669,10639,9940,0,2,36295,,,,,,1,1,7.535222687,18770,8602,8281,321,2,319
17669,10772,10447,0,0,34283,,,,,,1,1,7.028044969,17838,8069,7762,307,4,303
17669,11195,11020,0,4,36740,,,,,,1,1,7.500279805,19033,8679,8330,349,1,348
17669,10828,10044,2,0,36421,,,,,,1,1,7.462416444,18655,8736,8442,294,3,291
17669,9960,10091,4,2,36730,,,,,,1,1,7.99118291,18711,8850,8531,319,3,316
17669,9878,9736,7,2,35062,,,,,,1,1,7.22447679,18352,8233,7989,244,5,239
17669,11260,11071,0,1,35553,,,,,,1,1,7.364113652,18234,8499,8178,321,3,318
17669,10678,10921,5,2,35965,,,,,,1,1,7.306341457,18379,8630,8304,326,2,324
17669,10817,11974,0,4,35596,,,,,,1,1,7.462595686,18054,8607,8279,328,5,323
17669,10792,9939,0,2,35687,,,,,,1,1,7.59370202,18907,8242,7946,296,0,296
17669,9771,8009,0,0,38481,,,,,,1,1,7.844003064,19640,9286,9017,269,3,266
17669,10281,9578,0,0,35963,,,,,,1,1,7.360005554,18813,8431,8143,288,3,285
17669,11241,11245,0,2,35394,,,,,,1,1,7.524243424,18337,8358,8017,341,6,335
17669,9393,7828,0,0,38349,,,,,,1,1,8.07930276,19363,9356,9082,274,3,271
17669,11588,10262,0,0,36131,,,,,,1,1,7.478609154,18629,8587,8259,328,0,328
17669,10542,9894,0,0,35212,,,,,,1,1,7.677343099,18581,8143,7798,345,3,342
17669,9780,10578,1,0,36568,,,,,,1,1,7.4626877050000004,18879,8701,8414,287,2,285
17669,10754,10608,4,0,33616,,,,,,1,1,6.91215763,17197,8067,7782,285,2,283
17669,10341,10864,4,0,38585,,,,,,1,1,8.076080021,19593,9324,8980,344,11,333
17669,11376,11461,0,0,35152,,,,,,1,1,7.4253679980000005,17796,8487,8105,382,0,382
17669,9274,10514,0,2,35947,,,,,,1,1,7.475855692,18477,8599,8327,272,2,270
17669,11195,9372,0,2,34578,,,,,,1,1,7.3063281700000005,18090,8086,7770,316,10,306
17669,9047,10326,0,0,35805,,,,,,1,1,7.592270212,18396,8564,8283,281,0,281
17669,8674,11416,0,2,37644,,,,,,1,1,7.760918031,19045,9146,8839,307,3,304
17669,11016,9995,1,0,34896,,,,,,1,1,7.319896893,18190,8192,7870,322,4,318
17669,10533,10043,3,2,37012,,,,,,1,1,7.813951129,18772,8959,8637,322,3,319
17669,9774,11116,0,3,36529,,,,,,1,1,7.525741274,18640,8774,8433,341,5,336
17669,10953,10056,0,2,36116,,,,,,1,1,7.298530448,18701,8557,8256,301,1,300
17669,9920,11774,2,0,34954,,,,,,1,1,7.340355003,18345,8153,7850,303,1,302
17669,9712,7907,0,0,38659,,,,,,1,1,8.030824781,19756,9321,9060,261,0,261
17669,11205,10971,0,2,35607,,,,,,1,1,7.456639673,17776,8750,8419,331,5,326
17669,10084,9240,0,4,38850,,,,,,1,1,7.873316555,19350,9603,9309,294,3,291
17669,10328,9710,0,0,37683,,,,,,1,1,7.822381534,19095,9139,8829,310,5,305
17669,9940,9956,0,0,36890,,,,,,1,1,7.582931889,18698,8934,8610,324,2,322
17669,11332,10269,2,0,35491,,,,,,1,1,7.368426709,18293,8429,8089,340,6,334
17669,10293,9605,0,2,37754,,,,,,1,1,7.797807825,19312,9067,8759,308,15,293
17669,7665,10535,0,0,37149,,,,,,1,1,7.647221504,19416,8722,8433,289,3,286
17669,11939,11787,0,0,32898,,,,,,1,1,7.04509785,17366,7598,7262,336,1,335
17669,10785,11515,2,2,34791,,,,,,1,1,7.225949399,17729,8365,8033,332,0,332
17669,10932,10701,3,2,33716,,,,,,1,1,7.03779254,17753,7830,7527,303,5,298
17669,10320,12406,0,0,36413,,,,,,1,1,7.5591207,18205,8925,8567,358,1,357
17669,11631,10702,0,3,35409,,,,,,1,1,7.197948512,18391,8341,8005,336,4,332
17669,8963,10282,0,2,34696,,,,,,1,1,7.183979398,18584,7925,7663,262,1,261
17669,12095,9659,6,0,36195,,,,,,1,1,7.313941625,18017,8926,8600,326,13,313
17669,10366,10640,0,0,36062,,,,,,1,1,7.532316977,18806,8469,8151,318,4,314
17669,9259,10218,0,0,37676,,,,,,1,1,7.769088374,19441,8966,8663,303,3,300
17669,9628,9453,0,2,36987,,,,,,1,1,7.541828716,19099,8807,8533,274,2,272
17669,10023,10985,0,0,36598,,,,,,1,1,7.400934128,18215,9044,8749,295,0,295
17669,10713,10568,2,2,34652,,,,,,1,1,7.648798717,18102,8132,7846,286,6,280
17669,10607,11968,0,4,33758,,,,,,1,1,7.128029693,17512,7964,7646,318,7,311
17669,11410,11224,2,2,35055,,,,,,1,1,7.646824488,18166,8275,7936,339,10,329
17669,11675,10708,2,2,35093,,,,,,1,1,7.163515171,18585,8090,7762,328,10,318
17669,10940,12190,0,0,33356,,,,,,1,1,7.033949209,17398,7802,7448,354,1,353
17669,10534,9451,6,0,36345,,,,,,1,1,7.545488484,18925,8563,8269,294,1,293
17669,11578,11298,2,0,35155,,,,,,1,1,7.417611715,18425,8182,7816,366,10,356
17669,11421,11684,5,0,35511,,,,,,1,1,7.594425557,18354,8400,8043,357,2,355
17669,8137,10095,2,0,36538,,,,,,1,1,7.53141385,19153,8556,8283,273,6,267
17669,10372,12261,0,2,36305,,,,,,1,1,7.487003819,18443,8771,8451,320,6,314
17669,10167,11640,0,0,36363,,,,,,1,1,7.5990711399999995,18445,8799,8479,320,2,318
17669,10951,10414,0,1,35608,,,,,,1,1,7.537249059,18517,8395,8094,301,2,299
17669,9924,11765,2,3,36481,,,,,,1,1,7.832495861,18395,8877,8545,332,3,329
17669,10357,10320,5,0,37821,,,,,,1,1,8.079071432,18981,9280,9000,280,5,275
17669,10927,10416,0,4,36968,,,,,,1,1,7.929070709,18832,8900,8564,336,3,333
17669,10570,9536,2,2,37984,,,,,,1,1,8.383038562,19166,9250,8932,318,2,316
17669,9045,11048,0,0,36283,,,,,,1,1,8.325677622,18816,8585,8288,297,4,293
17669,11379,11149,2,0,33931,,,,,,1,1,6.982595829,17605,8002,7680,322,1,321
17669,9929,11881,2,2,36148,,,,,,1,1,7.897113947,18158,8840,8530,310,0,310
17669,10903,9988,2,2,34579,,,,,,1,1,7.182284623,17943,8166,7862,304,6,298
17669,9352,10099,2,0,36206,,,,,,1,1,7.441252794,18768,8587,8323,264,5,259
17669,10672,11191,0,6,34582,,,,,,1,1,7.55661237,18018,8121,7799,322,5,317
17669,12346,11075,2,0,34655,,,,,,1,1,7.025563655,17870,8206,7833,373,6,367
17669,10203,11471,2,4,34886,,,,,,1,1,7.604029971,17937,8316,7999,317,6,311
17669,10393,10172,5,0,36970,,,,,,1,1,7.505018708,18801,8929,8618,311,0,311
17669,9995,10545,2,2,36118,,,,,,1,1,7.50158715,18703,8562,8271,291,5,286
17669,9501,11105,1,2,38479,,,,,,1,1,7.853369469,19499,9330,9010,320,1,319
17669,9829,10805,0,0,34246,,,,,,1,1,7.082176662,18118,7937,7683,254,0,254
17669,11958,11775,0,2,35586,,,,,,1,1,7.311281822,18280,8477,8125,352,1,351
17669,11026,10104,2,3,34608,,,,,,1,1,7.229308295,18114,8097,7797,300,3,297
17669,10974,9646,2,2,38345,,,,,,1,1,7.785010437,19602,9223,8926,297,4,293
17669,10780,8820,2,0,36297,,,,,,1,1,7.498614109,18997,8510,8230,280,1,279
17669,12027,9539,0,0,34131,,,,,,1,1,7.046432039,17968,7943,7666,277,1,276
17669,10751,10728,4,0,35758,,,,,,1,1,7.437489977,18221,8606,8281,325,6,319
17669,8779,9262,0,3,39024,,,,,,1,1,8.652816932,19595,9572,9287,285,1,284
17669,10544,8425,0,0,35856,,,,,,1,1,7.6601646389999996,18326,8632,8366,266,8,258
17669,10885,9478,0,0,37960,,,,,,1,1,7.856166674,18902,9380,9082,298,3,295
17669,10374,9215,2,0,38116,,,,,,1,1,8.215944142,19550,9134,8836,298,2,296
17669,8175,11577,2,5,36337,,,,,,1,1,7.728120153,18724,8668,8391,277,5,272
17669,10553,10568,0,0,37578,,,,,,1,1,7.912361446,19388,8933,8609,324,3,321
17669,11056,10325,5,0,33787,,,,,,1,1,7.366358796,18079,7691,7365,326,3,323
17669,10759,11815,0,2,36342,,,,,,1,1,7.505174015,18257,8859,8492,367,3,364
17669,12037,10502,2,4,37361,,,,,,1,1,7.740065686,18688,9168,8831,337,1,336
17669,10836,11176,4,4,32923,,,,,,1,1,7.057436126,17329,7641,7329,312,7,305
17669,10234,9841,2,0,37611,,,,,,1,1,7.669957259,19213,9031,8695,336,7,329
17669,9040,11463,0,0,35049,,,,,,1,1,7.594314798,18480,8132,7827,305,8,297
17669,9560,9700,0,2,36999,,,,,,1,1,7.484994792,18979,8870,8590,280,9,271
17669,10223,8637,0,0,38126,,,,,,1,1,7.95967627,19448,9190,8892,298,1,297
17669,9572,10119,2,0,34807,,,,,,1,1,7.249707116,18247,8132,7836,296,1,295
17669,9549,11648,2,0,35437,,,,,,1,1,7.329736086,18355,8375,8043,332,6,326
17669,9690,10568,4,0,35284,,,,,,1,1,7.291899695,18303,8347,8060,287,1,286
17669,10567,9137,5,0,37764,,,,,,1,1,7.548367713,19179,9123,8784,339,19,320
17669,10942,12410,0,3,34315,,,,,,1,1,7.573435467,17660,8152,7801,351,7,344
17669,9453,9795,0,0,36320,,,,,,1,1,7.446306578,18925,8551,8258,293,4,289
17669,12068,10275,2,2,34014,,,,,,1,1,7.145708615,17745,7968,7635,333,2,331
17669,10488,10576,4,0,36390,,,,,,1,1,7.67836443,18514,8760,8404,356,10,346
17669,10039,10231,4,0,36534,,,,,,1,1,7.928403778,18898,8684,8416,268,0,268
17669,9081,9745,0,2,36026,,,,,,1,1,7.56211452,18434,8668,8412,256,2,254
17669,11269,10957,0,0,35137,,,,,,1,1,7.282209001,18162,8313,7964,349,3,346
17669,10306,10725,4,0,35540,,,,,,1,1,7.251776562,18493,8376,8081,295,5,290
17669,10301,10924,1,2,34528,,,,,,1,1,7.409882585,18294,7973,7685,288,2,286
17669,9853,11481,0,0,35208,,,,,,1,1,7.378664155,18346,8256,7906,350,3,347
17669,12356,10849,0,0,34160,,,,,,1,1,7.342874383,17985,7907,7546,361,2,359
17669,10869,9571,0,0,35321,,,,,,1,1,7.39496251,18370,8319,8006,313,2,311
17669,10298,9615,2,0,35596,,,,,,1,1,7.221740578,18351,8473,8174,299,2,297
17669,9976,10953,0,2,36394,,,,,,1,1,7.939842462,18723,8665,8324,341,13,328
17669,10996,10983,1,0,36000,,,,,,1,1,7.529176024,18561,8547,8202,345,4,341
17669,9916,10729,0,2,35648,,,,,,1,1,7.409006432,18614,8393,8145,248,3,245
17669,10137,9631,0,0,35095,,,,,,1,1,7.720821947,18262,8285,8022,263,0,263
17669,9953,10013,0,5,37521,,,,,,1,1,7.883838928,19212,9007,8712,295,7,288
17669,9324,11229,4,0,33809,,,,,,1,1,7.162804133,17814,7849,7552,297,6,291
17669,10575,9688,0,0,35621,,,,,,1,1,7.398732696,18440,8433,8118,315,2,313
17669,8604,10786,0,0,35086,,,,,,1,1,7.550599044,18299,8255,7978,277,2,275
17669,12263,10516,2,2,33933,,,,,,1,1,7.017017956,17687,7948,7598,350,3,347
17669,11212,10479,2,2,33050,,,,,,1,1,6.748047807,17496,7630,7336,294,2,292
17669,10948,10738,2,2,35531,,,,,,1,1,7.245060191,18077,8561,8229,332,5,327
17669,9589,11362,0,4,35514,,,,,,1,1,7.447501925,18176,8504,8174,330,5,325
17669,10898,10531,4,2,36092,,,,,,1,1,7.462109545,18712,8533,8219,314,6,308
17669,9541,11380,0,2,36881,,,,,,1,1,7.849260039,18869,8857,8559,298,1,297
17669,9572,9736,0,0,38819,,,,,,1,1,8.127665146,19413,9551,9247,304,4,300
17669,11988,10910,2,2,34756,,,,,,1,1,7.273722474,18091,8163,7824,339,3,336
17669,9421,10205,2,0,36648,,,,,,1,1,7.499854623,18901,8717,8404,313,3,310
17669,10791,10197,0,0,37436,,,,,,1,1,7.550777013,18961,9086,8783,303,1,302
17669,8578,9491,0,2,37892,,,,,,1,1,7.853043609,19008,9301,9019,282,2,280
17669,8791,9914,0,2,37438,,,,,,1,1,7.617880544,19155,9003,8726,277,2,275
17669,9888,11664,0,4,36165,,,,,,1,1,7.473113694,18546,8632,8277,355,22,333
17669,10496,9551,2,0,35827,,,,,,1,1,7.294326736,18625,8452,8154,298,6,292
17669,11388,10192,0,0,37882,,,,,,1,1,7.69394414,18971,9286,8947,339,1,338
17669,10242,10528,0,0,36561,,,,,,1,1,7.6680998240000005,18805,8716,8392,324,0,324
17669,10464,9024,2,0,35484,,,,,,1,1,7.753554969,18692,8246,7946,300,1,299
17669,11143,10930,2,5,38182,,,,,,1,1,7.9762954409999995,19068,9378,9020,358,7,351
17669,10280,9746,0,2,36650,,,,,,1,1,7.471954576,18758,8797,8499,298,2,296
17669,10379,10856,0,0,36117,,,,,,1,1,7.35817203,18344,8722,8393,329,0,329
17669,10938,10694,0,2,34215,,,,,,1,1,6.925345988,17827,8047,7753,294,6,288
17669,10622,9636,2,2,37327,,,,,,1,1,7.790272711,19189,8922,8628,294,6,288
17669,10016,10626,5,2,35578,,,,,,1,1,7.224801864,18609,8339,8048,291,9,282
17669,11629,9182,2,0,35904,,,,,,1,1,7.356814709,18574,8515,8215,300,5,295
17669,11645,11221,2,0,34865,,,,,,1,1,7.199942532,17868,8331,7996,335,3,332
17669,11275,10503,2,0,38102,,,,,,1,1,7.786942252,19221,9272,8935,337,0,337
17669,12004,10408,2,2,33869,,,,,,1,1,6.8552461319999995,17576,7970,7617,353,4,349
17669,8555,9775,0,0,36621,,,,,,1,1,7.539413089,18859,8747,8479,268,1,267
17669,10294,11128,0,2,34260,,,,,,1,1,7.069658159,17903,8013,7682,331,8,323
17669,10522,9286,0,0,37208,,,,,,1,1,7.579979536,19186,8872,8594,278,1,277
17669,10318,11897,0,0,36316,,,,,,1,1,7.367605385,18456,8768,8444,324,1,323
17669,9377,11126,0,0,36509,,,,,,1,1,7.494080963,18628,8779,8456,323,2,321
17669,11407,12042,2,1,36336,,,,,,1,1,7.357236862,18423,8770,8397,373,13,360
17669,11814,10124,3,0,37955,,,,,,1,1,7.78045631,18733,9437,9089,348,4,344
17669,9739,10838,0,0,37074,,,,,,1,1,7.597007688,18669,9041,8718,323,3,320
17669,9597,12135,0,4,35773,,,,,,1,1,7.284881527,18482,8478,8143,335,8,327
17669,12439,10177,2,4,36280,,,,,,1,1,7.422751202,18937,8508,8181,327,2,325
17669,10333,10046,2,0,34847,,,,,,1,1,7.324820964,18238,8149,7838,311,7,304
17669,10800,10463,0,0,37663,,,,,,1,1,7.747618127,19103,9103,8749,354,1,353
17669,10485,10214,1,2,37993,,,,,,1,1,7.81986934,19187,9242,8920,322,0,322
17669,10359,11804,1,0,33676,,,,,,1,1,6.886351615,17753,7796,7465,331,1,330
17669,8455,9585,2,0,36576,,,,,,1,1,7.552594535,18656,8836,8588,248,2,246
17669,10686,9868,0,0,36840,,,,,,1,1,7.5330273949999995,18952,8782,8458,324,3,321
17669,9570,11076,2,0,34891,,,,,,1,1,7.066394378,18237,8179,7883,296,0,296
17669,11803,9660,2,0,34157,,,,,,1,1,7.017669567,17938,7964,7673,291,3,288
17669,9745,11230,2,2,36941,,,,,,1,1,7.536693273,18725,8957,8655,302,2,300
17669,10816,11752,0,2,34571,,,,,,1,1,7.015903062,17973,8142,7828,314,0,314
17669,11051,10122,0,0,36153,,,,,,1,1,7.342778065,18397,8716,8392,324,5,319
17669,10808,9864,0,3,37028,,,,,,1,1,7.498568207,19338,8676,8338,338,2,336
17669,10050,8167,2,0,36759,,,,,,1,1,7.455298532,18942,8783,8532,251,9,242
17669,9572,10906,0,2,37255,,,,,,1,1,7.490655168,18959,8990,8674,316,3,313
17669,11691,9550,0,0,34188,,,,,,1,1,7.246421339,17867,8009,7706,303,4,299
17669,8577,10229,2,2,37639,,,,,,1,1,7.696815241,19244,9060,8785,275,10,265
17669,11614,11069,4,0,35537,,,,,,1,1,7.246844764,18450,8379,8050,329,2,327
17669,10826,9259,0,4,36602,,,,,,1,1,7.513577661,18569,8867,8568,299,3,296
17669,10598,9623,0,0,34877,,,,,,1,1,7.299814522,18411,8089,7801,288,2,286
17669,10796,10889,0,0,37493,,,,,,1,1,7.932809585,19175,8985,8637,348,2,346
17669,9258,9858,0,2,35759,,,,,,1,1,7.260952178,18191,8658,8406,252,0,252
17669,10098,9364,0,2,36539,,,,,,1,1,7.579244974,19004,8630,8355,275,5,270
17669,10330,11368,0,0,36981,,,,,,1,1,7.738523293,18916,8857,8506,351,1,350
17669,10970,10154,2,2,35708,,,,,,1,1,7.310570269,18229,8575,8246,329,14,315
17669,11293,10990,0,0,33670,,,,,,1,1,6.91423571,17848,7760,7458,302,0,302
17669,10024,8202,2,0,37925,,,,,,1,1,7.673718841,19354,9147,8870,277,7,270
17669,12078,10376,0,2,35705,,,,,,1,1,7.386829977,18188,8592,8259,333,4,329
17669,11478,10591,0,4,36634,,,,,,1,1,7.426487742,18388,8965,8649,316,4,312
17669,10866,11704,6,2,34785,,,,,,1,1,7.089943734,18050,8200,7865,335,7,328
17669,9183,11118,2,0,36844,,,,,,1,1,7.593401666,18989,8779,8482,297,4,293
17669,8455,9958,2,2,36876,,,,,,1,1,7.485415099,19045,8785,8524,261,5,256
17669,12670,8726,4,0,37123,,,,,,1,1,7.548153711,18523,9141,8823,318,1,317
17669,10662,10487,2,0,37000,,,,,,1,1,7.572479396,18396,9139,8813,326,3,323
17669,11241,10997,2,4,36059,,,,,,1,1,7.305493484,18622,8569,8270,299,3,296
17669,10085,11308,3,4,34439,,,,,,1,1,7.062654695,17815,8163,7865,298,11,287
17669,8738,10186,0,1,37986,,,,,,1,1,7.8390651479999995,19390,9160,8884,276,3,273
17669,11164,10203,2,0,35970,,,,,,1,1,7.32052942,18377,8634,8309,325,7,318
17669,10500,11177,0,0,36056,,,,,,1,1,7.285097273,18305,8707,8370,337,3,334
17669,8810,10726,0,3,37220,,,,,,1,1,7.563349316,19036,8945,8651,294,4,290
17669,10234,10314,0,0,35744,,,,,,1,1,7.326872596,18505,8460,8141,319,7,312
17669,8840,10701,0,0,37152,,,,,,1,1,7.544184882,19105,8867,8554,313,1,312
17669,11156,11303,0,3,32958,,,,,,1,1,6.741193183,17236,7713,7417,296,0,296
17669,9276,11403,0,0,37351,,,,,,1,1,7.58556438,18990,9015,8684,331,2,329
17669,11433,11163,2,2,36857,,,,,,1,1,7.7650803889999995,18797,8857,8511,346,7,339
17669,10632,9032,4,0,35848,,,,,,1,1,7.375663724,18593,8479,8182,297,7,290
17669,10554,9409,2,2,38408,,,,,,1,1,7.817866574,19358,9363,9039,324,17,307
17669,10137,11235,0,3,37508,,,,,,1,1,7.559641563,19118,9034,8712,322,2,320
17669,11103,11620,0,2,35768,,,,,,1,1,7.535878956,18143,8628,8259,369,1,368
17669,10926,9892,0,0,34731,,,,,,1,1,7.297821593,18153,8141,7845,296,2,294
17669,10609,10691,1,4,35398,,,,,,1,1,7.540321707,18306,8391,8081,310,2,308
17669,11716,9612,0,2,37112,,,,,,1,1,7.596183215,18301,9238,8903,335,3,332
17669,10812,9583,2,0,36750,,,,,,1,1,7.522200576,18648,8887,8559,328,5,323
17669,9456,10514,0,0,37703,,,,,,1,1,7.714332437,19189,9106,8804,302,4,298
17669,9501,10378,1,0,39721,,,,,,1,1,8.18155153,19741,9825,9495,330,1,329
17669,10553,11779,0,2,35383,,,,,,1,1,7.353520695,18437,8305,7969,336,8,328
17669,10578,9485,4,2,37028,,,,,,1,1,7.823438075,18996,8855,8533,322,6,316
17669,9493,10626,0,0,35117,,,,,,1,1,7.4811109590000004,18361,8236,7952,284,3,281
17669,11099,10691,6,0,32972,,,,,,1,1,6.787102999,17337,7672,7381,291,14,277
17669,9813,9728,2,0,34231,,,,,,1,1,7.149272797,18054,7955,7688,267,3,264
17669,11304,10889,0,4,33643,,,,,,1,1,7.148942632,17332,8002,7695,307,11,296
17669,11353,10041,6,2,34515,,,,,,1,1,7.009376923,18250,7969,7642,327,21,306
17669,11081,10948,0,0,34755,,,,,,1,1,7.101849104,18038,8205,7898,307,2,305
17669,10084,10381,4,2,35904,,,,,,1,1,7.368299686,18491,8557,8258,299,2,297
17669,11025,10810,2,0,34636,,,,,,1,1,7.334615332,17990,8158,7828,330,8,322
17669,11319,9249,0,2,35636,,,,,,1,1,7.276384101,18509,8416,8121,295,3,292
17669,9737,9330,0,0,37892,,,,,,1,1,7.591475772,19277,9157,8856,301,1,300
17669,11324,9101,3,0,36975,,,,,,1,1,7.464531647,18994,8843,8548,295,0,295
17669,10875,10663,0,0,35363,,,,,,1,1,7.513323657,18360,8360,8077,283,2,281
17669,11273,10986,0,3,34994,,,,,,1,1,7.125294624,18180,8241,7909,332,2,330
17669,10977,10956,0,0,36551,,,,,,1,1,7.60084039,18805,8709,8381,328,2,326
17669,10210,9359,3,2,36915,,,,,,1,1,7.708333536,18691,8958,8650,308,3,305
17669,11707,11202,0,0,33944,,,,,,1,1,7.167894438,17890,7869,7553,316,3,313
17669,11113,9767,3,0,34056,,,,,,1,1,7.164790675,18113,7840,7577,263,1,262
17669,10550,9399,4,0,37793,,,,,,1,1,7.56025261,19271,9107,8799,308,9,299
17669,10463,9184,0,2,37055,,,,,,1,1,8.020270323,18887,8945,8667,278,0,278
17669,10994,10330,0,0,33708,,,,,,1,1,7.267442895,17534,7918,7580,338,2,336
17669,9494,10974,2,1,34320,,,,,,1,1,7.193045483,17932,8056,7780,276,7,269
17669,10230,11263,0,1,37296,,,,,,1,1,7.804967982,18925,9023,8698,325,0,325
17669,10381,10398,0,0,35905,,,,,,1,1,7.556330833,18591,8509,8213,296,1,295
17669,9714,9893,0,2,36656,,,,,,1,1,7.729782836,18738,8797,8473,324,0,324
17669,11552,10221,4,6,36025,,,,,,1,1,7.820834779,18550,8578,8259,319,8,311
17669,10801,11796,6,4,33593,,,,,,1,1,7.364248572,17372,7959,7656,303,1,302
17669,10164,10874,3,1,38424,,,,,,1,1,8.022934035,19477,9308,8977,331,13,318
17669,9968,8507,2,0,35528,,,,,,1,1,7.53875602,18230,8502,8208,294,4,290
17669,10867,11288,0,2,34986,,,,,,1,1,7.69885986,18292,8198,7900,298,3,295
17669,10405,9700,0,0,35954,,,,,,1,1,7.780867057,18329,8672,8391,281,3,278
17669,10316,11241,2,11,34908,,,,,,1,1,7.459403858,18051,8286,8001,285,7,278
17669,10125,10902,0,5,34966,,,,,,1,1,7.539355006,18361,8156,7863,293,14,279
17669,11346,11027,0,0,34810,,,,,,1,1,7.681016243,18176,8144,7798,346,3,343
17669,11683,10765,2,0,34889,,,,,,1,1,7.555016971,18013,8276,7952,324,1,323
17669,11297,11555,0,0,34159,,,,,,1,1,7.180359532,17854,7984,7647,337,2,335
17669,10507,8899,0,2,37469,,,,,,1,1,7.86705594,19220,8972,8667,305,4,301
17669,12280,10227,2,0,34652,,,,,,1,1,7.712077559,18090,8109,7765,344,3,341
17669,10126,12825,0,2,32204,,,,,,1,1,6.77435217,17485,7193,6860,333,1,332
17669,10927,10069,0,0,36218,,,,,,1,1,7.720916129,18590,8669,8379,290,2,288
17669,10829,11754,2,2,34319,,,,,,1,1,7.176708079,17961,8008,7666,342,9,333
17669,9961,11595,3,2,35533,,,,,,1,1,7.614229942,18270,8479,8174,305,1,304
17669,9803,8757,0,0,38809,,,,,,1,1,8.858771947,19362,9575,9278,297,1,296
17669,10888,9079,0,0,37164,,,,,,1,1,7.847220314,18980,8940,8636,304,1,303
17669,9944,8774,0,0,36534,,,,,,1,1,7.941857505,18875,8706,8459,247,5,242
17669,9436,9822,0,4,37553,,,,,,1,1,8.099485021,19308,8981,8698,283,4,279
17669,10889,10304,5,0,37351,,,,,,1,1,7.987322397,19156,8922,8571,351,2,349
17669,9943,11656,0,1,36162,,,,,,1,1,7.99926293,18401,8717,8390,327,1,326
17669,10575,10823,3,2,37834,,,,,,1,1,7.871610645,19399,9047,8706,341,2,339
17669,11027,11095,0,0,32521,,,,,,1,1,7.095930655,17032,7593,7290,303,1,302
17669,11681,10816,4,3,36175,,,,,,1,1,7.532340721,18294,8759,8396,363,13,350
17669,11017,9763,1,2,35652,,,,,,1,1,7.761724925,18387,8481,8178,303,8,295
17669,10825,8353,2,0,37959,,,,,,1,1,8.500020471,18966,9348,9051,297,6,291
17669,10744,9572,2,0,38709,,,,,,1,1,8.170751513999999,19144,9617,9286,331,5,326
17669,11125,10237,2,2,38842,,,,,,1,1,8.279459878,19349,9570,9217,353,4,349
17669,10899,8981,0,2,37155,,,,,,1,1,7.740692263,18777,9047,8763,284,1,283
17669,10358,8884,0,2,37116,,,,,,1,1,7.672288255,18908,8958,8666,292,2,290
17669,9747,11460,0,3,36327,,,,,,1,1,7.430581352,18381,8797,8445,352,3,349
17669,12479,11269,2,0,35460,,,,,,1,1,7.314940632,17993,8546,8171,375,3,372
17669,10561,10036,0,0,35855,,,,,,1,1,7.599958308,18305,8619,8307,312,2,310
17669,9268,8487,0,0,36850,,,,,,1,1,7.691377824,18998,8794,8530,264,3,261
17669,10061,10387,0,3,37715,,,,,,1,1,7.809604919,19119,9137,8815,322,3,319
17669,10717,10114,2,0,34303,,,,,,1,1,7.29311663,18010,7990,7677,313,2,311
17669,11239,10795,2,0,34777,,,,,,1,1,7.403817822,18006,8232,7925,307,4,303
17669,10744,9793,0,0,36328,,,,,,1,1,7.748207733,18706,8656,8346,310,0,310
17669,11071,8738,0,0,36867,,,,,,1,1,7.771330832,18760,8912,8629,283,3,280
17669,10290,8099,0,0,36627,,,,,,1,1,7.7342783619999995,18740,8809,8540,269,0,269
17669,9752,12383,0,0,37023,,,,,,1,1,7.598407095,18748,8965,8620,345,1,344
17669,10786,10599,0,2,35847,,,,,,1,1,7.334019012,18623,8444,8108,336,2,334
17669,10158,10632,2,0,37064,,,,,,1,1,7.683996511,19027,8856,8531,325,2,323
17669,11168,9780,4,0,38184,,,,,,1,1,7.950536931,19189,9332,9001,331,11,320
17669,12223,11903,2,0,33218,,,,,,1,1,7.211245341,17863,7501,7148,353,4,349
17669,9476,11230,0,2,34943,,,,,,1,1,7.195332122,18240,8191,7870,321,5,316
17669,10349,11609,2,0,36409,,,,,,1,1,7.658453927,18385,8844,8508,336,0,336
17669,9738,11032,1,4,34917,,,,,,1,1,7.396842091,18384,8117,7818,299,6,293
17669,11219,12072,2,0,36665,,,,,,1,1,7.787297826,18431,8927,8547,380,2,378
17669,10124,10589,2,2,36884,,,,,,1,1,7.638998388,18679,8950,8645,305,6,299
17669,10224,10596,2,0,35770,,,,,,1,1,7.386543008,18749,8351,8032,319,3,316
17669,11334,9706,0,0,36164,,,,,,1,1,7.419761194,18640,8603,8285,318,2,316
17669,10618,9900,2,4,36573,,,,,,1,1,7.6240586409999995,18590,8828,8501,327,11,316
17669,10418,10233,2,2,36527,,,,,,1,1,7.565918892,18493,8857,8537,320,1,319
17669,10073,10090,0,0,36926,,,,,,1,1,7.848358663,18864,8873,8557,316,0,316
17669,10777,9572,0,0,35421,,,,,,1,1,7.42756455,18427,8344,8038,306,4,302
17669,11332,10244,0,0,34098,,,,,,1,1,7.314706228,18118,7827,7501,326,6,320
17669,10160,8955,2,0,36718,,,,,,1,1,7.636790694,18738,8853,8579,274,3,271
17669,9908,11025,0,2,36711,,,,,,1,1,7.568298452,18553,8916,8590,326,0,326
17669,9898,9902,2,0,38081,,,,,,1,1,7.804426958,19167,9301,8989,312,2,310
17669,9772,9768,2,0,35828,,,,,,1,1,7.332862087,18802,8375,8099,276,2,274
17669,10801,10537,4,1,34707,,,,,,1,1,7.229125041,18223,8083,7765,318,4,314
17669,10297,10871,0,3,35347,,,,,,1,1,7.33021973,18422,8308,7999,309,2,307
17669,10623,10684,2,1,37585,,,,,,1,1,7.878790278,19060,9091,8748,343,6,337
17669,10738,12214,2,0,35804,,,,,,1,1,7.640908359,18405,8523,8170,353,3,350
17669,11312,11156,2,2,35129,,,,,,1,1,7.75380528,18101,8338,7986,352,2,350
17669,10266,10843,4,0,36230,,,,,,1,1,7.620341836,18479,8720,8409,311,8,303
17669,9727,11423,0,2,35005,,,,,,1,1,7.466346408,18018,8341,8036,305,6,299
17669,10260,11553,0,0,35636,,,,,,1,1,7.565471348,18371,8476,8163,313,3,310
17669,12429,11604,2,0,35675,,,,,,1,1,7.407838663,18030,8619,8212,407,0,407
17669,9712,10758,1,2,36848,,,,,,1,1,7.581389407,18973,8800,8525,275,4,271
17669,10127,10818,0,4,36478,,,,,,1,1,7.860171037,19038,8561,8243,318,2,316
17669,9721,9170,2,0,36926,,,,,,1,1,8.165987248,19083,8771,8470,301,11,290
17669,7981,8355,0,0,39528,,,,,,1,1,8.002446891,19977,9635,9354,281,2,279
17669,10122,10552,2,0,35271,,,,,,1,1,7.522265873,18017,8471,8159,312,0,312
17669,10773,10762,0,0,36154,,,,,,1,1,7.692123436,18469,8677,8346,331,0,331
17669,10285,10316,4,0,35693,,,,,,1,1,7.562814609,18650,8381,8100,281,5,276
17669,11456,10795,0,0,35602,,,,,,1,1,7.719167817,18493,8367,7992,375,2,373
17669,10797,9107,2,0,36057,,,,,,1,1,7.691958753,18644,8562,8273,289,2,287
17669,10521,9685,0,0,36358,,,,,,1,1,7.584612249,18476,8799,8515,284,4,280
17669,11475,10050,0,0,37350,,,,,,1,1,7.5431238369999996,18980,8995,8615,380,1,379
17669,10530,9592,0,6,34477,,,,,,1,1,7.050968485,18333,7945,7691,254,3,251
17669,10037,10265,2,2,35779,,,,,,1,1,7.609631731,18720,8378,8075,303,1,302
17669,11037,9563,0,0,37393,,,,,,1,1,7.803442464,19085,8991,8665,326,0,326
17669,10588,9139,0,2,35945,,,,,,1,1,7.346341003,18321,8673,8395,278,9,269
17669,10832,10742,0,2,36720,,,,,,1,1,7.459526848,18548,8931,8621,310,5,305
17669,10941,10178,0,3,35062,,,,,,1,1,7.20206426,17946,8420,8144,276,0,276
17669,10899,11419,0,3,34660,,,,,,1,1,7.236485463,17945,8194,7867,327,5,322
17669,8865,10287,0,0,37071,,,,,,1,1,7.69260184,19136,8821,8528,293,2,291
17669,10767,12055,0,0,38547,,,,,,1,1,7.991222411,19041,9557,9165,392,3,389
17669,10680,10195,0,0,35040,,,,,,1,1,7.836702898,18438,8165,7893,272,0,272
17669,9723,10928,2,0,34714,,,,,,1,1,7.518125991,18091,8165,7872,293,3,290
17669,10012,10814,6,2,35447,,,,,,1,1,7.534840088,18222,8466,8173,293,11,282
17669,9328,10888,0,4,35987,,,,,,1,1,7.687566477,18610,8545,8258,287,0,287
17669,9110,10144,0,0,38523,,,,,,1,1,7.99647779,19001,9616,9326,290,3,287
17669,11526,11197,0,0,34647,,,,,,1,1,7.301035106,17547,8393,8079,314,1,313
17669,11437,11097,4,2,34729,,,,,,1,1,7.141200819,18262,8075,7758,317,2,315
17669,12246,9655,4,0,37435,,,,,,1,1,8.160761137,18870,9113,8774,339,4,335
17669,9765,10766,2,1,37635,,,,,,1,1,7.688206054,19063,9122,8794,328,6,322
17669,9918,9533,0,0,34318,,,,,,1,1,7.074493892,18172,7939,7671,268,2,266
17669,10094,10775,4,0,35644,,,,,,1,1,7.406323621,18653,8354,8071,283,4,279
17669,9991,11099,2,0,36898,,,,,,1,1,7.67635556,18629,8966,8629,337,2,335
17669,9519,11657,0,4,34567,,,,,,1,1,7.337774748,17658,8305,8006,299,8,291
17669,9507,11301,3,2,35986,,,,,,1,1,7.601520981,18580,8535,8199,336,2,334
17669,8807,10608,0,0,35671,,,,,,1,1,7.35835432,18542,8410,8101,309,4,305
17669,10838,9737,0,2,35913,,,,,,1,1,7.742624939,18613,8502,8206,296,4,292
17669,9109,10993,2,4,35553,,,,,,1,1,7.419815994,18400,8439,8164,275,1,274
17669,11031,8703,0,0,34005,,,,,,1,1,7.266534119,17905,7917,7651,266,1,265
17669,9533,12035,0,0,34845,,,,,,1,1,7.316839579,18119,8207,7895,312,2,310
17669,10666,10952,0,6,37078,,,,,,1,1,7.595287593,18601,9079,8760,319,3,316
17669,12093,9923,0,0,35368,,,,,,1,1,7.5189823350000005,18343,8338,7989,349,2,347
17669,10082,9496,2,1,34755,,,,,,1,1,7.348544753,18221,8133,7865,268,13,255
17669,9344,8593,0,0,37058,,,,,,1,1,7.9525830509999995,19219,8783,8510,273,3,270
17669,9250,10740,0,2,37219,,,,,,1,1,8.022291745,18946,8975,8652,323,1,322
17669,11003,8909,2,0,37331,,,,,,1,1,8.238028577,18990,9007,8680,327,2,325
17669,11478,8803,2,0,35232,,,,,,1,1,7.5476127680000005,18217,8356,8053,303,0,303
17669,11809,9792,0,2,37095,,,,,,1,1,7.739541344,19069,8830,8464,366,6,360
17669,9339,10759,0,0,35164,,,,,,1,1,7.130722812,18386,8244,7954,290,2,288
17669,8481,10554,0,0,37452,,,,,,1,1,7.789160136,18914,9135,8867,268,2,266
17669,10702,10720,4,1,37015,,,,,,1,1,7.68345012,18669,8994,8636,358,18,340
17669,9319,10977,0,4,36567,,,,,,1,1,7.50782629,19013,8611,8279,332,3,329
17669,9218,10993,2,4,34582,,,,,,1,1,7.525653509,18328,7977,7677,300,3,297
17669,10123,12149,0,2,34309,,,,,,1,1,7.106810607,18142,7911,7566,345,9,336
17669,9120,9852,0,2,35609,,,,,,1,1,7.421079477,18682,8333,8072,261,1,260
17669,9571,10612,2,0,36999,,,,,,1,1,7.644675514,18743,8973,8663,310,7,303
17669,9946,9676,2,2,37603,,,,,,1,1,7.739921889,19257,9027,8735,292,12,280
17669,11065,9689,6,2,37447,,,,,,1,1,7.859154681,19063,9034,8718,316,1,315
17669,8269,10987,0,2,37090,,,,,,1,1,7.736260143,19051,8882,8607,275,2,273
17669,10361,10260,2,2,35348,,,,,,1,1,7.335433832,17984,8535,8241,294,7,287
17669,10092,9487,3,0,36143,,,,,,1,1,7.39361939,18747,8566,8302,264,1,263
17669,10572,10050,0,2,35583,,,,,,1,1,7.422352473,18503,8388,8084,304,3,301
17669,10423,11005,0,0,35088,,,,,,1,1,7.204882284,18145,8319,8014,305,2,303
17669,9320,9425,2,0,34736,,,,,,1,1,7.216744308,18379,8051,7796,255,5,250
17669,10560,11315,2,2,33301,,,,,,1,1,7.08427095,17574,7699,7370,329,19,310
17669,9387,11315,0,0,34525,,,,,,1,1,7.410805252,17775,8237,7961,276,2,274
17669,11529,11652,2,2,35412,,,,,,1,1,7.226423087,18329,8359,7994,365,3,362
17669,10612,11078,0,2,34952,,,,,,1,1,7.450642286,18052,8287,7961,326,0,326
17669,9539,9964,2,2,35520,,,,,,1,1,7.429436234,18482,8371,8075,296,4,292
17669,10715,9479,0,2,36651,,,,,,1,1,7.357804487,19092,8617,8292,325,6,319
17669,9018,10203,4,0,38399,,,,,,1,1,7.999927103,19436,9351,9090,261,2,259
17669,10765,11042,0,2,36923,,,,,,1,1,7.640583848,18685,8955,8627,328,2,326
17669,10576,9802,1,0,35084,,,,,,1,1,7.273997855,18358,8211,7907,304,0,304
17669,8639,9996,0,11,37367,,,,,,1,1,7.512314831,19109,8999,8739,260,3,257
17669,10876,9332,0,0,35018,,,,,,1,1,7.413548394,18286,8224,7940,284,1,283
17669,11486,9853,0,0,34624,,,,,,1,1,7.175513601,18013,8153,7848,305,1,304
17669,11906,12327,0,2,20251,,,,,,1,1,4.307970454,10313,4801,4465,336,0,336
17669,10063,10085,2,2,37532,,,,,,1,1,7.711101971,19165,9013,8672,341,7,334
17669,10708,10761,2,2,34786,,,,,,1,1,7.36344463,17976,8261,7973,288,2,286
17669,10394,10337,0,0,37843,,,,,,1,1,8.015864057,19184,9160,8821,339,2,337
17669,10493,10426,0,0,34078,,,,,,1,1,7.063148552,17925,7916,7595,321,1,320
17669,9201,8844,2,0,36860,,,,,,1,1,7.578236621,19134,8739,8491,248,4,244
17669,10459,9882,0,3,36057,,,,,,1,1,7.363636417,18640,8563,8272,291,5,286
17669,9362,11702,4,0,35869,,,,,,1,1,7.546182034,18192,8676,8351,325,10,315
17669,8799,10213,0,0,37967,,,,,,1,1,7.638124763,19188,9260,9001,259,0,259
17669,9633,10520,2,2,36267,,,,,,1,1,7.689285601,18893,8536,8234,302,10,292
17669,11202,10653,2,2,35363,,,,,,1,1,7.160122577,18098,8463,8124,339,10,329
17669,10779,9900,3,0,35538,,,,,,1,1,7.249680919,18471,8389,8100,289,1,288
17669,10486,10477,0,0,37145,,,,,,1,1,7.580563035,18638,9085,8748,337,1,336
17669,11476,9800,0,4,37608,,,,,,1,1,7.671682905,19124,9072,8732,340,5,335
17669,10999,9651,4,0,35889,,,,,,1,1,7.4187595250000005,18189,8705,8415,290,10,280
17669,11297,10610,0,0,36142,,,,,,1,1,7.435609433,18500,8655,8323,332,3,329
17669,10289,9441,0,0,35470,,,,,,1,1,7.34437297,18788,8198,7912,286,5,281
17669,10852,9485,4,0,36233,,,,,,1,1,7.410422413,18681,8616,8296,320,3,317
17669,10423,10768,0,0,36753,,,,,,1,1,7.537642728,18510,8964,8649,315,0,315
17669,9173,8282,0,0,36607,,,,,,1,1,7.484087383,19004,8684,8449,235,0,235
17669,9587,8730,0,0,37298,,,,,,1,1,7.597600763,19015,9000,8717,283,3,280
17669,11961,9656,3,0,34218,,,,,,1,1,7.28298565,17928,8001,7713,288,0,288
17669,10788,9304,4,2,35617,,,,,,1,1,7.237903925,18456,8436,8147,289,3,286
17669,9253,10352,1,3,37826,,,,,,1,1,7.818703426,19020,9255,8959,296,0,296
17669,10423,10075,0,0,35480,,,,,,1,1,7.41951811,18040,8575,8285,290,0,290
17669,9852,10981,2,8,38272,,,,,,1,1,7.693586144,19345,9291,8946,345,9,336
17669,9294,9708,0,3,36844,,,,,,1,1,7.5407426619999995,19022,8769,8485,284,4,280
17669,10193,12028,2,4,35892,,,,,,1,1,7.302930059,18113,8721,8384,337,1,336
17669,10703,12198,2,0,35931,,,,,,1,1,7.477889638,18361,8603,8239,364,6,358
17669,10916,9003,0,0,36593,,,,,,1,1,7.338281082,18837,8733,8443,290,2,288
17669,10937,9611,2,0,33988,,,,,,1,1,6.96587846,17990,7842,7528,314,0,314
17669,9553,11011,2,0,35377,,,,,,1,1,7.186654811,18239,8413,8101,312,3,309
17669,11168,10187,2,4,35502,,,,,,1,1,7.285302439,18011,8584,8261,323,6,317
17669,9658,10186,2,3,37658,,,,,,1,1,7.629740427,19010,9173,8871,302,1,301
17669,7995,9070,4,2,36934,,,,,,1,1,7.473414186,18957,8876,8651,225,3,222
17669,11254,8956,2,3,37802,,,,,,1,1,7.806601283,19379,9060,8757,303,6,297
17669,10425,9983,2,2,37542,,,,,,1,1,7.914682769,19340,8935,8603,332,4,328
17669,11747,9324,2,0,35243,,,,,,1,1,7.388072438,18306,8315,8008,307,2,305
17669,10500,10598,0,2,37100,,,,,,1,1,7.701651149,18509,9115,8754,361,3,358
17669,11228,9217,3,0,35598,,,,,,1,1,7.411458657,18773,8271,7988,283,0,283
17669,10918,11675,0,0,36928,,,,,,1,1,7.662108499,18638,8980,8650,330,1,329
17669,8567,10821,2,0,38861,,,,,,1,1,8.338166982,19235,9660,9354,306,8,298
17669,9588,12606,0,1,35332,,,,,,1,1,7.656777986,18171,8411,8072,339,3,336
17669,11277,10224,2,2,35531,,,,,,1,1,7.246198816,18434,8381,8046,335,8,327
17669,11172,9025,0,0,35526,,,,,,1,1,7.443662691,18591,8322,8031,291,4,287
17669,9785,11138,0,2,36366,,,,,,1,1,7.821902119,18713,8672,8363,309,1,308
17669,12272,10171,2,0,33704,,,,,,1,1,7.135390827,17578,7897,7565,332,6,326
17669,9756,11060,0,0,38982,,,,,,1,1,8.023716874,19431,9601,9252,349,0,349
17669,10166,11523,4,0,36722,,,,,,1,1,7.749694689,18784,8811,8495,316,9,307
17669,12096,10864,2,0,33678,,,,,,1,1,6.996063007,18039,7663,7350,313,1,312
17669,9866,10448,2,2,38661,,,,,,1,1,8.184336269,19295,9528,9218,310,5,305
17669,10280,11542,0,4,36707,,,,,,1,1,7.870383514,18334,8988,8591,397,7,390
17669,10542,10384,0,0,35755,,,,,,1,1,7.685647808,18486,8480,8171,309,1,308
17669,9848,11027,0,0,36529,,,,,,1,1,7.690194138,18605,8805,8491,314,1,313
17669,10589,10751,0,2,35800,,,,,,1,1,7.455939059,18393,8554,8255,299,0,299
17669,11892,8858,5,0,34365,,,,,,1,1,7.281025496,18204,7943,7668,275,3,272
17669,10239,7962,0,0,36513,,,,,,1,1,7.837558268,19165,8549,8299,250,4,246
17669,12297,10260,4,0,34182,,,,,,1,1,7.119746571,18023,7917,7592,325,10,315
17669,10364,9734,0,0,35194,,,,,,1,1,7.663242528,18372,8263,7967,296,3,293
17669,9154,10978,0,0,37671,,,,,,1,1,7.997847725,18995,9173,8843,330,2,328
17669,9479,9623,0,0,38763,,,,,,1,1,8.351639257,19023,9732,9456,276,3,273
17669,7620,11961,2,0,36448,,,,,,1,1,7.725716119,18885,8645,8372,273,4,269
17669,10154,11544,0,2,38218,,,,,,1,1,8.032545485,19282,9286,8922,364,11,353
17669,10942,8966,2,0,37984,,,,,,1,1,7.688124772,19119,9271,8948,323,2,321
17669,9145,9960,0,2,36392,,,,,,1,1,7.64559811,18792,8653,8359,294,5,289
17669,9429,9791,5,0,35274,,,,,,1,1,7.567823784,18171,8416,8145,271,2,269
17669,10655,9181,2,2,36377,,,,,,1,1,7.6182132110000005,18721,8677,8375,302,1,301
17669,10446,11174,0,0,35442,,,,,,1,1,7.427470562,18263,8424,8093,331,1,330
17669,9591,11303,0,0,36502,,,,,,1,1,7.5733781780000005,18512,8850,8560,290,1,289
17669,11461,10853,0,0,35002,,,,,,1,1,7.328848598,18049,8313,7986,327,1,326
17669,9838,9070,2,2,35687,,,,,,1,1,7.371279505,18672,8372,8101,271,12,259
17669,11006,10589,2,4,34177,,,,,,1,1,6.990900867,18125,7875,7573,302,7,295
17669,10241,10951,2,4,37925,,,,,,1,1,7.763283302,18934,9331,9002,329,4,325
17669,11607,12176,1,0,34736,,,,,,1,1,7.285560278,18200,8099,7761,338,5,333
17669,9008,8830,0,0,38018,,,,,,1,1,7.784489779,19322,9197,8895,302,2,300
17669,11460,12087,4,0,35411,,,,,,1,1,7.350696221,18298,8369,7994,375,1,374
17669,9668,10712,4,0,38542,,,,,,1,1,7.971984653,19150,9538,9222,316,10,306
17669,10708,9802,3,2,36472,,,,,,1,1,7.527244845,18397,8880,8565,315,5,310
17669,8994,11409,0,2,35098,,,,,,1,1,7.349139326,18621,8090,7793,297,1,296
17669,10820,11442,4,4,36983,,,,,,1,1,7.486549971,18745,8946,8600,346,11,335
17669,10385,9376,2,0,37859,,,,,,1,1,7.780949963,19378,9098,8813,285,1,284
17669,9157,10237,0,0,36831,,,,,,1,1,7.706742413,18941,8790,8480,310,3,307
17669,9544,11344,2,2,36541,,,,,,1,1,7.589435974,19052,8595,8296,299,1,298
17669,8927,8964,0,0,38819,,,,,,1,1,7.953334426,19877,9332,9054,278,1,277
17669,10279,10201,0,2,35760,,,,,,1,1,7.395187301,18632,8406,8090,316,9,307
17669,11272,10900,2,1,34591,,,,,,1,1,7.067414843,18160,8055,7734,321,6,315
17669,9764,9431,0,2,35146,,,,,,1,1,7.449360729,18502,8190,7926,264,2,262
17669,10144,11447,2,0,35775,,,,,,1,1,7.359693254,18186,8632,8307,325,3,322
17669,10180,9897,0,2,37317,,,,,,1,1,7.930255419,19004,8993,8666,327,7,320
17669,10529,10973,0,2,33959,,,,,,1,1,6.986467378,17714,7972,7671,301,3,298
17669,10923,9583,0,0,36971,,,,,,1,1,7.635267926,18890,8884,8571,313,0,313
17669,11522,10429,6,0,34917,,,,,,1,1,7.224891991,18189,8188,7836,352,16,336
17669,10716,10125,2,0,36283,,,,,,1,1,7.678892844,18850,8569,8274,295,2,293
17669,9796,11342,0,2,34578,,,,,,1,1,7.415227476,18474,7897,7587,310,3,307
17669,11250,10590,2,0,35869,,,,,,1,1,7.547817845,18492,8524,8195,329,3,326
17669,10722,10084,0,0,35373,,,,,,1,1,7.32604965,18339,8366,8064,302,2,300
17669,11060,10286,0,0,37111,,,,,,1,1,7.7026762479999995,18711,9027,8681,346,0,346
17669,10431,9543,0,0,37643,,,,,,1,1,7.949948352,19326,8994,8665,329,2,327
17669,10932,10968,4,2,34660,,,,,,1,1,7.302556993,18157,8076,7725,351,7,344
17669,10280,11315,4,0,37052,,,,,,1,1,7.818236487,18962,8886,8568,318,8,310
17669,12198,11023,4,2,36302,,,,,,1,1,7.5356345529999995,18254,8829,8439,390,13,377
17669,11065,10968,1,2,35172,,,,,,1,1,7.375437295,18209,8316,7985,331,4,327
17669,11256,11836,0,2,35159,,,,,,1,1,7.355387757,18169,8321,7973,348,2,346
17669,11215,8960,0,2,34518,,,,,,1,1,7.044833944,18159,8041,7764,277,1,276
17669,11469,8684,4,2,36516,,,,,,1,1,7.450715907,18702,8736,8394,342,8,334
17669,10600,9458,0,0,35616,,,,,,1,1,7.396344544,18719,8312,8039,273,2,271
17669,10700,9860,4,2,38244,,,,,,1,1,8.227801871,19190,9375,9071,304,8,296
17669,11817,9592,0,2,35129,,,,,,1,1,7.22750387,18240,8281,7954,327,5,322
17669,8980,9920,4,1,36166,,,,,,1,1,7.770872468,18457,8736,8499,237,3,234
17669,8946,9186,0,0,36804,,,,,,1,1,8.161175896,19040,8753,8495,258,2,256
17669,11214,9860,4,2,34855,,,,,,1,1,7.210082425,18219,8160,7844,316,11,305
17669,10473,10888,0,2,35982,,,,,,1,1,7.68522777,18398,8627,8297,330,3,327
17669,10392,11073,2,0,36662,,,,,,1,1,8.071904935,18574,8886,8570,316,1,315
17669,12003,10895,4,4,35238,,,,,,1,1,7.179571311,18025,8433,8086,347,2,345
17669,10422,10467,3,0,37050,,,,,,1,1,7.633961188,18810,8965,8655,310,1,309
17669,9881,10883,2,0,37295,,,,,,1,1,7.825305484,18836,9070,8751,319,4,315
17669,11451,10750,2,3,35826,,,,,,1,1,7.416983712,18239,8619,8270,349,7,342
17669,12004,11679,3,4,34892,,,,,,1,1,7.276376178,17871,8326,7957,369,5,364
17669,11837,11020,0,2,34776,,,,,,1,1,7.46626878,17963,8242,7913,329,5,324
17669,8714,10986,0,0,35964,,,,,,1,1,7.425741847,18351,8665,8382,283,2,281
17669,10291,10005,1,4,34599,,,,,,1,1,7.007727882,18300,8022,7767,255,2,253
17669,10952,10749,0,0,35292,,,,,,1,1,7.338732423,18123,8436,8139,297,4,293
17669,8504,9854,0,0,36449,,,,,,1,1,7.332115057,18973,8605,8339,266,4,262
17669,10334,11309,0,2,35305,,,,,,1,1,7.351532796,18309,8345,8039,306,8,298
17669,9322,8946,2,0,38072,,,,,,1,1,7.934342251,19078,9361,9089,272,5,267
17669,12277,9380,0,0,35769,,,,,,1,1,7.759033929,18646,8389,8044,345,3,342
17669,9830,10828,2,0,33790,,,,,,1,1,6.947318612,18232,7644,7374,270,4,266
17669,11037,10894,0,4,35062,,,,,,1,1,7.201039371,18021,8368,8063,305,1,304
17669,9056,12194,2,2,38664,,,,,,1,1,7.990015599,19087,9602,9229,373,12,361
17669,10430,9831,2,8,35663,,,,,,1,1,7.449739185,18384,8493,8200,293,14,279
17669,10486,8254,2,0,37163,,,,,,1,1,7.596970896,19024,8935,8666,269,10,259
17669,10193,10555,0,0,34709,,,,,,1,1,7.038613927,18367,8014,7700,314,3,311
17669,10743,9053,2,0,37757,,,,,,1,1,7.904933325,18964,9244,8939,305,2,303
17669,9869,10891,0,0,35407,,,,,,1,1,7.550069982,18299,8415,8137,278,5,273
17669,10883,9671,0,0,36456,,,,,,1,1,7.435985036,18516,8818,8514,304,0,304
17669,9506,10009,2,2,37801,,,,,,1,1,8.135950458,19298,9100,8797,303,5,298
17669,9681,10881,0,0,36924,,,,,,1,1,7.881433925,18834,8887,8571,316,0,316
17669,8942,8023,0,0,37838,,,,,,1,1,7.970011025,19561,9011,8756,255,4,251
17669,11361,11755,2,0,36919,,,,,,1,1,7.688506856,18605,8970,8596,374,1,373
17669,9624,10810,1,2,35744,,,,,,1,1,7.255845329,18582,8448,8182,266,3,263
17669,9071,10515,2,0,35710,,,,,,1,1,7.30394127,18445,8484,8187,297,7,290
17669,10402,10012,0,4,36477,,,,,,1,1,7.578406169,19016,8571,8252,319,7,312
17669,10708,9109,6,4,35085,,,,,,1,1,7.263552,17999,8410,8144,266,7,259
17669,10613,10037,0,0,35614,,,,,,1,1,7.543859848,18417,8445,8138,307,1,306
17669,10464,11275,6,0,36672,,,,,,1,1,7.569329762,18723,8804,8463,341,5,336
17669,11452,10623,2,2,34290,,,,,,1,1,7.185424086,17748,8106,7776,330,9,321
17669,10361,8125,0,0,37546,,,,,,1,1,7.724506985,19179,9045,8768,277,2,275
17669,10556,10273,2,0,36679,,,,,,1,1,7.577683789,18642,8844,8495,349,1,348
17669,7951,9949,0,0,38850,,,,,,1,1,7.83435684,19806,9385,9111,274,1,273
17669,9667,9498,0,4,36500,,,,,,1,1,7.675059212,19000,8610,8330,280,0,280
17669,8287,11605,0,2,36726,,,,,,1,1,7.450598576,18769,8833,8542,291,6,285
17669,9379,9695,2,2,36742,,,,,,1,1,7.5111616,18989,8733,8446,287,7,280
17669,11808,11356,4,0,35208,,,,,,1,1,7.208436723,18097,8388,8053,335,2,333
17669,10987,12546,0,0,33780,,,,,,1,1,7.063898995,17644,7898,7558,340,3,337
17669,10204,10221,0,0,35349,,,,,,1,1,7.343652487,18365,8336,8024,312,4,308
17669,10726,10778,0,2,34942,,,,,,1,1,7.330168427,18172,8225,7905,320,3,317
17669,10469,11156,0,2,37852,,,,,,1,1,7.653107679,19054,9234,8904,330,7,323
17669,10066,9591,4,0,36561,,,,,,1,1,7.610732634,18766,8748,8449,299,1,298
17669,10442,10597,2,0,34631,,,,,,1,1,7.137969142,18053,8121,7785,336,3,333
17669,11933,11525,2,1,36038,,,,,,1,1,7.339283214,18574,8567,8237,330,1,329
17669,10175,8937,3,2,34779,,,,,,1,1,6.187315532,18052,8224,7945,279,8,271
17669,12108,11185,5,0,36169,,,,,,1,1,7.486154128,18164,8829,8482,347,2,345
17669,10008,10918,0,2,35605,,,,,,1,1,7.216389958,18635,8331,8023,308,1,307
17669,10893,10449,4,2,35281,,,,,,1,1,6.406144884,18138,8422,8123,299,3,296
17669,11095,10449,4,0,37019,,,,,,1,1,7.552765246,19061,8822,8508,314,3,311
17669,11405,10917,0,2,36033,,,,,,1,1,6.975139393,18134,8786,8459,327,4,323
17669,9622,11246,2,3,34819,,,,,,1,1,5.465024797,18139,8180,7860,320,6,314
17669,10444,9955,0,2,37894,,,,,,1,1,7.5914546739999995,18973,9305,8994,311,5,306
17669,8891,12273,0,0,36157,,,,,,1,1,5.687490669,18447,8688,8354,334,2,332
17669,11580,9778,0,2,36706,,,,,,1,1,7.086753288,18360,8998,8648,350,15,335
17669,10166,10800,0,4,37445,,,,,,1,1,5.962222047,18983,9084,8790,294,9,285
17669,8085,10256,0,0,36629,,,,,,1,1,5.778670542,18876,8735,8452,283,0,283
17669,10450,12551,0,2,37132,,,,,,1,1,6.734604806,18783,8986,8609,377,0,377
17669,10173,9825,1,0,36964,,,,,,1,1,7.408355469,18738,8953,8633,320,4,316
17669,11081,10379,0,2,34657,,,,,,1,1,7.048569976,17775,8286,7976,310,6,304
17669,10182,9946,2,2,35772,,,,,,1,1,6.547527521,18418,8543,8275,268,6,262
17669,8962,10956,0,0,38161,,,,,,1,1,7.542215238,18913,9461,9135,326,1,325
17669,10214,9978,0,0,37287,,,,,,1,1,6.550677529,19245,8860,8538,322,2,320
17669,9734,10847,2,2,36844,,,,,,1,1,6.295419519,18867,8829,8510,319,4,315
