key_bits,recovered_zeros_x,recovered_zeros_y,wrong_zeros_x,wrong_zeros_y,queries,traces,calibration_traces,threshold,tpr,tnr,attack_tpr,attack_tnr,duration_seconds,test_outcomes_0_false,test_outcomes_0_true,test_outcomes_1_false,test_outcomes_1_true,test_outcomes_2_false,test_outcomes_2_true
17669,10994,10330,0,0,33558,,,,,,1,1,6.871984775,17534,7868,7580,288,2,286
17669,11445,10340,0,0,34115,,,,,,1,1,7.092859677,17666,8067,7752,315,3,312
17669,10801,11796,6,4,33598,,,,,,1,1,7.19280887,17366,7959,7645,314,1,313
17669,11113,9767,3,0,34103,,,,,,1,1,7.254488988,18124,7863,7610,253,1,252
17669,10549,9811,0,2,35285,,,,,,1,1,7.323526441,18490,8253,7964,289,4,285
17669,10611,9278,2,0,35321,,,,,,1,1,7.378956039,18625,8206,7922,284,4,280
17669,9989,10379,0,0,36009,,,,,,1,1,7.390278967,18647,8517,8189,328,2,326
17669,10061,12227,2,2,34634,,,,,,1,1,7.391324649,17979,8151,7798,353,2,351
17669,9853,11346,2,2,34858,,,,,,1,1,7.3986423519999995,18272,8108,7738,370,16,354
17669,11742,10467,0,2,35348,,,,,,1,1,7.401202101,18009,8492,8137,355,3,352
17669,10358,10907,0,3,34635,,,,,,1,1,7.412274546,18190,8065,7750,315,1,314
17669,11332,10269,2,0,35442,,,,,,1,1,7.431396333,18292,8413,8089,324,8,316
17669,10902,10424,4,0,36383,,,,,,1,1,7.441134033,18668,8701,8388,313,5,308
17669,10896,9351,1,1,35527,,,,,,1,1,7.461699536,18662,8287,7996,291,1,290
17669,11500,10477,2,0,36021,,,,,,1,1,7.472020023,18507,8599,8283,316,1,315
17669,10413,10261,2,0,36142,,,,,,1,1,7.534604262,18561,8643,8348,295,1,294
17669,9514,10878,2,0,36288,,,,,,1,1,7.5714255900000005,18262,8861,8557,304,3,301
17669,10230,11263,0,1,37335,,,,,,1,1,7.585168425,18925,9036,8698,338,0,338
17669,9619,9271,2,2,35461,,,,,,1,1,7.611914148,18559,8310,8028,282,13,269
17669,10516,10759,2,0,36096,,,,,,1,1,7.640234759,18566,8601,8273,328,1,327
17669,11338,11019,2,2,37236,,,,,,1,1,7.719886782,18940,8967,8605,362,9,353
17669,10199,9012,2,0,37777,,,,,,1,1,7.802246736,19466,9003,8698,305,1,304
17669,10476,10432,0,0,37588,,,,,,1,1,7.841234697,19051,9104,8775,329,4,325
17669,10845,8230,2,0,38984,,,,,,1,1,8.33281639,19677,9508,9217,291,5,286
17669,10829,11754,2,2,34351,,,,,,1,1,6.972817117,18002,8018,7705,313,0,313
17669,11790,12101,4,2,33014,,,,,,1,1,6.809482968,17765,7456,7119,337,2,335
17669,9415,11981,0,6,33982,,,,,,1,1,6.938718324,17814,7937,7643,294,3,291
17669,11002,10369,2,0,34590,,,,,,1,1,7.002542309,18039,8122,7815,307,7,300
17669,11405,11801,4,0,34835,,,,,,1,1,7.295853158,17937,8270,7912,358,10,348
17669,11017,9763,1,2,35776,,,,,,1,1,7.426693681,18473,8494,8179,315,7,308
17669,10899,11023,2,2,34439,,,,,,1,1,7.025231804,18174,7985,7690,295,1,294
17669,11049,10704,0,1,35857,,,,,,1,1,7.291448091,18480,8501,8126,375,8,367
17669,10003,11079,0,0,35477,,,,,,1,1,7.311941264,18446,8362,8055,307,1,306
17669,10341,8234,0,0,36819,,,,,,1,1,7.386842975,18950,8798,8525,273,2,271
17669,10377,10543,0,0,36326,,,,,,1,1,7.364919167,18750,8623,8293,330,4,326
17669,10888,9079,0,0,37236,,,,,,1,1,7.577451656,18980,8964,8636,328,1,327
17669,9845,11129,0,2,35799,,,,,,1,1,7.426509667,18445,8523,8215,308,4,304
17669,10565,9329,4,0,35797,,,,,,1,1,7.23854391,18286,8602,8295,307,4,303
17669,10167,11640,0,0,36378,,,,,,1,1,7.591396761,18445,8804,8479,325,2,323
17669,9660,10907,0,0,35751,,,,,,1,1,7.423550129,18450,8495,8184,311,0,311
17669,10096,10070,0,2,36909,,,,,,1,1,7.6855379809999995,18912,8850,8553,297,2,295
17669,10820,10876,0,0,37570,,,,,,1,1,7.675441277,19038,9098,8762,336,3,333
17669,10490,9100,0,0,36128,,,,,,1,1,7.368365767,18444,8694,8398,296,3,293
17669,10889,10304,5,0,37285,,,,,,1,1,7.6369901129999995,19211,8883,8575,308,2,306
17669,10736,9657,2,2,35816,,,,,,1,1,7.754512387,18597,8458,8155,303,4,299
17669,9666,11616,2,0,37896,,,,,,1,1,7.733422808,19020,9270,8934,336,5,331
17669,9510,10899,0,0,37201,,,,,,1,1,7.632010664,18874,9003,8682,321,2,319
17669,9158,10676,0,0,36634,,,,,,1,1,7.513705014,19037,8642,8329,313,1,312
17669,11239,10795,2,0,34852,,,,,,1,1,7.061597809,18013,8256,7929,327,4,323
17669,10649,10812,0,2,36814,,,,,,1,1,7.570662636,18656,8929,8629,300,3,297
17669,10379,10400,2,0,32072,,,,,,1,1,6.558197721,16993,7412,7157,255,1,254
17669,10592,9509,2,0,36459,,,,,,1,1,7.433499816,18729,8703,8379,324,6,318
17669,9609,11629,2,0,32723,,,,,,1,1,6.750234144,17577,7432,7150,282,1,281
17669,9476,11230,0,2,34895,,,,,,1,1,7.276244844,18239,8175,7869,306,4,302
17669,9068,10875,0,3,35356,,,,,,1,1,7.233387247,18612,8227,7937,290,3,287
17669,10249,10018,0,4,36703,,,,,,1,1,7.53899954,18657,8875,8579,296,2,294
17669,10463,10971,0,2,36275,,,,,,1,1,7.483806088,18546,8703,8380,323,10,313
17669,12027,9539,0,0,34191,,,,,,1,1,7.107450603,17968,7963,7666,297,1,296
17669,11656,11235,1,0,36465,,,,,,1,1,7.397239818,18568,8773,8422,351,1,350
17669,10462,10129,4,2,37296,,,,,,1,1,7.552402782,18859,9066,8761,305,4,301
17669,10130,10455,2,2,37209,,,,,,1,1,7.553729748,19249,8828,8524,304,2,302
17669,10324,10933,1,2,36943,,,,,,1,1,7.543784385,18985,8816,8490,326,3,323
17669,10365,10221,0,2,36320,,,,,,1,1,7.505265398,18540,8750,8470,280,4,276
17669,9752,12383,0,0,37002,,,,,,1,1,7.555109326,18748,8958,8620,338,1,337
17669,11495,9126,3,2,35382,,,,,,1,1,7.229940732,18207,8440,8145,295,1,294
17669,10224,11254,3,0,35876,,,,,,1,1,7.300727762,18394,8570,8228,342,13,329
17669,10412,9028,4,2,37340,,,,,,1,1,7.688339178,19164,8944,8656,288,4,284
17669,8550,9701,0,2,36478,,,,,,1,1,7.382999099,19214,8499,8233,266,9,257
17669,10454,9687,4,1,38516,,,,,,1,1,7.830077598,19758,9207,8863,344,19,325
17669,10382,9607,2,0,35777,,,,,,1,1,7.581733269,18663,8399,8083,316,1,315
17669,11168,9780,4,0,38473,,,,,,1,1,7.857917178,19341,9397,9059,338,9,329
17669,8807,10122,0,2,35191,,,,,,1,1,7.452081672,18385,8265,7989,276,4,272
17669,10608,12107,2,2,33568,,,,,,1,1,6.847066144,17492,7850,7474,376,10,366
17669,10623,10684,2,1,37516,,,,,,1,1,7.8838261549999995,19061,9067,8746,321,7,314
17669,11260,11071,0,1,35841,,,,,,1,1,7.365326293,18366,8564,8217,347,4,343
17669,10796,11392,2,0,36340,,,,,,1,1,7.383508578,18518,8743,8407,336,3,333
17669,12068,10275,2,2,34265,,,,,,1,1,7.131036548,17866,8036,7709,327,1,326
17669,10382,10026,0,0,37178,,,,,,1,1,7.486349474,18866,9001,8691,310,2,308
17669,9667,11666,2,3,34852,,,,,,1,1,7.107993787,18309,8111,7790,321,8,313
17669,11588,10262,0,0,36119,,,,,,1,1,7.4339245290000004,18629,8583,8259,324,0,324
17669,9712,10758,1,2,36965,,,,,,1,1,7.498482665,18973,8839,8525,314,4,310
17669,10801,10537,4,1,34579,,,,,,1,1,7.042313001,18152,8055,7738,317,6,311
17669,9334,9937,2,2,36942,,,,,,1,1,7.482643971,18944,8869,8609,260,1,259
17669,10011,10511,0,0,37000,,,,,,1,1,7.465577338,18809,8942,8635,307,1,306
17669,9251,8511,3,0,38462,,,,,,1,1,7.827520133,19662,9270,9010,260,1,259
17669,11195,11020,0,4,36656,,,,,,1,1,7.47062787,19009,8655,8318,337,1,336
17669,7964,10771,0,0,37188,,,,,,1,1,7.514745746,19094,8899,8603,296,3,293
17669,9517,11718,0,0,37810,,,,,,1,1,7.626987406,18895,9303,8994,309,2,307
17669,10514,10369,0,2,38192,,,,,,1,1,7.739217685,19390,9233,8897,336,1,335
17669,10772,10447,0,0,34370,,,,,,1,1,6.983042072,17838,8098,7762,336,4,332
17669,11160,9551,3,0,35264,,,,,,1,1,7.149306329,18570,8203,7915,288,5,283
17669,9727,11423,0,2,34944,,,,,,1,1,7.117201046,18014,8322,8036,286,5,281
17669,9969,10162,4,5,37403,,,,,,1,1,7.619858503,19224,8937,8632,305,9,296
17669,10020,9149,2,0,37871,,,,,,1,1,7.760504912,19165,9193,8873,320,1,319
17669,9771,8009,0,0,38448,,,,,,1,1,8.032066839,19640,9275,9017,258,3,255
17669,10341,10864,4,0,38401,,,,,,1,1,7.700657715,19447,9299,8943,356,2,354
17669,8617,10954,0,0,36491,,,,,,1,1,7.442674118,18852,8678,8395,283,0,283
17669,11939,11787,0,0,32880,,,,,,1,1,6.741198712,17366,7592,7262,330,1,329
17669,10953,10056,0,2,36134,,,,,,1,1,7.442677866,18701,8563,8256,307,1,306
17669,10742,11036,2,0,34532,,,,,,1,1,7.059522012,18141,8040,7729,311,3,308
17669,10905,10413,2,0,36241,,,,,,1,1,7.350195624,18537,8697,8387,310,2,308
17669,8865,10287,0,0,37032,,,,,,1,1,7.773057304,19136,8808,8528,280,2,278
17669,12074,11958,2,2,32700,,,,,,1,1,6.693801973,17286,7522,7152,370,3,367
17669,9328,10888,0,4,36248,,,,,,1,1,7.344638088,18785,8590,8307,283,0,283
17669,9589,11362,0,4,35887,,,,,,1,1,7.483252781,18390,8590,8273,317,4,313
17669,9633,10889,2,0,34588,,,,,,1,1,7.122384973,18121,8093,7812,281,6,275
17669,11215,8866,2,0,36550,,,,,,1,1,7.451927396,18611,8821,8524,297,2,295
17669,11128,9233,1,0,35564,,,,,,1,1,7.339178102,18535,8361,8054,307,6,301
17669,10042,12784,2,0,33033,,,,,,1,1,6.815563483,17485,7613,7291,322,1,321
17669,10832,10742,0,2,36753,,,,,,1,1,7.546376639,18566,8939,8630,309,8,301
17669,10586,11291,0,4,36446,,,,,,1,1,7.578647386,18562,8776,8444,332,8,324
17669,9723,10928,2,0,34752,,,,,,1,1,7.217343483,18090,8178,7872,306,3,303
17669,11410,10390,0,0,36826,,,,,,1,1,7.555436457,18802,8846,8514,332,0,332
17669,11364,11093,2,3,36914,,,,,,1,1,7.502500882,18665,8951,8604,347,4,343
17669,10533,10043,3,2,36647,,,,,,1,1,7.504136772,18659,8849,8559,290,3,287
17669,9712,7907,0,0,38635,,,,,,1,1,7.866255192,19756,9313,9060,253,0,253
17669,9925,11312,0,1,36105,,,,,,1,1,7.289048661,18436,8663,8320,343,1,342
17669,10680,9779,2,0,36317,,,,,,1,1,7.556363006,18458,8772,8457,315,1,314
17669,8963,10282,0,2,34484,,,,,,1,1,6.977142755,18511,7869,7634,235,0,235
17669,9940,9956,0,0,36815,,,,,,1,1,7.613231198,18698,8909,8610,299,2,297
17669,11083,9956,0,2,35605,,,,,,1,1,7.364716932,18583,8357,8049,308,0,308
17669,11675,10708,2,2,35077,,,,,,1,1,7.316684457,18586,8087,7770,317,9,308
17669,10053,12397,4,2,34344,,,,,,1,1,7.167430534,17885,8049,7688,361,12,349
17669,9312,9402,0,4,36644,,,,,,1,1,7.513525747,19383,8495,8224,271,2,269
17669,12004,10408,2,2,33853,,,,,,1,1,7.238697736,17579,7965,7621,344,3,341
17669,10570,9536,2,2,37737,,,,,,1,1,8.042987495,19071,9175,8859,316,2,314
17669,9250,10740,0,2,37183,,,,,,1,1,7.593836545,18946,8963,8652,311,1,310
17669,10342,9789,3,0,36931,,,,,,1,1,7.794668085,18919,8849,8535,314,4,310
17669,10394,11395,0,0,34842,,,,,,1,1,7.315783066,18415,8063,7762,301,1,300
17669,10205,11107,2,4,35200,,,,,,1,1,7.491659839,18001,8451,8154,297,5,292
17669,9998,9898,0,0,35937,,,,,,1,1,7.52715995,18724,8469,8194,275,4,271
17669,8481,10554,0,0,37476,,,,,,1,1,8.063179356,18914,9143,8867,276,2,274
17669,10666,10952,0,6,37116,,,,,,1,1,7.843981607,18580,9097,8755,342,3,339
17669,8980,9279,2,2,38318,,,,,,1,1,8.061574178,19052,9493,9213,280,3,277
17669,11410,11224,2,2,35142,,,,,,1,1,7.449130703,18176,8302,7940,362,12,350
17669,10581,10804,2,2,35687,,,,,,1,1,7.499460709,18517,8424,8102,322,17,305
17669,11090,10446,0,2,36709,,,,,,1,1,7.57807907,18797,8773,8407,366,3,363
17669,8807,10608,0,0,35599,,,,,,1,1,7.762896269,18542,8386,8101,285,4,281
17669,11809,11276,0,2,34237,,,,,,1,1,7.377089583,17989,7969,7659,310,0,310
17669,10001,10400,2,0,37410,,,,,,1,1,7.956116283,18937,9086,8785,301,0,301
17669,11379,11149,2,0,34110,,,,,,1,1,7.288718292,17715,8040,7725,315,1,314
17669,11421,11684,5,0,35481,,,,,,1,1,7.627469823,18354,8390,8043,347,2,345
17669,10569,10610,0,0,37089,,,,,,1,1,7.681646856,18982,8894,8575,319,2,317
17669,10357,10320,5,0,37659,,,,,,1,1,8.118359714,18878,9245,8954,291,5,286
17669,11986,11379,0,0,35113,,,,,,1,1,7.476898414,18330,8196,7805,391,4,387
17669,9856,11465,0,1,35119,,,,,,1,1,7.54096998,18459,8172,7856,316,3,313
17669,10974,9646,2,2,38422,,,,,,1,1,7.859323846,19600,9248,8922,326,4,322
17669,9126,12103,0,5,35192,,,,,,1,1,7.635929803,18499,8191,7880,311,10,301
17669,10574,11205,2,0,35001,,,,,,1,1,7.407807701,18321,8181,7863,318,4,314
17669,9539,9964,2,2,35550,,,,,,1,1,7.630784823,18482,8381,8075,306,4,302
17669,11241,11245,0,2,35596,,,,,,1,1,7.415994192,18418,8409,8049,360,7,353
17669,9387,11315,0,0,34540,,,,,,1,1,7.239851496,17775,8242,7961,281,2,279
17669,10258,10613,0,0,37636,,,,,,1,1,7.803189879,19061,9125,8800,325,1,324
17669,9572,10906,0,2,37257,,,,,,1,1,8.087512551,18957,8994,8682,312,3,309
17669,8175,11577,2,5,36738,,,,,,1,1,7.9259862089999995,18856,8785,8473,312,7,305
17669,10716,9284,0,0,35908,,,,,,1,1,7.40618335,18643,8479,8172,307,3,304
17669,10636,10744,1,4,37112,,,,,,1,1,7.966596291,18626,9073,8733,340,20,320
17669,10940,12190,0,0,33305,,,,,,1,1,7.051065386,17398,7785,7448,337,1,336
17669,10576,9802,1,0,35041,,,,,,1,1,7.709118513,18355,8197,7905,292,0,292
17669,10078,9989,0,0,35132,,,,,,1,1,7.449308811,18451,8199,7916,283,1,282
17669,9995,10545,2,2,36635,,,,,,1,1,7.557908088,18887,8719,8409,310,6,304
17669,9258,11466,0,2,36294,,,,,,1,1,7.375785671,18440,8766,8444,322,7,315
17669,9070,9613,1,0,36450,,,,,,1,1,7.478354719,19009,8553,8218,335,3,332
17669,10826,9781,2,0,37741,,,,,,1,1,7.702569183,19128,9147,8828,319,2,317
17669,10361,10260,2,2,35405,,,,,,1,1,7.561810468,18024,8547,8260,287,6,281
17669,12037,10502,2,4,37474,,,,,,1,1,7.627004091,18700,9206,8844,362,1,361
17669,10431,11336,0,4,36400,,,,,,1,1,7.698795612,18550,8759,8427,332,5,327
17669,10374,9215,2,0,38086,,,,,,1,1,7.675212106,19550,9124,8836,288,2,286
17669,10378,9698,0,0,36859,,,,,,1,1,7.951242353,19079,8738,8434,304,0,304
17669,9453,9795,0,0,36308,,,,,,1,1,7.503253365,18925,8547,8258,289,4,285
17669,10183,10549,2,0,36589,,,,,,1,1,7.630430453,18887,8686,8356,330,4,326
17669,10289,9441,0,0,35494,,,,,,1,1,7.398565488,18788,8206,7912,294,5,289
17669,10030,11147,0,2,39022,,,,,,1,1,7.881067386,19462,9608,9264,344,8,336
17669,11929,12353,0,2,34739,,,,,,1,1,7.244578459,17971,8198,7826,372,0,372
17669,9104,9819,0,2,37274,,,,,,1,1,7.728262213,18946,9021,8735,286,1,285
17669,10848,11286,0,0,34337,,,,,,1,1,7.127545225,17591,8201,7857,344,2,342
17669,9853,11481,0,0,35166,,,,,,1,1,7.366635637,18346,8242,7906,336,3,333
17669,9137,10221,3,0,36293,,,,,,1,1,7.668537486,18672,8674,8401,273,4,269
17669,10500,11177,0,0,36065,,,,,,1,1,7.7017052,18305,8710,8370,340,3,337
17669,9706,10698,2,0,36613,,,,,,1,1,7.5738306699999995,18697,8800,8484,316,8,308
17669,10797,10597,0,4,35958,,,,,,1,1,7.34584659,18236,8707,8399,308,6,302
17669,10085,11023,2,2,34667,,,,,,1,1,7.20588497,18209,8063,7731,332,4,328
17669,10588,9348,4,2,38557,,,,,,1,1,8.091542699,19563,9342,9032,310,5,305
17669,9549,11648,2,0,35387,,,,,,1,1,7.452577911,18359,8358,8046,312,6,306
17669,10521,9685,0,0,36523,,,,,,1,1,7.534912649,18476,8854,8515,339,4,335
17669,10386,10814,0,0,34260,,,,,,1,1,7.028523726,17873,8043,7742,301,3,298
17669,8957,10269,0,0,36444,,,,,,1,1,7.545725347,18870,8637,8337,300,2,298
17669,8813,10486,0,4,36919,,,,,,1,1,7.509992157,18954,8844,8567,277,8,269
17669,10797,9107,2,0,36066,,,,,,1,1,7.562708786,18644,8565,8273,292,2,290
17669,10298,9615,2,0,35563,,,,,,1,1,7.474109758,18351,8462,8174,288,2,286
17669,8779,9262,0,3,38859,,,,,,1,1,8.075478588,19558,9527,9280,247,1,246
17669,9976,10953,0,2,36346,,,,,,1,1,7.689837887,18712,8651,8319,332,11,321
17669,11269,10957,0,0,35143,,,,,,1,1,7.284430719,18162,8315,7964,351,3,348
17669,11228,9217,3,0,35505,,,,,,1,1,7.428789313,18773,8240,7988,252,0,252
17669,10229,9893,2,0,35943,,,,,,1,1,7.432758509,18655,8490,8182,308,2,306
17669,11326,11010,1,1,35583,,,,,,1,1,7.5301417619999995,18231,8516,8196,320,0,320
17669,10407,9901,0,0,36655,,,,,,1,1,7.858071233,18883,8723,8397,326,1,325
17669,9981,11955,0,0,35732,,,,,,1,1,7.383091699,18098,8649,8313,336,3,333
17669,10423,10075,0,0,35585,,,,,,1,1,7.567684651,18040,8610,8285,325,0,325
17669,9888,11664,0,4,36108,,,,,,1,1,7.674394668,18537,8614,8271,343,18,325
17669,10571,10997,0,3,35519,,,,,,1,1,7.893305876,18388,8393,8048,345,10,335
17669,10422,10382,2,0,36058,,,,,,1,1,7.399644585,18666,8540,8228,312,2,310
17669,11081,10948,0,0,34815,,,,,,1,1,7.514193376,18038,8225,7898,327,2,325
17669,12263,10516,2,2,33965,,,,,,1,1,7.338291288,17715,7950,7600,350,3,347
17669,10892,12425,6,2,36163,,,,,,1,1,7.631669436,18140,8818,8431,387,6,381
17669,9519,11657,0,4,34529,,,,,,1,1,7.478947046,17661,8291,8005,286,7,279
17669,9878,10271,0,0,36227,,,,,,1,1,7.617465353,18759,8588,8296,292,2,290
17669,10204,11516,0,0,34747,,,,,,1,1,7.4417029679999995,17977,8217,7881,336,6,330
17669,11156,9635,0,2,35563,,,,,,1,1,7.464607059,18118,8580,8295,285,2,283
17669,10496,9551,2,0,35869,,,,,,1,1,7.586649719,18627,8465,8153,312,5,307
17669,10872,10859,0,0,37995,,,,,,1,1,7.822835613,19324,9166,8827,339,0,339
17669,9507,11301,3,2,35884,,,,,,1,1,7.886479043,18580,8501,8199,302,2,300
17669,10689,8501,2,0,35994,,,,,,1,1,8.427595616,18841,8445,8182,263,2,261
17669,8993,10510,0,3,38609,,,,,,1,1,8.76828928,19404,9451,9148,303,1,302
17669,11109,10922,0,4,36947,,,,,,1,1,8.324731996,18576,9009,8656,353,1,352
17669,11143,10930,2,5,38226,,,,,,1,1,8.521613168,19097,9388,9035,353,9,344
17669,11988,10910,2,2,34725,,,,,,1,1,7.129469533,18077,8153,7811,342,1,341
17669,10013,10479,0,2,35422,,,,,,1,1,7.59634807,18317,8405,8110,295,4,291
17669,9504,10335,0,0,35861,,,,,,1,1,7.463849618,18896,8349,8082,267,1,266
17669,11581,10289,0,2,35693,,,,,,1,1,7.617166421,18275,8546,8220,326,6,320
17669,12215,10297,1,0,35802,,,,,,1,1,7.654610165,18454,8510,8182,328,2,326
17669,10942,8966,2,0,37978,,,,,,1,1,7.918730791,19119,9269,8948,321,2,319
17669,9548,10312,0,0,35486,,,,,,1,1,7.312297546,18558,8314,8014,300,3,297
17669,10166,11523,4,0,36557,,,,,,1,1,7.801429541,18661,8780,8444,336,9,327
17669,12439,10177,2,4,36234,,,,,,1,1,7.586663319,18791,8528,8141,387,2,385
17669,11629,9182,2,0,35906,,,,,,1,1,7.375141115,18567,8516,8209,307,4,303
17669,11025,11342,2,4,35888,,,,,,1,1,7.350464577,18455,8547,8208,339,0,339
17669,10405,9700,0,0,35957,,,,,,1,1,7.676903009,18329,8673,8391,282,3,279
17669,11305,10271,0,1,36406,,,,,,1,1,7.420229927,18901,8589,8262,327,0,327
17669,9906,9229,0,4,36061,,,,,,1,1,7.797537626,18819,8485,8213,272,4,268
17669,9877,10511,0,0,36338,,,,,,1,1,7.732954885,18866,8602,8334,268,1,267
17669,11065,9689,6,2,37368,,,,,,1,1,7.858379278,19042,9012,8710,302,1,301
17669,10746,10684,0,2,34817,,,,,,1,1,7.182290685,18024,8238,7921,317,2,315
17669,8651,9773,0,0,37501,,,,,,1,1,7.626609743,19368,8927,8648,279,0,279
17669,10899,11419,0,3,35380,,,,,,1,1,7.421059,18286,8371,8019,352,5,347
17669,10800,10463,0,0,37600,,,,,,1,1,7.937976723,19103,9082,8749,333,1,332
17669,10271,8485,0,0,38445,,,,,,1,1,7.960645245,19271,9450,9176,274,3,271
17669,9992,11027,0,4,36372,,,,,,1,1,7.528217131,18537,8761,8448,313,2,311
17669,11928,10346,0,0,35622,,,,,,1,1,7.683441138,18322,8480,8140,340,2,338
17669,10686,9868,0,0,36675,,,,,,1,1,7.565854781,18952,8727,8458,269,3,266
17669,10318,11897,0,0,36265,,,,,,1,1,7.681121551,18456,8751,8444,307,1,306
17669,10196,11549,0,0,35066,,,,,,1,1,7.178117896,18321,8214,7897,317,4,313
17669,12050,11520,2,0,37086,,,,,,1,1,7.603814466,18940,8888,8518,370,3,367
17669,10653,9786,2,0,37860,,,,,,1,1,7.632832474,18980,9273,8939,334,5,329
17669,10281,10371,4,2,35576,,,,,,1,1,7.319906932,18572,8357,8067,290,5,285
17669,10816,11752,0,2,34810,,,,,,1,1,7.20579231,18067,8207,7878,329,0,329
17669,10144,11447,2,0,35649,,,,,,1,1,7.510078277,18146,8598,8291,307,4,303
17669,9894,10428,0,0,36841,,,,,,1,1,7.736675082,18496,9036,8763,273,3,270
17669,10970,10154,2,2,35768,,,,,,1,1,7.444025285,18266,8584,8250,334,13,321
17669,10566,9857,2,0,35580,,,,,,1,1,7.274017836,18381,8442,8127,315,2,313
17669,10406,10687,2,3,35745,,,,,,1,1,7.256441895,18227,8612,8318,294,7,287
17669,10617,10554,2,0,34815,,,,,,1,1,7.107212568,18206,8146,7829,317,6,311
17669,11632,12593,2,3,34610,,,,,,1,1,7.057929951,17463,8400,8053,347,1,346
17669,9008,8830,0,0,37970,,,,,,1,1,7.847944502,19322,9181,8895,286,2,284
17669,10521,10477,1,0,35089,,,,,,1,1,7.616235393,18491,8159,7879,280,2,278
17669,9362,11702,4,0,35493,,,,,,1,1,7.32326186,17984,8594,8273,321,13,308
17669,12093,9923,0,0,35341,,,,,,1,1,7.358292892,18343,8329,7989,340,2,338
17669,10236,10833,0,2,36016,,,,,,1,1,7.471003209,18714,8496,8186,310,5,305
17669,11125,10237,2,2,38787,,,,,,1,1,8.085213986,19341,9555,9219,336,4,332
17669,11511,9656,0,4,33630,,,,,,1,1,6.922471196,17688,7841,7581,260,4,256
17669,11101,10576,0,0,35381,,,,,,1,1,7.445226739,18162,8448,8125,323,3,320
17669,12200,10531,4,3,34533,,,,,,1,1,7.308919921,17754,8224,7893,331,11,320
17669,12078,10376,0,2,35529,,,,,,1,1,7.49100273,18138,8535,8214,321,4,317
17669,10866,11704,6,2,34826,,,,,,1,1,7.236464812,18037,8218,7865,353,12,341
17669,10826,9259,0,4,36565,,,,,,1,1,7.493859106,18565,8856,8568,288,3,285
17669,10687,9102,0,0,36406,,,,,,1,1,7.561094997,18543,8782,8483,299,3,296
17669,11049,11201,2,0,33793,,,,,,1,1,6.954802565,17855,7822,7528,294,2,292
17669,11498,9826,2,0,35975,,,,,,1,1,7.452180362,18307,8675,8357,318,3,315
17669,11214,9860,4,2,34880,,,,,,1,1,7.276432872,18182,8178,7836,342,13,329
17669,9823,10518,0,0,33599,,,,,,1,1,7.026588062,17883,7720,7444,276,1,275
17669,10436,10417,0,0,36641,,,,,,1,1,7.595892213,18516,8909,8602,307,1,306
17669,11103,11620,0,2,35678,,,,,,1,1,7.292943347,18142,8597,8255,342,1,341
17669,9228,10249,0,1,36098,,,,,,1,1,7.538403035,18789,8522,8257,265,0,265
17669,10819,10415,0,1,32993,,,,,,1,1,6.911428821,17591,7547,7239,308,3,305
17669,10733,10136,3,0,36899,,,,,,1,1,7.601116009,19011,8789,8479,310,6,304
17669,11192,9441,0,2,35665,,,,,,1,1,7.306866978,18410,8475,8170,305,2,303
17669,8738,10186,0,1,37959,,,,,,1,1,7.910431044,19390,9151,8884,267,3,264
17669,10423,11005,0,0,35091,,,,,,1,1,7.253472762,18145,8320,8014,306,2,304
17669,9543,9257,0,0,36587,,,,,,1,1,7.696218164,18765,8769,8485,284,2,282
17669,10280,11315,4,0,37106,,,,,,1,1,7.673611175,18962,8904,8568,336,7,329
17669,11273,10986,0,3,34988,,,,,,1,1,7.177244353,18180,8239,7909,330,2,328
17669,10869,10321,0,0,35386,,,,,,1,1,7.276992921,18391,8331,7998,333,5,328
17669,10374,10100,0,1,36929,,,,,,1,1,7.66436665,18961,8835,8537,298,2,296
17669,10609,10691,1,4,35724,,,,,,1,1,7.4556457609999995,18470,8473,8165,308,2,306
17669,12091,10650,2,6,37887,,,,,,1,1,7.879808099,18743,9378,8990,388,18,370
17669,10379,10159,4,0,37707,,,,,,1,1,7.613996064,19301,9043,8723,320,0,320
17669,10767,12055,0,0,38472,,,,,,1,1,8.027796988,19041,9532,9165,367,3,364
17669,9456,10514,0,0,37763,,,,,,1,1,7.824371226,19189,9126,8804,322,4,318
17669,11241,10997,2,4,36179,,,,,,1,1,7.4801753269999995,18651,8603,8281,322,2,320
17669,10991,11895,0,4,33778,,,,,,1,1,7.241452852,17558,7935,7585,350,5,345
17669,11353,10890,2,2,35138,,,,,,1,1,7.180993322,18191,8313,7992,321,3,318
17669,10063,11333,1,0,36988,,,,,,1,1,7.584974374,18849,8889,8528,361,1,360
17669,10194,11753,0,0,36661,,,,,,1,1,7.41701365,18689,8818,8482,336,3,333
17669,10726,10317,2,2,35305,,,,,,1,1,7.178890601,18242,8375,8062,313,2,311
17669,8687,10486,0,2,37965,,,,,,1,1,7.798009803,18993,9338,9042,296,4,292
17669,10410,12358,4,2,36347,,,,,,1,1,7.4600202939999996,18616,8670,8279,391,13,378
17669,9848,11027,0,0,36454,,,,,,1,1,7.663766666,18605,8780,8491,289,1,288
17669,10586,9600,0,0,35416,,,,,,1,1,7.404436403,18694,8219,7935,284,3,281
17669,10280,9746,0,2,36606,,,,,,1,1,7.663711989,18730,8787,8485,302,2,300
17669,9471,10492,2,2,36993,,,,,,1,1,7.447224305,18874,8910,8611,299,1,298
17669,11478,10591,0,4,36506,,,,,,1,1,7.580640861,18311,8934,8607,327,4,323
17669,10803,9932,0,4,35800,,,,,,1,1,7.403776694,18769,8373,8088,285,2,283
17669,12277,9380,0,0,35727,,,,,,1,1,7.264093288,18646,8375,8044,331,3,328
17669,10779,9900,3,0,35565,,,,,,1,1,7.518048053,18456,8403,8100,303,1,302
17669,11707,11202,0,0,33911,,,,,,1,1,6.877237663,17890,7858,7553,305,3,302
17669,11528,10461,2,4,35121,,,,,,1,1,7.2957749,17809,8503,8197,306,2,304
17669,9758,10627,0,2,35285,,,,,,1,1,7.4052929259999996,18382,8317,8048,269,3,266
17669,10730,10700,4,4,35009,,,,,,1,1,7.092103882,18228,8242,7945,297,4,293
17669,9803,8757,0,0,38794,,,,,,1,1,8.023002349,19362,9570,9278,292,1,291
17669,10082,9496,2,1,34751,,,,,,1,1,7.435223283,18224,8131,7866,265,13,252
17669,9466,9714,0,0,37760,,,,,,1,1,7.871489301,19164,9151,8857,294,0,294
17669,9494,10974,2,1,34275,,,,,,1,1,7.411522954,17861,8053,7745,308,6,302
17669,11099,10691,6,0,32946,,,,,,1,1,6.882302301,17300,7672,7370,302,9,293
17669,9860,11233,0,2,35549,,,,,,1,1,7.239763673,18402,8413,8092,321,1,320
17669,10496,10439,1,1,35760,,,,,,1,1,7.299317919,18646,8403,8095,308,4,304
17669,10970,10100,4,2,36420,,,,,,1,1,7.523321241,18412,8844,8524,320,3,317
17669,10826,10937,1,0,35680,,,,,,1,1,7.434827391,18820,8255,7905,350,2,348
17669,9748,9048,0,4,35876,,,,,,1,1,7.492588378,18956,8317,8031,286,11,275
17669,10162,8765,2,0,35273,,,,,,1,1,7.201973559,18268,8366,8093,273,4,269
17669,10359,11804,1,0,33494,,,,,,1,1,7.201890059,17654,7757,7431,326,1,325
17669,9913,11662,0,1,37606,,,,,,1,1,7.6764069710000005,18813,9227,8888,339,2,337
17669,10708,9802,3,2,36522,,,,,,1,1,7.499364601,18445,8880,8563,317,6,311
17669,9830,10828,2,0,33994,,,,,,1,1,7.065471753,18303,7701,7412,289,4,285
17669,8555,10889,0,0,37359,,,,,,1,1,7.637814856,19068,8990,8679,311,10,301
17669,11230,10017,0,0,35813,,,,,,1,1,7.438131672,18573,8461,8143,318,4,314
17669,10152,10133,0,2,36185,,,,,,1,1,7.434361644,18735,8579,8287,292,3,289
17669,10715,9479,0,2,36624,,,,,,1,1,7.430611521,19092,8608,8292,316,6,310
17669,9961,11595,3,2,35748,,,,,,1,1,7.437726909,18417,8524,8241,283,2,281
17669,11046,11070,0,1,35519,,,,,,1,1,7.279273593,18219,8473,8119,354,1,353
17669,10141,9952,3,0,36097,,,,,,1,1,7.30437791,18495,8643,8327,316,5,311
17669,9328,10015,0,1,36273,,,,,,1,1,7.414525447,18797,8592,8300,292,1,291
17669,10680,10195,0,0,35130,,,,,,1,1,7.109328349,18438,8195,7893,302,0,302
17669,9501,10378,1,0,39751,,,,,,1,1,8.247774317,19741,9835,9495,340,1,339
17669,10290,8099,0,0,36606,,,,,,1,1,7.543410948,18740,8802,8540,262,0,262
17669,10878,10426,2,2,34389,,,,,,1,1,7.167695481,17751,8145,7797,348,14,334
17669,10126,12825,0,2,32050,,,,,,1,1,6.5531827,17431,7154,6843,311,1,310
17669,10164,10874,3,1,38458,,,,,,1,1,7.933201625,19478,9320,8980,340,14,326
17669,10944,12054,2,0,32700,,,,,,1,1,6.729018884,17479,7460,7159,301,0,301
17669,9961,11494,2,0,33578,,,,,,1,1,7.201379753,17309,7988,7695,293,1,292
17669,11607,12176,1,0,34765,,,,,,1,1,7.168086157,18171,8114,7748,366,4,362
17669,9211,10362,2,0,37713,,,,,,1,1,7.737282308,19112,9161,8882,279,2,277
17669,11147,11267,0,0,37172,,,,,,1,1,7.669863482,18731,9059,8736,323,1,322
17669,11088,10901,1,3,36379,,,,,,1,1,7.456894624,18454,8797,8466,331,2,329
17669,11092,10848,2,0,36317,,,,,,1,1,7.746060974,18853,8574,8258,316,1,315
17669,8287,11605,0,2,36770,,,,,,1,1,7.46893369,18773,8849,8550,299,9,290
17669,10169,10384,0,1,36378,,,,,,1,1,7.47996166,18746,8639,8285,354,0,354
17669,8487,9844,0,3,38462,,,,,,1,1,7.870546374,19469,9355,9072,283,3,280
17669,9280,10307,0,4,38438,,,,,,1,1,7.944809847,19244,9444,9138,306,3,303
17669,10852,9485,4,0,36024,,,,,,1,1,7.53132152,18635,8556,8279,277,3,274
17669,10024,8202,2,0,37962,,,,,,1,1,8.161045488,19355,9159,8870,289,7,282
17669,11186,10163,0,0,37883,,,,,,1,1,7.697764628,19407,9074,8746,328,2,326
17669,9177,10075,2,0,35296,,,,,,1,1,7.368448675,18346,8344,8082,262,3,259
17669,10812,12330,0,4,36592,,,,,,1,1,7.5358262719999995,18720,8763,8417,346,8,338
17669,12825,10920,7,0,36336,,,,,,1,1,7.514965183,18343,8807,8428,379,10,369
17669,11071,8738,0,0,36948,,,,,,1,1,7.872581162,18760,8939,8629,310,3,307
17669,10297,10871,0,3,35310,,,,,,1,1,7.317481927,18424,8296,8002,294,1,293
17669,11003,8909,2,0,37223,,,,,,1,1,7.586057667,18990,8971,8680,291,2,289
17669,10210,9359,3,2,37338,,,,,,1,1,7.69881884,18994,9031,8749,282,6,276
17669,9510,11635,0,2,36535,,,,,,1,1,7.457494863,18889,8653,8313,340,3,337
17669,9968,8507,2,0,35524,,,,,,1,1,7.388538355,18233,8501,8212,289,4,285
17669,11681,10816,4,3,36161,,,,,,1,1,7.326003797,18291,8756,8398,358,17,341
17669,9973,9138,4,0,35478,,,,,,1,1,7.237930508,18348,8446,8208,238,2,236
17669,10937,9791,0,0,35350,,,,,,1,1,7.276946843,18463,8299,8010,289,0,289
17669,9544,11344,2,2,35874,,,,,,1,1,7.449149651,18702,8427,8109,318,1,317
17669,9838,9070,2,2,35820,,,,,,1,1,7.30437518,18682,8416,8110,306,20,286
17669,10446,9804,2,0,37248,,,,,,1,1,7.550752225,19093,8931,8638,293,8,285
17669,10999,9018,3,0,36525,,,,,,1,1,7.560486221,19218,8502,8199,303,2,301
17669,10663,10483,2,0,38038,,,,,,1,1,7.626716956,19317,9181,8822,359,4,355
17669,9943,11656,0,1,36202,,,,,,1,1,7.429841832,18409,8727,8388,339,1,338
17669,9507,10574,0,2,38637,,,,,,1,1,8.03409838,19557,9391,9093,298,5,293
17669,10791,10197,0,0,37580,,,,,,1,1,7.601219844,18961,9134,8783,351,1,350
17669,11573,8990,0,1,36977,,,,,,1,1,7.548199186,18757,8962,8666,296,2,294
17669,11027,11095,0,0,32581,,,,,,1,1,6.788251369,17032,7613,7290,323,1,322
17669,11312,11156,2,2,34444,,,,,,1,1,7.133516274,17817,8132,7769,363,2,361
17669,10260,11553,0,0,35726,,,,,,1,1,7.621161008,18371,8506,8163,343,3,340
17669,11337,8526,2,1,37404,,,,,,1,1,7.592501406,18933,9094,8811,283,2,281
17669,11716,9612,0,2,36944,,,,,,1,1,7.762085652,18249,9180,8845,335,3,332
17669,9324,11229,4,0,33641,,,,,,1,1,6.880785395,17738,7811,7530,281,5,276
17669,10107,10496,2,0,34555,,,,,,1,1,7.3670398200000005,18049,8107,7815,292,7,285
17669,11814,10124,3,0,38036,,,,,,1,1,7.872341793,18778,9452,9098,354,4,350
17669,11324,9101,3,0,36942,,,,,,1,1,7.551058652,18994,8832,8548,284,0,284
17669,10927,10069,0,0,36242,,,,,,1,1,7.365791593,18590,8677,8379,298,2,296
17669,10102,10412,0,0,36809,,,,,,1,1,7.6773179030000005,19076,8703,8376,327,1,326
17669,10785,11515,2,2,34719,,,,,,1,1,7.271425385,17725,8340,8026,314,0,314
17669,9721,9170,2,0,36887,,,,,,1,1,7.523989105,19082,8759,8472,287,16,271
17669,9411,11974,0,0,35104,,,,,,1,1,7.181390761,18296,8236,7900,336,3,333
17669,11393,10831,2,0,33422,,,,,,1,1,6.994408298,17427,7850,7555,295,0,295
17669,12429,11604,2,0,35528,,,,,,1,1,7.281170764,18030,8570,8212,358,0,358
17669,11250,10590,2,0,35636,,,,,,1,1,7.220012699,18404,8457,8139,318,3,315
17669,9102,10464,0,2,37849,,,,,,1,1,7.649220058,19065,9245,8951,294,2,292
17669,10951,9302,1,0,35761,,,,,,1,1,7.303619204,18221,8629,8347,282,2,280
17669,10349,11609,2,0,36392,,,,,,1,1,7.354848398,18372,8840,8500,340,0,340
17669,10733,10585,0,2,36349,,,,,,1,1,7.424415786,18656,8690,8377,313,5,308
17669,11271,10780,0,0,35979,,,,,,1,1,7.484817938,18416,8608,8261,347,5,342
17669,11407,12042,2,1,36434,,,,,,1,1,7.43027125,18424,8803,8399,404,14,390
17669,10598,9623,0,0,34871,,,,,,1,1,7.29711707,18411,8087,7801,286,2,284
17669,10549,9468,2,4,36536,,,,,,1,1,7.480923809,19006,8619,8327,292,3,289
17669,9690,10568,4,0,35531,,,,,,1,1,7.452567745,18435,8402,8110,292,1,291
17669,10938,10694,0,2,34209,,,,,,1,1,6.971110888,17823,8045,7749,296,6,290
17669,10012,10814,6,2,35227,,,,,,1,1,7.298327238,18091,8415,8109,306,11,295
17669,9878,9736,7,2,35528,,,,,,1,1,7.393279239,18551,8355,8088,267,4,263
17669,10826,10280,0,3,36084,,,,,,1,1,7.487490854,18545,8621,8324,297,2,295
17669,11683,10765,2,0,34911,,,,,,1,1,7.096875204,18022,8283,7960,323,1,322
17669,10521,11357,4,0,35786,,,,,,1,1,7.521951995,18310,8583,8273,310,2,308
17669,9633,10520,2,2,36186,,,,,,1,1,7.34053551,18866,8512,8216,296,10,286
17669,10098,9364,0,2,36590,,,,,,1,1,7.571887687,19009,8647,8360,287,7,280
17669,10382,10766,2,2,36172,,,,,,1,1,7.416856429,18449,8697,8368,329,4,325
17669,10951,10414,0,1,35729,,,,,,1,1,7.350509926,18556,8427,8108,319,2,317
17669,11526,11197,0,0,34740,,,,,,1,1,7.130069056,17547,8424,8079,345,1,344
17669,11635,10319,0,0,33713,,,,,,1,1,7.021266406,17692,7860,7559,301,1,300
17669,11837,11020,0,2,34668,,,,,,1,1,7.15766886,17963,8206,7913,293,5,288
17669,10200,10546,0,0,37697,,,,,,1,1,7.8345422750000004,19281,9042,8710,332,1,331
17669,10539,11483,0,0,34709,,,,,,1,1,7.231191331,18122,8138,7827,311,1,310
17669,8873,9408,1,2,37319,,,,,,1,1,7.844524273,19230,8916,8659,257,1,256
17669,10788,9178,0,3,36066,,,,,,1,1,7.482268196,18579,8603,8322,281,7,274
17669,9110,10144,0,0,38571,,,,,,1,1,7.863159016,19001,9632,9326,306,3,303
17669,10127,10818,0,4,36278,,,,,,1,1,7.573887058,18947,8512,8205,307,2,305
17669,11478,8803,2,0,35329,,,,,,1,1,7.1816316669999996,18242,8386,8071,315,0,315
17669,9570,11076,2,0,34739,,,,,,1,1,7.05257576,18162,8133,7822,311,0,311
17669,9276,11403,0,0,37315,,,,,,1,1,7.593063388,18990,9003,8684,319,2,317
17669,9812,10591,0,0,35663,,,,,,1,1,7.383384924,18791,8294,8010,284,2,282
17669,11809,9792,0,2,36996,,,,,,1,1,7.492693664,19069,8796,8461,335,7,328
17669,12479,11269,2,0,35668,,,,,,1,1,7.241830538,18050,8612,8218,394,3,391
17669,11156,11303,0,3,32977,,,,,,1,1,6.878598739,17210,7726,7411,315,0,315
17669,10598,9873,2,0,34369,,,,,,1,1,7.215060585,17935,8063,7755,308,2,306
17669,9572,9736,0,0,38846,,,,,,1,1,7.952031763,19413,9560,9247,313,4,309
17669,7981,8355,0,0,39498,,,,,,1,1,8.157917714,19977,9625,9354,271,2,269
17669,10328,9710,0,0,37728,,,,,,1,1,7.759579325,19095,9154,8829,325,5,320
17669,11089,11550,0,4,35634,,,,,,1,1,7.378443588,18498,8399,8061,338,7,331
17669,7995,9070,4,2,36981,,,,,,1,1,7.719022897,18977,8892,8672,220,3,217
17669,11008,10070,0,2,38843,,,,,,1,1,8.190723395,19310,9590,9237,353,4,349
17669,10544,8425,0,0,35856,,,,,,1,1,7.555463398,18326,8632,8366,266,8,258
17669,9319,10977,0,4,36573,,,,,,1,1,7.563653088,19012,8613,8278,335,3,332
17669,10708,9109,6,4,35030,,,,,,1,1,7.229478386,18027,8387,8158,229,6,223
17669,9886,11871,0,4,36073,,,,,,1,1,7.299055046,18613,8562,8226,336,2,334
17669,10817,11974,0,4,35631,,,,,,1,1,7.381462378,18053,8620,8282,338,6,332
17669,10355,10827,2,4,35462,,,,,,1,1,7.349189908,18466,8344,8036,308,4,304
17669,8455,9958,2,2,36752,,,,,,1,1,7.493861101,18998,8746,8484,262,2,260
17669,10777,9572,0,0,35370,,,,,,1,1,7.348958026,18427,8327,8038,289,4,285
17669,9136,9123,2,1,38930,,,,,,1,1,7.853508359,19809,9397,9070,327,5,322
17669,10702,10720,4,1,37014,,,,,,1,1,7.813453459,18672,8993,8637,356,18,338
17669,12246,9655,4,0,37737,,,,,,1,1,7.744947804,19073,9168,8840,328,4,324
17669,9393,7828,0,0,38274,,,,,,1,1,8.155163108,19363,9331,9082,249,3,246
17669,9018,10203,4,0,38458,,,,,,1,1,7.838857292,19406,9378,9082,296,2,294
17669,11437,11097,4,2,34819,,,,,,1,1,7.041217518,18212,8119,7750,369,2,367
17669,11615,10714,0,0,37264,,,,,,1,1,7.767903302,18909,9001,8648,353,1,352
17669,10016,10626,5,2,35676,,,,,,1,1,7.351036081,18685,8351,8062,289,13,276
17669,10765,11042,0,2,36956,,,,,,1,1,7.610499628,18685,8966,8627,339,2,337
17669,11578,11298,2,0,35189,,,,,,1,1,7.24283832,18430,8192,7817,375,12,363
17669,9953,10013,0,5,37698,,,,,,1,1,7.703549401,19319,9039,8738,301,5,296
17669,9737,9330,0,0,37871,,,,,,1,1,7.816123611,19277,9150,8856,294,1,293
17669,9047,10326,0,0,35820,,,,,,1,1,7.319325048,18396,8569,8283,286,0,286
17669,10364,9734,0,0,35173,,,,,,1,1,7.244934154,18372,8256,7967,289,3,286
17669,9377,11126,0,0,36512,,,,,,1,1,7.8620431459999995,18628,8780,8456,324,2,322
17669,9851,10557,2,0,35249,,,,,,1,1,7.461876457,18354,8317,8056,261,0,261
17669,10306,10725,4,0,35693,,,,,,1,1,7.553588752,18493,8427,8081,346,9,337
17669,10063,10085,2,2,37440,,,,,,1,1,7.749038774,19160,8983,8669,314,3,311
17669,11195,9372,0,2,34530,,,,,,1,1,7.227138099,18089,8071,7772,299,11,288
17669,9667,9498,0,4,36459,,,,,,1,1,7.583110184,18970,8603,8320,283,0,283
17669,11205,10971,0,2,35673,,,,,,1,1,7.627353231,17777,8772,8420,352,6,346
17669,8674,11416,0,2,37597,,,,,,1,1,7.653786166,19045,9131,8841,290,5,285
17669,10572,10050,0,2,35528,,,,,,1,1,7.233796429,18504,8369,8083,286,3,283
17669,11167,10821,0,3,33786,,,,,,1,1,7.043314942,17935,7750,7399,351,0,351
17669,9218,10993,2,4,34439,,,,,,1,1,7.167062003,18248,7950,7659,291,3,288
17669,10876,9332,0,0,35078,,,,,,1,1,7.390090019,18286,8244,7940,304,1,303
17669,9339,10759,0,0,35173,,,,,,1,1,7.227100306,18386,8247,7954,293,2,291
17669,10578,9485,4,2,36995,,,,,,1,1,7.696028862,18995,8844,8532,312,3,309
17669,11026,10104,2,3,34708,,,,,,1,1,7.192413435,18121,8133,7812,321,3,318
17669,10423,10768,0,0,36693,,,,,,1,1,7.628707314,18510,8944,8649,295,0,295
17669,10017,10096,0,4,38478,,,,,,1,1,7.8682515219999996,19690,9241,8935,306,0,306
17669,8269,10987,0,2,37014,,,,,,1,1,7.555305482,19046,8853,8591,262,2,260
17669,11051,10122,0,0,36174,,,,,,1,1,7.579478168,18397,8723,8392,331,5,326
17669,10622,9636,2,2,37657,,,,,,1,1,7.586521597,19367,8999,8707,292,11,281
17669,10634,9222,2,0,39581,,,,,,1,1,8.143034361,19899,9681,9361,320,0,320
17669,10333,10046,2,0,34893,,,,,,1,1,7.5106034170000004,18268,8160,7855,305,11,294
17669,10507,8899,0,2,37349,,,,,,1,1,7.735657284,19201,8933,8651,282,4,278
17669,10916,11040,5,0,35027,,,,,,1,1,7.344163294,18154,8291,8000,291,2,289
17669,9628,9453,0,2,37091,,,,,,1,1,7.837977155,19135,8840,8564,276,2,274
17669,8927,8964,0,0,38786,,,,,,1,1,7.906400447,19877,9321,9054,267,1,266
17669,10285,10316,4,0,35617,,,,,,1,1,7.348204455,18592,8370,8085,285,5,280
17669,10366,10640,0,0,36017,,,,,,1,1,7.439026935,18806,8454,8151,303,4,299
17669,11808,11356,4,0,35157,,,,,,1,1,7.299237816,18084,8370,8037,333,0,333
17669,9852,10981,2,8,38312,,,,,,1,1,7.8354204979999995,19380,9304,8980,324,16,308
17669,8137,10095,2,0,36493,,,,,,1,1,7.380693725,19153,8541,8283,258,6,252
17669,11486,9853,0,0,34633,,,,,,1,1,7.073037354,18013,8156,7848,308,1,307
17669,12590,9412,3,0,35233,,,,,,1,1,7.166717273,18119,8397,8077,320,1,319
17669,11961,9656,3,0,34511,,,,,,1,1,7.088841055,18066,8071,7768,303,0,303
17669,10023,10985,0,0,36571,,,,,,1,1,7.469512037,18215,9035,8749,286,0,286
17669,10486,10477,0,0,37172,,,,,,1,1,7.514273338,18638,9094,8748,346,1,345
17669,11552,10221,4,6,35707,,,,,,1,1,7.302526199,18435,8482,8174,308,7,301
17669,8639,9996,0,11,37238,,,,,,1,1,7.5112766010000005,19028,8971,8703,268,4,264
17669,9588,12606,0,1,35415,,,,,,1,1,7.18488325,18239,8426,8102,324,4,320
17669,11803,9660,2,0,33987,,,,,,1,1,6.976798905,17801,7935,7619,316,3,313
17669,10223,8637,0,0,38075,,,,,,1,1,7.767361761,19448,9173,8892,281,1,280
17669,10796,10889,0,0,37454,,,,,,1,1,7.6683062920000005,19175,8972,8637,335,2,333
17669,8799,10213,0,0,37937,,,,,,1,1,7.729048152,19188,9250,9001,249,0,249
17669,8881,10197,0,0,39424,,,,,,1,1,7.968358954,19972,9584,9300,284,0,284
17669,10203,11471,2,4,34921,,,,,,1,1,7.101878687,17938,8328,8001,327,6,321
17669,9493,10626,0,0,35141,,,,,,1,1,7.260384802,18361,8244,7952,292,3,289
17669,10561,10036,0,0,35768,,,,,,1,1,7.228189921,18305,8590,8307,283,2,281
17669,10481,10230,0,0,38532,,,,,,1,1,7.835710929,19191,9518,9213,305,1,304
17669,8946,9186,0,0,36738,,,,,,1,1,7.465878594,19040,8731,8495,236,2,234
17669,7595,9782,0,1,39104,,,,,,1,1,7.885137187,19842,9492,9214,278,2,276
17669,9991,11099,2,0,36847,,,,,,1,1,7.421185093,18629,8949,8629,320,2,318
17669,11452,10623,2,2,34332,,,,,,1,1,7.108048286,17747,8123,7784,339,8,331
17669,9352,10099,2,0,36225,,,,,,1,1,7.332184372,18741,8597,8307,290,5,285
17669,10560,11315,2,2,33210,,,,,,1,1,6.847342494,17573,7669,7370,299,18,281
17669,10788,9304,4,2,35784,,,,,,1,1,7.438195267,18537,8485,8208,277,4,273
17669,10780,8820,2,0,36315,,,,,,1,1,7.450377344,18997,8516,8230,286,1,285
17669,12346,11075,2,0,34603,,,,,,1,1,7.126003487,17871,8188,7832,356,5,351
17669,10828,10044,2,0,36487,,,,,,1,1,7.419844339,18655,8758,8442,316,3,313
17669,10937,9611,2,0,34046,,,,,,1,1,7.180259912,18060,7846,7552,294,0,294
17669,11277,10224,2,2,35502,,,,,,1,1,7.457049173,18432,8371,8043,328,7,321
17669,10655,9181,2,2,36168,,,,,,1,1,7.507240259,18664,8612,8332,280,1,279
17669,10575,10823,3,2,37835,,,,,,1,1,7.789812429,19400,9046,8703,343,0,343
17669,8604,10786,0,0,35050,,,,,,1,1,7.138191891,18299,8243,7978,265,2,263
17669,9253,10352,1,3,37817,,,,,,1,1,7.739212223,19020,9252,8959,293,0,293
17669,12670,8726,4,0,37138,,,,,,1,1,7.613999632,18523,9146,8823,323,1,322
17669,11075,9741,0,2,34833,,,,,,1,1,7.152613548,18270,8124,7809,315,4,311
17669,11332,10244,0,0,34089,,,,,,1,1,7.141968162,18118,7824,7501,323,6,317
17669,10459,9882,0,3,36150,,,,,,1,1,7.43330858,18713,8575,8288,287,5,282
17669,10425,9983,2,2,37310,,,,,,1,1,7.534402968,19240,8877,8561,316,2,314
17669,9714,9893,0,2,36509,,,,,,1,1,7.566124036,18738,8748,8473,275,0,275
17669,10554,9409,2,2,38412,,,,,,1,1,7.8074307990000005,19359,9364,9039,325,20,305
17669,9869,10891,0,0,35497,,,,,,1,1,7.213359391,18299,8445,8137,308,5,303
17669,10369,10482,0,4,35860,,,,,,1,1,7.419669971,18745,8407,8106,301,1,300
17669,11471,10134,5,0,36853,,,,,,1,1,7.5890523850000005,18441,9037,8699,338,9,329
17669,9946,9676,2,2,37671,,,,,,1,1,7.736098954,19247,9051,8729,322,8,314
17669,10204,10221,0,0,35334,,,,,,1,1,7.258290259,18365,8331,8024,307,4,303
17669,11202,10653,2,2,35324,,,,,,1,1,7.196974287,18091,8452,8123,329,8,321
17669,10234,9841,2,0,37514,,,,,,1,1,7.677794427,19207,9000,8693,307,6,301
17669,11747,9324,2,0,35237,,,,,,1,1,7.267621751,18304,8314,8009,305,2,303
17669,10039,10231,4,0,36591,,,,,,1,1,7.429529108,18898,8703,8416,287,0,287
17669,9560,9700,0,2,37034,,,,,,1,1,7.519231729,18987,8879,8590,289,12,277
17669,10239,7962,0,0,36528,,,,,,1,1,7.460510664,19165,8554,8299,255,4,251
17669,9774,11116,0,3,36547,,,,,,1,1,7.572377444,18640,8780,8433,347,5,342
17669,9591,11303,0,0,36502,,,,,,1,1,7.446392538,18512,8850,8560,290,1,289
17669,10529,10973,0,2,33802,,,,,,1,1,7.040931699,17674,7925,7647,278,3,275
17669,9120,9852,0,2,35585,,,,,,1,1,7.309370176,18655,8330,8060,270,1,269
17669,11219,12072,2,0,36701,,,,,,1,1,7.449690852,18431,8939,8547,392,2,390
17669,12297,10260,4,0,34271,,,,,,1,1,6.958198061,18055,7940,7604,336,6,330
17669,9173,8282,0,0,36628,,,,,,1,1,7.476653278,19004,8691,8449,242,0,242
17669,11475,10050,0,0,37233,,,,,,1,1,7.479708857,18980,8956,8615,341,1,340
17669,10848,10514,0,0,36659,,,,,,1,1,7.532811527,19000,8676,8369,307,2,305
17669,9756,11060,0,0,38856,,,,,,1,1,7.884221522,19431,9559,9252,307,0,307
17669,10987,12546,0,0,33795,,,,,,1,1,7.025144034,17644,7903,7558,345,3,342
17669,10193,12028,2,4,36049,,,,,,1,1,7.379205322,18220,8749,8418,331,2,329
17669,10825,8353,2,0,37914,,,,,,1,1,7.695190969,18966,9333,9051,282,6,276
17669,9658,10186,2,3,37743,,,,,,1,1,7.875625171,19079,9184,8888,296,2,294
17669,10008,10977,0,2,36493,,,,,,1,1,7.502385224,18399,8894,8588,306,1,305
17669,11190,10581,0,0,35498,,,,,,1,1,7.283778891,18581,8304,7995,309,3,306
17669,10493,10426,0,0,34063,,,,,,1,1,6.9702218479999996,17925,7911,7595,316,1,315
17669,11065,10968,1,2,35275,,,,,,1,1,7.526635846,18238,8348,8007,341,4,337
17669,8962,10956,0,0,38176,,,,,,1,1,7.8192367560000005,18913,9466,9135,331,1,330
17669,11429,8548,3,0,36864,,,,,,1,1,7.672229102,18894,8832,8526,306,2,304
17669,10607,11968,0,4,33805,,,,,,1,1,7.188239723,17545,7977,7671,306,7,299
17669,10838,9737,0,2,35713,,,,,,1,1,7.467214393,18511,8440,8118,322,4,318
17669,11522,10429,6,0,34514,,,,,,1,1,7.340047852,17979,8091,7738,353,15,338
17669,10820,11442,4,4,36800,,,,,,1,1,7.52312703,18687,8897,8578,319,13,306
17669,8578,9491,0,2,38081,,,,,,1,1,7.930839577,19105,9345,9059,286,4,282
17669,12003,10895,4,4,35821,,,,,,1,1,7.439365238,18448,8526,8205,321,1,320
17669,8567,10821,2,0,38835,,,,,,1,1,8.409026556,19234,9651,9352,299,6,293
17669,12272,10171,2,0,33652,,,,,,1,1,7.033604136,17586,7879,7571,308,11,297
17669,11172,9025,0,0,35544,,,,,,1,1,7.342481281,18591,8328,8031,297,4,293
17669,10773,10762,0,0,36178,,,,,,1,1,7.535603898,18469,8685,8346,339,0,339
17669,10916,9003,0,0,36593,,,,,,1,1,7.408698013,18837,8733,8443,290,2,288
17669,10394,10337,0,0,37729,,,,,,1,1,7.987965813,19184,9122,8821,301,2,299
17669,10124,10589,2,2,36965,,,,,,1,1,7.807722275,18715,8970,8660,310,2,308
17669,11892,8858,5,0,34300,,,,,,1,1,7.148132761,18189,7926,7667,259,1,258
17669,10918,11675,0,0,36991,,,,,,1,1,7.545994155,18638,9001,8650,351,1,350
17669,12108,11185,5,0,36376,,,,,,1,1,7.834563098,18214,8890,8508,382,2,380
17669,9866,10448,2,2,38768,,,,,,1,1,8.164152126,19364,9548,9240,308,5,303
17669,10556,10273,2,0,36592,,,,,,1,1,7.753853608,18642,8815,8495,320,1,319
17669,10450,12551,0,2,36966,,,,,,1,1,7.590591169,18714,8944,8580,364,0,364
17669,8569,10498,0,1,38435,,,,,,1,1,7.877766582,19513,9309,9005,304,7,297
17669,10654,10291,0,2,37980,,,,,,1,1,8.236287782,19380,9132,8796,336,12,324
17669,10334,11309,0,2,35271,,,,,,1,1,7.246767619,18306,8335,8040,295,5,290
17669,10628,10177,0,0,34767,,,,,,1,1,7.3772193,18196,8131,7822,309,0,309
17669,10214,9978,0,0,37194,,,,,,1,1,7.826164542,19245,8829,8538,291,2,289
17669,10092,9487,3,0,36241,,,,,,1,1,7.486043846,18817,8580,8316,264,1,263
17669,9739,10838,0,0,37050,,,,,,1,1,7.568471292,18669,9033,8718,315,3,312
17669,11469,8684,4,2,36710,,,,,,1,1,7.7600568580000004,18782,8793,8451,342,9,333
17669,9501,11105,1,2,38479,,,,,,1,1,8.08920991,19499,9330,9010,320,1,319
17669,9429,9791,5,0,35188,,,,,,1,1,7.644345182,18112,8402,8130,272,6,266
17669,8942,8023,0,0,37829,,,,,,1,1,7.823887392,19561,9008,8756,252,4,248
17669,7951,9949,0,0,38838,,,,,,1,1,8.127063765,19806,9381,9111,270,1,269
17669,10241,10951,2,4,37643,,,,,,1,1,7.87444889,18774,9262,8917,345,4,341
17669,10446,11174,0,0,35445,,,,,,1,1,7.357791096,18263,8425,8093,332,1,331
17669,10094,10775,4,0,35679,,,,,,1,1,7.51639733,18651,8366,8070,296,4,292
17669,12096,10864,2,0,33606,,,,,,1,1,7.416137697,18039,7639,7350,289,1,288
17669,11451,10750,2,3,35191,,,,,,1,1,7.199484288,17899,8469,8115,354,10,344
17669,10703,12198,2,0,35943,,,,,,1,1,7.487425548,18364,8605,8236,369,6,363
17669,11168,10187,2,4,35480,,,,,,1,1,7.229225906,18043,8567,8264,303,5,298
17669,8994,11409,0,2,35092,,,,,,1,1,7.427636142,18621,8088,7793,295,1,294
17669,10542,10384,0,0,35716,,,,,,1,1,7.285181155,18486,8467,8171,296,1,295
17669,9553,11011,2,0,35311,,,,,,1,1,7.273613563,18203,8396,8080,316,3,313
17669,9785,11138,0,2,36518,,,,,,1,1,7.37597432,18791,8706,8391,315,1,314
17669,10716,10125,2,0,36313,,,,,,1,1,7.545656172,18850,8579,8274,305,2,303
17669,9947,9229,0,0,38538,,,,,,1,1,7.865184406,19207,9510,9199,311,2,309
17669,11226,10484,3,3,37794,,,,,,1,1,7.957886808,19240,9109,8773,336,2,334
17669,10612,11078,0,2,35413,,,,,,1,1,7.402513328,18282,8393,8048,345,0,345
17669,10736,11165,0,0,33843,,,,,,1,1,6.954646503,17779,7863,7525,338,1,337
17669,10708,10761,2,2,34571,,,,,,1,1,7.180066706,17872,8210,7931,279,2,277
17669,11212,10479,2,2,33021,,,,,,1,1,6.8968339929999996,17453,7631,7325,306,2,304
17669,8085,10256,0,0,36668,,,,,,1,1,7.745625932,18876,8748,8452,296,0,296
17669,10330,11368,0,0,36927,,,,,,1,1,7.525235686,18916,8839,8506,333,1,332
17669,8504,9854,0,0,36413,,,,,,1,1,7.495396934,18973,8593,8339,254,4,250
17669,8891,12273,0,0,36160,,,,,,1,1,7.595546175,18447,8689,8354,335,2,333
17669,10923,9583,0,0,36917,,,,,,1,1,7.8597712,18890,8866,8571,295,0,295
17669,10567,9137,5,0,37827,,,,,,1,1,7.913985207,19236,9136,8817,319,11,308
17669,9071,10515,2,0,35434,,,,,,1,1,7.306528993,18326,8416,8140,276,6,270
17669,10431,9543,0,0,37583,,,,,,1,1,7.807717035,19326,8974,8665,309,2,307
17669,9294,9708,0,3,37099,,,,,,1,1,7.7976279349999995,19145,8827,8527,300,5,295
17669,9571,10612,2,0,37008,,,,,,1,1,7.628236505,18747,8976,8667,309,7,302
17669,11460,12087,4,0,35482,,,,,,1,1,7.360515273,18400,8369,8025,344,2,342
17669,10279,10201,0,2,35712,,,,,,1,1,7.493754936,18631,8391,8092,299,11,288
17669,11254,8956,2,3,37817,,,,,,1,1,7.805051183,19379,9065,8757,308,6,302
17669,11022,9888,0,0,33236,,,,,,1,1,6.921828952,17897,7529,7248,281,2,279
17669,9154,10978,0,0,37632,,,,,,1,1,7.8050370860000005,18995,9160,8843,317,2,315
17669,10589,10751,0,2,36199,,,,,,1,1,7.415528368,18546,8657,8318,339,0,339
17669,9668,10712,4,0,38576,,,,,,1,1,8.331564645,19148,9549,9219,330,11,319
17669,12198,11023,4,2,36246,,,,,,1,1,7.454264628,18248,8809,8429,380,10,370
17669,11376,11461,0,0,35011,,,,,,1,1,7.22929793,17796,8440,8105,335,0,335
17669,10880,10394,0,0,37506,,,,,,1,1,7.666947807,19202,8983,8645,338,0,338
17669,11297,10610,0,0,36241,,,,,,1,1,7.4025165,18500,8688,8323,365,3,362
17669,9697,11280,2,2,35204,,,,,,1,1,7.307513459,18371,8259,7944,315,4,311
17669,11060,10286,0,0,37111,,,,,,1,1,7.677941918,18711,9027,8681,346,0,346
17669,12004,11679,3,4,34920,,,,,,1,1,7.433707772,17883,8336,7971,365,9,356
17669,9734,10847,2,2,36405,,,,,,1,1,7.451007739,18719,8696,8402,294,4,290
17669,11580,9778,0,2,36679,,,,,,1,1,7.462154477,18361,8988,8646,342,17,325
17669,10137,11235,0,3,37417,,,,,,1,1,8.131203767,19074,9010,8687,323,2,321
17669,9056,12194,2,2,38675,,,,,,1,1,8.003773465,19074,9606,9217,389,10,379
17669,10291,10005,1,4,34643,,,,,,1,1,7.396781881,18263,8047,7761,286,2,284
17669,10932,10968,4,2,35030,,,,,,1,1,7.271847591,18420,8141,7813,328,6,322
17669,11361,11755,2,0,37011,,,,,,1,1,7.820105596,18681,8984,8622,362,1,361
17669,10422,10467,3,0,37005,,,,,,1,1,7.90491677,18810,8950,8655,295,1,294
17669,10066,9591,4,0,36477,,,,,,1,1,7.776314285,18742,8723,8434,289,1,288
17669,9201,8844,2,0,36782,,,,,,1,1,7.789757699,19134,8713,8491,222,4,218
17669,11353,10041,6,2,34406,,,,,,1,1,7.419430186,18277,7927,7652,275,17,258
17669,8980,9920,4,1,36304,,,,,,1,1,7.67076829,18507,8770,8513,257,3,254
17669,10196,10619,0,2,34129,,,,,,1,1,7.296528347,17988,7925,7634,291,3,288
17669,8118,11337,0,3,38954,,,,,,1,1,8.24245189,19361,9637,9318,319,8,311
17669,10385,9376,2,0,37589,,,,,,1,1,7.656267713,19247,9029,8745,284,1,283
17669,9380,9052,0,0,38849,,,,,,1,1,7.923535669,19572,9491,9196,295,1,294
17669,9479,9623,0,0,38838,,,,,,1,1,8.297562659,19023,9757,9456,301,3,298
17669,11476,9800,0,4,37690,,,,,,1,1,7.98433504,19132,9098,8736,362,5,357
17669,12095,9659,6,0,36200,,,,,,1,1,7.466261653,18018,8926,8596,330,9,321
17669,11341,10426,0,0,36619,,,,,,1,1,7.9900641,19152,8553,8192,361,5,356
17669,9624,10810,1,2,35756,,,,,,1,1,7.483664142,18582,8452,8182,270,3,267
17669,11604,8925,3,0,36576,,,,,,1,1,7.990955189,18412,8931,8629,302,0,302
17669,10473,10888,0,2,35939,,,,,,1,1,7.4365376659999995,18419,8607,8301,306,4,302
17669,10700,9860,4,2,38337,,,,,,1,1,7.931262308,19197,9409,9087,322,11,311
17669,11272,10900,2,1,34794,,,,,,1,1,7.152028142,18283,8095,7774,321,8,313
17669,10173,9825,1,0,37009,,,,,,1,1,7.644761078,18803,8949,8641,308,4,304
17669,10154,11544,0,2,38192,,,,,,1,1,8.58775242,19276,9282,8930,352,14,338
17669,10952,10749,0,0,35298,,,,,,1,1,7.391040035,18123,8438,8139,299,4,295
17669,10442,10597,2,0,34642,,,,,,1,1,7.25777837,18053,8129,7798,331,3,328
17669,10893,10449,4,2,35945,,,,,,1,1,7.372568444,18413,8619,8325,294,3,291
17669,10280,11542,0,4,36527,,,,,,1,1,8.011210757,18338,8925,8586,339,5,334
17669,11933,11525,2,1,36140,,,,,,1,1,7.746178036,18574,8601,8237,364,1,363
17669,11457,11187,0,2,33699,,,,,,1,1,6.998261489,17254,8044,7687,357,7,350
17669,9587,8730,0,0,37331,,,,,,1,1,8.215717604,19015,9011,8717,294,3,291
17669,11913,8473,0,0,35529,,,,,,1,1,7.302239353,18234,8497,8196,301,2,299
17669,9743,11494,2,0,35991,,,,,,1,1,7.570249626,18494,8583,8252,331,6,325
17669,10941,10178,0,3,35185,,,,,,1,1,7.943215005,17958,8459,8150,309,0,309
17669,10883,9671,0,0,36453,,,,,,1,1,7.846065433,18516,8817,8514,303,0,303
17669,10867,11288,0,2,35046,,,,,,1,1,7.894137379,18292,8218,7900,318,3,315
17669,10926,11310,0,4,37548,,,,,,1,1,7.851289401,19036,9077,8719,358,6,352
17669,10613,10037,0,0,35596,,,,,,1,1,7.499260502,18417,8439,8138,301,1,300
17669,10903,9988,2,2,34307,,,,,,1,1,7.378481679,17826,8086,7777,309,6,303
17669,9145,9960,0,2,36384,,,,,,1,1,8.068275535,18829,8647,8386,261,5,256
17669,12079,8918,3,2,34041,,,,,,1,1,7.331975583,17617,8065,7771,294,1,293
17669,10444,9955,0,2,38012,,,,,,1,1,7.930690459,18973,9345,8996,349,7,342
17669,9887,10698,0,0,36429,,,,,,1,1,7.839377999,18519,8795,8475,320,5,315
17669,11529,11652,2,2,35359,,,,,,1,1,7.635688568,18328,8341,7992,349,3,346
17669,10726,10778,0,2,34921,,,,,,1,1,7.310249027,18172,8218,7905,313,3,310
17669,11817,9592,0,2,35090,,,,,,1,1,7.30278528,18244,8267,7955,312,2,310
17669,11081,10379,0,2,34662,,,,,,1,1,7.062123639,17776,8287,7975,312,6,306
17669,9829,10805,0,0,34312,,,,,,1,1,7.181007298,18118,7959,7683,276,0,276
17669,10008,10918,0,2,35556,,,,,,1,1,7.433332836,18634,8315,8023,292,1,291
17669,9764,9431,0,2,34888,,,,,,1,1,7.476149431,18332,8136,7852,284,2,282
17669,11006,10589,2,4,34296,,,,,,1,1,7.091472748,18201,7897,7596,301,4,297
17669,10383,11610,0,0,33590,,,,,,1,1,7.02702135,17747,7768,7461,307,0,307
17669,10744,9572,2,0,38733,,,,,,1,1,7.767524115,19149,9623,9285,338,6,332
17669,12062,12507,0,2,33439,,,,,,1,1,6.887473632,17414,7848,7519,329,2,327
17669,10338,10408,1,1,36401,,,,,,1,1,7.359998523,18552,8769,8458,311,3,308
17669,10796,9748,0,2,37317,,,,,,1,1,7.647827776,18790,9093,8752,341,2,339
17669,11388,10192,0,0,37783,,,,,,1,1,7.794922321,18971,9253,8947,306,1,305
17669,11433,11163,2,2,36845,,,,,,1,1,7.651586655,18791,8854,8508,346,5,341
17669,10134,10446,0,0,36184,,,,,,1,1,7.410322802,18693,8604,8321,283,0,283
17669,9344,8593,0,0,37055,,,,,,1,1,7.618112677,19219,8782,8510,272,3,269
17669,10836,11176,4,4,33184,,,,,,1,1,6.832948029,17461,7711,7410,301,5,296
17669,7844,10127,0,2,37678,,,,,,1,1,8.007746651,19272,9073,8813,260,1,259
17669,10361,8125,0,0,37558,,,,,,1,1,7.875399092,19179,9049,8768,281,2,279
17669,10180,9897,0,2,37230,,,,,,1,1,7.582522809,18968,8973,8657,316,7,309
17669,9817,9269,2,2,36052,,,,,,1,1,7.6682850689999995,18726,8526,8252,274,5,269
17669,11095,10449,4,0,37082,,,,,,1,1,7.788319245,19061,8843,8508,335,3,332
17669,11197,10184,0,6,35334,,,,,,1,1,7.28484565,18087,8473,8172,301,5,296
17669,10999,9651,4,0,35966,,,,,,1,1,7.510376763,18181,8734,8417,317,15,302
17669,11614,11069,4,0,35581,,,,,,1,1,7.616723084,18450,8394,8051,343,2,341
17669,10486,8254,2,0,37209,,,,,,1,1,7.693230509,19026,8951,8670,281,13,268
17669,10942,12410,0,3,34325,,,,,,1,1,7.336811289,17661,8156,7804,352,7,345
17669,12029,9965,0,0,35394,,,,,,1,1,7.72856096,18328,8364,8026,338,2,336
17669,10722,10084,0,0,35361,,,,,,1,1,7.596217393,18339,8362,8064,298,2,296
17669,10500,10598,0,2,37242,,,,,,1,1,7.854591902,18613,9139,8788,351,3,348
17669,10166,10800,0,4,37544,,,,,,1,1,8.023963328,18985,9118,8795,323,8,315
17669,9335,8955,0,0,36295,,,,,,1,1,7.830847273,18474,8781,8522,259,0,259
17669,10224,10596,2,0,35929,,,,,,1,1,7.853479448,18805,8395,8061,334,3,331
17669,11785,11048,6,0,35885,,,,,,1,1,7.690550852,18234,8668,8353,315,2,313
17669,10090,10447,0,0,37594,,,,,,1,1,7.707805031,18918,9189,8891,298,4,294
17669,9916,10729,0,2,35717,,,,,,1,1,7.237454079,18578,8426,8139,287,3,284
17669,10875,10663,0,0,35408,,,,,,1,1,7.683852096,18360,8375,8077,298,2,296
17669,9485,9459,2,0,37278,,,,,,1,1,7.934683361,18903,9048,8769,279,2,277
17669,9148,11160,0,0,35987,,,,,,1,1,7.518555029,18683,8506,8214,292,1,291
17669,10485,10214,1,2,37957,,,,,,1,1,7.841804605,19145,9239,8905,334,0,334
17669,11022,11960,0,2,33095,,,,,,1,1,7.236404363,17266,7761,7454,307,0,307
17669,9694,10179,0,0,37725,,,,,,1,1,7.86671419,19294,9078,8803,275,2,273
17669,10464,11275,6,0,36480,,,,,,1,1,7.432296089,18659,8754,8441,313,3,310
17669,12021,10527,0,2,37654,,,,,,1,1,7.959741271,18800,9257,8917,340,0,340
17669,9463,11441,0,2,35867,,,,,,1,1,7.563389401,18437,8565,8265,300,1,299
17669,10744,9793,0,0,36298,,,,,,1,1,7.358347834,18706,8646,8346,300,0,300
17669,9433,10467,0,0,35623,,,,,,1,1,7.635046895,18308,8515,8230,285,2,283
17669,9843,9819,7,0,35579,,,,,,1,1,7.407608791,18144,8579,8302,277,4,273
17669,10234,10314,0,0,35753,,,,,,1,1,7.597724946,18505,8463,8141,322,7,315
17669,10154,10162,0,0,35028,,,,,,1,1,7.28683415,18075,8332,8043,289,1,288
17669,10402,10012,0,4,36558,,,,,,1,1,7.681023505,19045,8592,8263,329,7,322
17669,9541,11380,0,2,36878,,,,,,1,1,7.713831332,18869,8856,8559,297,1,296
17669,8714,10986,0,0,35994,,,,,,1,1,7.549054205,18351,8675,8382,293,2,291
17669,9622,11246,2,3,34778,,,,,,1,1,7.661334944,18110,8172,7848,324,2,322
17669,7620,11961,2,0,36457,,,,,,1,1,7.766115375,18896,8645,8374,271,4,267
17669,10338,11480,2,0,35168,,,,,,1,1,7.26288646,18198,8324,8002,322,0,322
17669,10738,9025,4,0,34490,,,,,,1,1,7.135878263,18271,7965,7676,289,9,280
17669,10137,9631,0,0,35122,,,,,,1,1,7.31254936,18262,8294,8022,272,0,272
17669,10981,9751,2,0,35624,,,,,,1,1,7.801425027,18485,8408,8085,323,4,319
17669,12280,10227,2,0,34784,,,,,,1,1,7.339314546,18096,8155,7777,378,6,372
17669,10932,10701,3,2,33925,,,,,,1,1,7.449517494,17849,7888,7588,300,6,294
17669,10927,9017,1,0,36158,,,,,,1,1,7.672286545,18491,8684,8385,299,2,297
17669,9157,10237,0,0,36780,,,,,,1,1,7.846239231,18941,8773,8480,293,3,290
17669,9183,11118,2,0,36863,,,,,,1,1,7.676267678,18979,8790,8486,304,5,299
17669,9687,11220,0,0,38725,,,,,,1,1,7.846988682,19443,9477,9149,328,0,328
17669,10548,10857,0,0,37800,,,,,,1,1,8.167414783,19319,9085,8774,311,1,310
17669,9379,9695,2,2,36748,,,,,,1,1,7.75053626,19016,8733,8467,266,6,260
17669,10123,11952,0,4,38252,,,,,,1,1,7.764770067,19248,9317,8947,370,13,357
17669,10683,9508,0,2,35805,,,,,,1,1,7.959466742,18731,8389,8093,296,0,296
17669,10416,10307,3,0,36082,,,,,,1,1,7.316093495,18176,8790,8464,326,4,322
17669,9772,9768,2,0,35930,,,,,,1,1,7.623002227,18871,8398,8135,263,2,261
17669,11025,10810,2,0,34563,,,,,,1,1,7.270040999,17954,8138,7805,333,5,328
17669,10013,10124,0,2,37024,,,,,,1,1,7.760327209,18903,8889,8546,343,2,341
17669,10294,11128,0,2,34222,,,,,,1,1,7.007672879,17892,8003,7679,324,7,317
17669,10193,10555,0,0,34652,,,,,,1,1,7.227529101,18367,7995,7700,295,3,292
17669,10326,8851,2,0,37725,,,,,,1,1,7.687769366,19351,9028,8710,318,3,315
17669,11256,11836,0,2,35009,,,,,,1,1,7.343908234,18089,8288,7944,344,1,343
17669,11461,10853,0,0,35026,,,,,,1,1,7.153112018,18049,8321,7986,335,1,334
17669,10182,9946,2,2,35790,,,,,,1,1,7.23206305,18415,8551,8278,273,9,264
17669,10448,9439,0,0,35565,,,,,,1,1,7.511111273,18427,8423,8131,292,0,292
17669,10754,10608,4,0,33763,,,,,,1,1,7.148642143,17244,8110,7811,299,3,296
17669,11215,8960,0,2,34724,,,,,,1,1,7.156304626,18230,8104,7818,286,1,285
17669,10600,9458,0,0,35655,,,,,,1,1,7.54304882,18719,8325,8039,286,2,284
17669,10258,11395,2,0,36399,,,,,,1,1,7.7199946950000005,18800,8628,8285,343,0,343
17669,10535,9986,0,2,36991,,,,,,1,1,7.679093335,18997,8823,8475,348,1,347
17669,10927,10416,0,4,36992,,,,,,1,1,7.917822001,18833,8908,8565,343,6,337
17669,10812,9583,2,0,36669,,,,,,1,1,7.746547047,18648,8860,8559,301,2,299
17669,9780,10578,1,0,36545,,,,,,1,1,7.3940196369999995,18846,8699,8398,301,2,299
17669,10061,10387,0,3,37730,,,,,,1,1,8.195834334,19112,9144,8814,330,3,327
17669,11273,10484,0,2,34500,,,,,,1,1,7.271917452,18146,8015,7691,324,0,324
17669,9781,10426,0,0,36348,,,,,,1,1,7.601369427,18594,8718,8400,318,0,318
17669,9207,10964,0,2,35243,,,,,,1,1,7.245177383,18276,8335,8038,297,3,294
17669,9812,9487,0,2,36522,,,,,,1,1,7.732890744,18660,8796,8526,270,2,268
17669,10588,9139,0,2,35987,,,,,,1,1,7.471448291,18321,8687,8395,292,9,283
17669,9333,11033,0,2,37232,,,,,,1,1,7.953134851,18960,8973,8647,326,4,322
17669,11691,9550,0,0,34236,,,,,,1,1,6.962448727,17867,8025,7706,319,4,315
17669,10125,10902,0,5,35109,,,,,,1,1,7.349310621,18372,8204,7875,329,10,319
17669,10306,9920,0,0,35537,,,,,,1,1,7.4317602879999995,18580,8321,8006,315,6,309
17669,9796,11342,0,2,34621,,,,,,1,1,7.002302893,18475,7911,7587,324,3,321
17669,10575,9688,0,0,35582,,,,,,1,1,7.295092265,18440,8420,8118,302,2,300
17669,9840,8900,0,2,37070,,,,,,1,1,7.713169902,19134,8816,8512,304,1,303
17669,9322,8946,2,0,38180,,,,,,1,1,7.723813793,19078,9397,9089,308,5,303
17669,10469,11156,0,2,37844,,,,,,1,1,8.352187771,19042,9233,8897,336,6,330
17669,11037,10894,0,4,35543,,,,,,1,1,7.252901213,18191,8492,8124,368,1,367
17669,10034,10955,3,2,34290,,,,,,1,1,7.221877742,17787,8101,7800,301,9,292
17669,11631,10702,0,3,35430,,,,,,1,1,7.573594691,18391,8348,8005,343,4,339
17669,10629,10716,7,0,36187,,,,,,1,1,7.693509911,18628,8615,8286,329,6,323
17669,9562,10626,0,3,35731,,,,,,1,1,7.367506335,18466,8491,8208,283,4,279
17669,9881,10883,2,0,37322,,,,,,1,1,7.854745763,18836,9079,8751,328,4,324
17669,10122,10552,2,0,35387,,,,,,1,1,7.166380111,18096,8508,8233,275,0,275
17669,10219,9006,2,0,34733,,,,,,1,1,7.102678688,18291,8085,7813,272,11,261
17669,10553,10568,0,0,37677,,,,,,1,1,7.678440553,19388,8966,8609,357,3,354
17669,9898,9902,2,0,37630,,,,,,1,1,7.589540641,18920,9211,8923,288,1,287
17669,10463,9184,0,2,37106,,,,,,1,1,8.062789344,18887,8962,8667,295,0,295
17669,9404,11104,0,0,35766,,,,,,1,1,7.571810544,18576,8437,8121,316,1,315
17669,11712,10535,3,2,33545,,,,,,1,1,6.9710826390000005,17753,7731,7401,330,1,329
17669,10475,10664,0,0,36657,,,,,,1,1,7.672030878,18709,8816,8500,316,2,314
17669,11031,8703,0,0,33909,,,,,,1,1,7.472046669,17905,7885,7651,234,1,233
17669,11770,9486,4,0,34051,,,,,,1,1,7.316130096,17968,7880,7557,323,3,320
17669,9775,10021,0,0,34534,,,,,,1,1,7.196856702,18073,8087,7800,287,5,282
17669,8810,10726,0,3,37575,,,,,,1,1,7.90833103,19165,9041,8713,328,4,324
17669,10358,8884,0,2,37170,,,,,,1,1,7.805612299,18908,8976,8666,310,2,308
17669,10948,10738,2,2,36065,,,,,,1,1,7.86316951,18343,8686,8336,350,7,343
17669,10542,9894,0,0,35131,,,,,,1,1,7.535364206,18581,8116,7798,318,3,315
17669,11035,9978,0,0,34492,,,,,,1,1,7.413633984,17916,8155,7889,266,0,266
17669,10175,8937,3,2,34791,,,,,,1,1,7.661763572,18081,8221,7953,268,1,267
17669,10807,9805,2,2,35112,,,,,,1,1,7.458422356,18239,8298,8021,277,6,271
17669,11275,10503,2,0,38165,,,,,,1,1,8.078926249,19239,9289,8941,348,0,348
17669,10743,9053,2,0,37928,,,,,,1,1,7.890353564,19041,9282,8959,323,2,321
17669,9929,11881,2,2,36236,,,,,,1,1,7.690002582,18181,8868,8549,319,0,319
17669,10475,11145,0,2,35943,,,,,,1,1,7.66489448,18594,8499,8148,351,4,347
17669,10786,10599,0,2,35687,,,,,,1,1,7.494230478,18571,8396,8072,324,2,322
17669,12896,9970,6,0,37388,,,,,,1,1,7.751475851,18734,9148,8790,358,7,351
17669,12356,10849,0,0,34073,,,,,,1,1,7.482597576,17985,7878,7546,332,2,330
17669,9765,10766,2,1,37640,,,,,,1,1,7.88127987,19096,9113,8795,318,6,312
17669,10530,9592,0,6,34468,,,,,,1,1,7.478244265,18320,7946,7690,256,3,253
17669,10949,11525,2,3,34691,,,,,,1,1,7.671584584,18094,8139,7820,319,6,313
17669,9900,10264,2,0,35826,,,,,,1,1,7.619771917,18335,8605,8324,281,0,281
17669,9642,9345,0,0,36737,,,,,,1,1,7.587692971,19026,8710,8419,291,3,288
17669,9944,8774,0,0,36618,,,,,,1,1,7.822254739,18875,8734,8459,275,5,270
17669,10713,9239,0,0,35920,,,,,,1,1,7.489415541,18710,8454,8152,302,4,298
17669,10738,12214,2,0,35857,,,,,,1,1,7.568123482,18465,8535,8213,322,3,319
17669,10766,10629,1,4,36910,,,,,,1,1,7.906140478,18796,8892,8562,330,5,325
17669,9576,10267,2,0,36031,,,,,,1,1,7.508210784,18836,8447,8146,301,4,297
17669,10084,10381,4,2,35870,,,,,,1,1,7.463919143,18489,8545,8254,291,2,289
17669,10418,10233,2,2,36373,,,,,,1,1,7.689452309,18458,8813,8524,289,1,288
17669,11314,10644,0,0,33738,,,,,,1,1,7.227970438,17712,7852,7530,322,1,321
17669,10320,12406,0,0,36485,,,,,,1,1,7.8015783039999995,18205,8949,8567,382,1,381
17669,11405,10917,0,2,35989,,,,,,1,1,7.54758912,18105,8771,8429,342,4,338
17669,8555,9775,0,0,36657,,,,,,1,1,8.073272349,18859,8759,8479,280,1,279
17669,10218,11621,2,2,36260,,,,,,1,1,7.566210299,18614,8666,8352,314,4,310
17669,10392,11073,2,0,36548,,,,,,1,1,7.432587924,18555,8848,8551,297,1,296
17669,10050,8167,2,0,36779,,,,,,1,1,7.746616308,18938,8790,8529,261,6,255
17669,10259,10149,3,2,34927,,,,,,1,1,7.470947121,18231,8223,7973,250,2,248
17669,10759,11815,0,2,36296,,,,,,1,1,7.538063195,18261,8840,8485,355,3,352
17669,9045,11048,0,0,36361,,,,,,1,1,7.476978676,18816,8611,8288,323,4,319
17669,9918,9533,0,0,34336,,,,,,1,1,7.139627893,18172,7945,7671,274,2,272
17669,10913,10543,6,2,37219,,,,,,1,1,7.719188235,19006,8953,8646,307,1,306
17669,9320,9425,2,0,34741,,,,,,1,1,7.292977872,18380,8052,7795,257,4,253
17669,9533,12035,0,0,34845,,,,,,1,1,7.519252027,18119,8207,7895,312,2,310
17669,10639,9940,0,2,36779,,,,,,1,1,7.720792434,19020,8718,8395,323,3,320
17669,10701,10785,0,2,34919,,,,,,1,1,7.282356407,18384,8116,7813,303,1,302
17669,10898,10531,4,2,36100,,,,,,1,1,7.413222092,18729,8535,8234,301,5,296
17669,9960,10091,4,2,36813,,,,,,1,1,7.730800176,18749,8871,8549,322,3,319
17669,10918,11856,5,2,36556,,,,,,1,1,7.791852857,18211,8992,8631,361,16,345
17669,11043,11375,0,0,34709,,,,,,1,1,7.1021330129999996,18175,8098,7760,338,2,336
17669,9938,10639,0,0,35643,,,,,,1,1,7.47550589,18511,8414,8110,304,3,301
17669,12223,11903,2,0,33275,,,,,,1,1,6.964568199,17864,7521,7152,369,4,365
17669,10316,11241,2,11,34889,,,,,,1,1,7.318908146,18073,8280,8024,256,5,251
17669,10678,10921,5,2,35747,,,,,,1,1,7.659383736,18297,8568,8254,314,1,313
17669,9738,11032,1,4,34822,,,,,,1,1,7.151690536,18321,8099,7796,303,2,301
17669,10792,9939,0,2,35636,,,,,,1,1,7.734516476,18907,8225,7946,279,0,279
17669,10430,9831,2,8,35753,,,,,,1,1,7.537662827,18407,8520,8214,306,12,294
17669,11056,10325,5,0,33667,,,,,,1,1,7.207540937,18079,7651,7365,286,3,283
17669,8577,10229,2,2,37713,,,,,,1,1,7.764244602,19286,9079,8810,269,12,257
17669,10996,10983,1,0,36062,,,,,,1,1,7.418238894,18561,8567,8200,367,5,362
17669,11397,9582,0,2,37549,,,,,,1,1,7.780290197,18927,9149,8825,324,2,322
17669,9681,10881,0,0,36942,,,,,,1,1,7.655731797,18834,8893,8571,322,0,322
17669,11164,10203,2,0,35902,,,,,,1,1,7.642303484,18341,8618,8293,325,4,321
17669,10123,12149,0,2,34287,,,,,,1,1,7.220617869,18137,7905,7565,340,8,332
17669,10332,10332,4,4,37437,,,,,,1,1,7.580087731,19212,8975,8700,275,1,274
17669,10053,11440,2,0,33578,,,,,,1,1,7.243700272,17208,8036,7738,298,1,297
17669,9274,10514,0,2,36081,,,,,,1,1,7.391960834,18512,8643,8360,283,2,281
17669,10899,8981,0,2,36919,,,,,,1,1,7.557231385,18656,8990,8707,283,0,283
17669,11016,9995,1,0,34862,,,,,,1,1,7.305478992,18163,8179,7838,341,4,337
17669,10459,9714,0,0,35217,,,,,,1,1,7.445873772,18142,8398,8119,279,1,278
17669,10522,9286,0,0,37190,,,,,,1,1,7.804352188,19186,8866,8594,272,1,271
17669,11571,10816,6,3,32009,,,,,,1,1,6.588957173,17338,7183,6878,305,5,300
17669,10084,9240,0,4,38926,,,,,,1,1,8.264810129,19354,9628,9312,316,3,313
17669,11099,8953,2,0,36332,,,,,,1,1,7.332389963,18864,8584,8284,300,1,299
17669,9920,11774,2,0,34666,,,,,,1,1,7.7244370060000005,18197,8067,7732,335,1,334
17669,9745,11230,2,2,36990,,,,,,1,1,7.870605883,18728,8973,8657,316,3,313
17669,9506,10009,2,2,37765,,,,,,1,1,8.301418358,19287,9089,8789,300,5,295
17669,10393,10172,5,0,36992,,,,,,1,1,7.9969697,18811,8935,8624,311,0,311
17669,10672,11191,0,6,34536,,,,,,1,1,7.523739614,18018,8110,7812,298,4,294
17669,10869,9971,0,0,31971,,,,,,1,1,6.775209714,16998,7349,7074,275,1,274
17669,9572,10119,2,0,34653,,,,,,1,1,7.147678115,18204,8089,7818,271,1,270
17669,10293,9605,0,2,37744,,,,,,1,1,8.342751728,19315,9063,8760,303,13,290
17669,9557,10624,3,1,36401,,,,,,1,1,7.870636964,18609,8741,8431,310,12,298
17669,10713,10568,2,2,34659,,,,,,1,1,7.359236591,18097,8136,7846,290,7,283
17669,10464,9024,2,0,35500,,,,,,1,1,7.573587045,18723,8244,7955,289,1,288
17669,8840,10701,0,0,37077,,,,,,1,1,7.581547442,19105,8842,8554,288,1,287
17669,9040,11463,0,0,34971,,,,,,1,1,7.576159598,18480,8106,7827,279,8,271
17669,10798,10644,2,0,35993,,,,,,1,1,7.727067677,18462,8600,8269,331,5,326
17669,10869,9571,0,0,35363,,,,,,1,1,8.135515161,18370,8333,8006,327,2,325
17669,10808,9864,0,3,37022,,,,,,1,1,8.063252325,19338,8674,8338,336,2,334
17669,10707,9147,0,0,35524,,,,,,1,1,7.500916406,18449,8402,8131,271,1,270
17669,11334,9706,0,0,36116,,,,,,1,1,7.865727324,18640,8587,8285,302,2,300
17669,9259,10218,0,0,37712,,,,,,1,1,8.336335894,19441,8978,8663,315,3,312
17669,10379,10856,0,0,36039,,,,,,1,1,7.320177109,18344,8696,8393,303,0,303
17669,11354,10366,2,0,35263,,,,,,1,1,7.48748536,18135,8417,8123,294,2,292
17669,10737,10401,0,0,37400,,,,,,1,1,8.270498718,18723,9183,8872,311,0,311
17669,11492,11157,0,2,34518,,,,,,1,1,7.439815718,17944,8119,7783,336,3,333
17669,10703,9337,0,2,37188,,,,,,1,1,7.513563485,18913,8975,8650,325,9,316
17669,10534,9451,6,0,36097,,,,,,1,1,7.699078759,18825,8503,8237,266,1,265
17669,10662,10487,2,0,36943,,,,,,1,1,7.856193764,18392,9120,8809,311,4,307
17669,10550,9399,4,0,37735,,,,,,1,1,7.757236851,19258,9088,8787,301,10,291
17669,11958,11775,0,2,35500,,,,,,1,1,7.294848327,18249,8453,8108,345,1,344
17669,10814,10015,0,2,36166,,,,,,1,1,7.914072171,18424,8710,8388,322,2,320
17669,9106,11016,0,0,36897,,,,,,1,1,7.736529191,18977,8803,8489,314,1,313
17669,10488,10576,4,0,36366,,,,,,1,1,7.405222122,18520,8751,8407,344,9,335
17669,11319,9249,0,2,35645,,,,,,1,1,7.313642413,18509,8419,8121,298,3,295
17669,9081,9745,0,2,36013,,,,,,1,1,7.49407206,18435,8664,8414,250,4,246
17669,10589,10685,0,2,36471,,,,,,1,1,7.534727655,18785,8667,8315,352,1,351
17669,10372,12261,0,2,36325,,,,,,1,1,7.646492927,18436,8777,8442,335,3,332
17669,9747,11460,0,3,36224,,,,,,1,1,7.562177472,18410,8752,8442,310,3,307
17669,8455,9585,2,0,36630,,,,,,1,1,7.743133655,18656,8854,8588,266,2,264
17669,10085,11308,3,4,34249,,,,,,1,1,7.145005907,17717,8113,7807,306,7,299
17669,11172,8575,3,0,36778,,,,,,1,1,7.484845876,19006,8747,8469,278,4,274
17669,10242,10528,0,0,36525,,,,,,1,1,7.481329434,18805,8704,8392,312,0,312
17669,11645,11221,2,0,34871,,,,,,1,1,7.138042564,17868,8333,7996,337,3,334
17669,10618,9900,2,4,36517,,,,,,1,1,7.495290774,18590,8811,8506,305,11,294
17669,8940,10684,2,2,37528,,,,,,1,1,7.809106773,19363,8939,8652,287,7,280
17669,10751,10728,4,0,35750,,,,,,1,1,7.550751811,18226,8602,8282,320,6,314
17669,9953,9421,0,0,36155,,,,,,1,1,7.455845505,18809,8532,8250,282,2,280
17669,10963,9312,0,0,36705,,,,,,1,1,7.555286694,18802,8803,8506,297,1,296
17669,9329,10272,2,0,36928,,,,,,1,1,7.930023628,19172,8731,8437,294,3,291
17669,11125,8668,2,2,36343,,,,,,1,1,7.364430028,18937,8568,8298,270,4,266
17669,10553,11779,0,2,35379,,,,,,1,1,7.336103447,18437,8303,7967,336,9,327
17669,10381,10398,0,0,36004,,,,,,1,1,7.588886805,18591,8542,8213,329,1,328
17669,10920,8913,0,0,36770,,,,,,1,1,7.581209085,18877,8793,8486,307,5,302
17669,10149,10297,0,0,37646,,,,,,1,1,7.644134151,19116,9106,8788,318,5,313
17669,9436,9822,0,4,37457,,,,,,1,1,7.798240179,19273,8955,8681,274,4,270
17669,11346,11027,0,0,34861,,,,,,1,1,7.233614635,18176,8161,7798,363,3,360
17669,10010,10326,0,0,37470,,,,,,1,1,7.761544644,18725,9217,8906,311,0,311
17669,11293,10990,0,0,33754,,,,,,1,1,7.080220375,17848,7788,7458,330,0,330
17669,9597,12135,0,4,35770,,,,,,1,1,7.298551795,18511,8467,8142,325,1,324
17669,10194,11811,0,2,34676,,,,,,1,1,7.218591062,18207,8073,7750,323,6,317
17669,10507,9415,2,2,35750,,,,,,1,1,7.590743537,18399,8538,8263,275,11,264
17669,9813,9728,2,0,34168,,,,,,1,1,7.174326553,18054,7934,7688,246,3,243
17669,10073,10090,0,0,36932,,,,,,1,1,7.486289225,18864,8875,8557,318,0,318
17669,9421,10205,2,0,36608,,,,,,1,1,7.52690542,18888,8707,8401,306,3,303
17669,10046,10958,0,0,34934,,,,,,1,1,7.098965626,18333,8156,7867,289,2,287
17669,10717,10114,2,0,34204,,,,,,1,1,7.092373246,17981,7961,7660,301,2,299
17669,11297,11555,0,0,34114,,,,,,1,1,7.051726053,17854,7969,7647,322,2,320
17669,11456,10795,0,0,35467,,,,,,1,1,7.421021257,18493,8322,7992,330,2,328
17669,8646,9486,0,0,37997,,,,,,1,1,7.81380328,19463,9124,8838,286,2,284
17669,11037,9563,0,0,37411,,,,,,1,1,8.010040723,19085,8997,8665,332,0,332
17669,11430,12725,2,5,34139,,,,,,1,1,7.043100814,17388,8199,7846,353,3,350
17669,11142,10261,2,0,36779,,,,,,1,1,7.745079262,19001,8729,8409,320,1,319
17669,9489,11382,0,0,34139,,,,,,1,1,7.148446291,17940,7942,7627,315,2,313
17669,10434,10684,0,4,35197,,,,,,1,1,7.293443094,17997,8430,8090,340,20,320
17669,10160,8955,2,0,36700,,,,,,1,1,7.518263836,18738,8847,8579,268,3,265
17669,10439,9704,0,0,35168,,,,,,1,1,7.120324682,18292,8293,8003,290,2,288
17669,10037,10265,2,2,35500,,,,,,1,1,7.487733223,18548,8318,8002,316,1,315
17669,9916,10097,0,2,35675,,,,,,1,1,7.491041784,18505,8429,8117,312,1,311
17669,10158,10632,2,0,37028,,,,,,1,1,7.653227277,19027,8844,8531,313,2,311
17669,11304,10889,0,4,33635,,,,,,1,1,7.036929612,17335,8002,7706,296,14,282
17669,11398,11997,0,0,34503,,,,,,1,1,7.10565401,17913,8134,7812,322,1,321
17669,10347,8033,0,0,38116,,,,,,1,1,7.90118251,19554,9147,8879,268,5,263
17669,10926,9892,0,0,34776,,,,,,1,1,7.53140758,18153,8156,7845,311,2,309
17669,8734,11909,0,2,35934,,,,,,1,1,7.4763441010000005,18573,8531,8232,299,1,298
17669,9258,9858,0,2,35893,,,,,,1,1,7.701205036,18222,8696,8417,279,0,279
17669,11859,9603,2,0,35503,,,,,,1,1,7.664098634,18046,8564,8235,329,2,327
17669,9908,11025,0,2,36733,,,,,,1,1,7.602009666,18569,8927,8617,310,0,310
17669,9109,10993,2,4,35676,,,,,,1,1,7.7796867469999995,18440,8473,8183,290,5,285
17669,8825,9915,2,4,38566,,,,,,1,1,8.172056767,19562,9350,9046,304,10,294
17669,8934,9722,0,0,38548,,,,,,1,1,8.083961664,19554,9328,8990,338,1,337
17669,10266,10843,4,0,36227,,,,,,1,1,7.500793886,18470,8720,8403,317,9,308
17669,9268,8487,0,0,36820,,,,,,1,1,7.732481594,18998,8784,8530,254,3,251
17669,10294,10424,2,0,34635,,,,,,1,1,7.08567249,17971,8183,7885,298,0,298
17669,9277,10223,2,2,37365,,,,,,1,1,7.7298660550000005,18963,9049,8745,304,2,302
17669,9717,9993,0,2,35448,,,,,,1,1,7.604384196,18410,8374,8084,290,2,288
17669,10485,11156,0,0,35235,,,,,,1,1,7.524152988,18286,8331,8044,287,1,286
17669,9701,10289,1,0,38419,,,,,,1,1,8.227392544,19255,9420,9096,324,9,315
17669,8607,9613,1,2,37770,,,,,,1,1,8.247118725,19490,9010,8750,260,3,257
17669,11473,12228,2,4,34634,,,,,,1,1,7.521514973,17873,8201,7842,359,3,356
17669,9768,10619,0,0,37750,,,,,,1,1,8.054573182,19168,9128,8802,326,3,323
17669,9444,10991,5,0,34572,,,,,,1,1,7.5750818970000005,18465,7914,7635,279,2,277
17669,9406,10325,0,0,34625,,,,,,1,1,7.83687667,18084,8133,7858,275,1,274
17669,9924,11765,2,3,36481,,,,,,1,1,7.864910277,18427,8869,8553,316,0,316
17669,8398,10527,0,0,36749,,,,,,1,1,7.649927771,19125,8669,8383,286,2,284
17669,10300,9739,0,0,36927,,,,,,1,1,7.670553153,19004,8821,8540,281,1,280
17669,11965,10908,2,0,33078,,,,,,1,1,7.195382081,17512,7617,7285,332,4,328
17669,10281,9578,0,0,35948,,,,,,1,1,7.754244504,18813,8426,8143,283,3,280
17669,10967,8778,0,0,36819,,,,,,1,1,7.926970904,18986,8769,8474,295,1,294
17669,10632,9032,4,0,35851,,,,,,1,1,7.56639042,18595,8480,8184,296,8,288
17669,9501,8826,2,0,35230,,,,,,1,1,7.577519699,18734,8114,7846,268,1,267
17669,10301,10924,1,2,34576,,,,,,1,1,7.743539667,18294,7989,7685,304,2,302
17669,10573,11548,0,2,38570,,,,,,1,1,8.398540779,19543,9341,8996,345,3,342
17669,7665,10535,0,0,37116,,,,,,1,1,8.182537555,19416,8711,8433,278,3,275
17669,11306,11583,0,2,36189,,,,,,1,1,7.681166719,18643,8591,8227,364,2,362
17669,11286,8778,4,0,38242,,,,,,1,1,8.314676543,19281,9311,8972,339,6,333
17669,10601,10893,0,0,37195,,,,,,1,1,8.065820127,19029,8919,8591,328,2,326
17669,10299,11469,2,2,35255,,,,,,1,1,7.50950048,18228,8342,7999,343,6,337
17669,11359,11058,0,2,35033,,,,,,1,1,7.285767376,18046,8340,8033,307,1,306
17669,8791,9914,0,2,37300,,,,,,1,1,7.967024637,19087,8972,8703,269,2,267
17669,11050,9175,1,0,34988,,,,,,1,1,7.771336098,18319,8194,7913,281,3,278
17669,10920,11024,2,0,35345,,,,,,1,1,7.6666134889999995,18387,8330,8032,298,0,298
17669,11499,11340,3,4,34066,,,,,,1,1,5.396540138,17647,8036,7689,347,7,340
17669,10139,9310,0,0,36130,,,,,,1,1,7.582878582,18713,8562,8269,293,4,289
17669,9770,9921,2,0,37725,,,,,,1,1,6.065359914,19039,9187,8875,312,5,307
17669,10080,10268,0,0,36402,,,,,,1,1,5.524692681,18973,8565,8266,299,2,297
17669,11969,11381,3,0,34899,,,,,,1,1,5.289057941,18132,8207,7854,353,3,350
17669,10122,11157,0,0,35516,,,,,,1,1,6.958781226,18113,8533,8196,337,1,336
17669,10591,10064,0,2,36073,,,,,,1,1,5.435832102,18680,8547,8248,299,1,298
17669,8640,10402,0,2,36959,,,,,,1,1,5.217911459,18952,8871,8606,265,3,262
17669,11081,9198,4,0,36196,,,,,,1,1,7.244983568,18743,8572,8263,309,2,307
17669,9873,10546,1,2,34127,,,,,,1,1,6.827195015,17956,7953,7688,265,2,263
17669,11275,10457,4,2,36145,,,,,,1,1,7.312509497,18144,8835,8504,331,6,325
17669,10977,10956,0,0,36569,,,,,,1,1,6.895035092,18805,8715,8381,334,2,332
17669,10885,9478,0,0,38023,,,,,,1,1,7.58554395,18902,9401,9082,319,3,316
17669,10152,9606,2,1,37041,,,,,,1,1,7.18805528,18909,8912,8604,308,2,306
17669,10887,10116,1,0,37406,,,,,,1,1,7.133227222,19019,9028,8697,331,3,328
17669,9282,10863,1,0,36880,,,,,,1,1,6.760747811,18922,8826,8520,306,1,305
