key_bits,recovered_zeros_x,recovered_zeros_y,wrong_zeros_x,wrong_zeros_y,queries,traces,calibration_traces,threshold,tpr,tnr,attack_tpr,attack_tnr,duration_seconds,test_outcomes_0_false,test_outcomes_0_true,test_outcomes_1_false,test_outcomes_1_true,test_outcomes_2_false,test_outcomes_2_true
17669,7777,10020,0,0,1055,317530,203094,12487,1,0.986,1,0.9958333333333333,58.455129123,160,143,79,64,1,63
17669,9142,8736,0,0,1989,404676,203948,12489,0.996,0.99,1,1,91.821420023,321,209,134,75,0,75
17669,8069,9626,2,0,1322,338458,204424,12488,0.996,0.978,1,1,105.329525001,175,140,73,67,0,67
17669,9035,8785,0,0,3521,560022,203675,12498,0.998,0.982,1,1,128.972254426,686,359,273,86,0,86
17669,9001,9034,0,0,2299,438910,205941,12483,0.996,0.982,1,1,142.46425798,342,249,164,85,0,85
17669,9113,8585,0,0,5997,810175,203466,12489,0.994,0.982,1,1,153.945271469,1213,609,490,119,0,119
17669,7916,9794,2,0,4725,682790,203702,12500,0.998,0.984,1,1,154.423592061,844,521,416,105,0,105
17669,8619,9062,0,0,1441,349864,204093,12489,1,0.986,1,1,66.403215364,279,193,115,78,0,78
17669,8632,9045,0,0,1841,392114,206578,12503,0.998,0.978,1,1,75.869207309,293,193,122,71,0,71
17669,10160,7665,2,0,8753,1089410,203436,12497,0.996,0.984,1,1,197.783068886,1682,964,825,139,3,136
17669,7967,9775,0,0,2301,435800,204029,12492,1,0.982,1,0.991701244813278,79.734360513,483,333,236,97,4,93
17669,9292,8453,0,0,3325,540529,205111,12489,0.996,0.972,1,1,106.410243324,560,353,249,104,0,104
17669,8593,9110,0,0,2261,432100,203741,12486,0.996,0.982,1,1,97.599471735,354,243,161,82,0,82
17669,8351,9323,0,0,4810,689666,204054,12496,0.998,0.992,1,1,134.271071178,1004,630,493,137,1,136
17669,7790,9913,0,0,1364,342070,204398,12500,1,0.984,1,0.986449864498645,62.510117598,270,175,96,79,3,76
17669,9221,8459,1,0,2346,441684,205028,12396,1,1,0.997624703087886,0.9993351063829787,149.632299235,1037,592,467,125,0,125
17669,7456,10218,0,0,3460,554435,204398,12493,0.994,0.982,1,1,115.274362425,595,360,247,113,0,113
17669,8922,8969,0,0,2817,490371,206719,12490,1,0.978,1,0.9908906882591093,133.216408268,699,394,287,107,2,105
17669,8402,9402,0,0,2782,486136,203703,12486,0.984,0.978,1,1,95.695116216,352,242,160,82,0,82
17669,8519,9201,2,0,2064,413459,203814,12485,0.996,0.976,1,1,78.418498035,288,223,130,93,1,92
17669,8346,9384,0,0,3763,585622,204954,12484,0.99,0.98,1,1,115.099993078,496,321,226,95,0,95
17669,7988,9686,0,2,4652,674568,204415,12490,0.994,0.992,1,1,127.001680343,1034,575,436,139,2,137
17669,10183,7693,0,0,17555,2016054,205033,12473,0.988,0.976,1,1,382.032680626,2795,1437,1283,154,0,154
17669,8139,9547,0,0,2324,439653,203997,12505,1,0.988,1,1,97.937920297,562,321,225,96,1,95
17669,8671,9058,2,0,6911,902049,204768,12495,0.986,0.982,1,1,166.714107144,965,582,450,132,3,129
17669,8964,8733,0,0,6107,831240,204563,12474,0.988,0.986,1,1,197.006196129,874,504,387,117,1,116
17669,8432,9393,0,2,7169,927681,204106,12413,0.998,1,1,1,249.12476449,2097,989,833,156,0,156
17669,8998,8925,0,0,3675,575511,204492,12489,1,0.986,1,0.9950980392156863,108.770604488,998,534,429,105,1,104
17669,8479,9308,0,0,1605,366305,204540,12487,0.998,0.958,1,1,67.336194536,235,172,104,68,0,68
17669,9347,8381,0,0,2015,407135,203788,12501,0.98,0.988,1,1,126.730466124,239,178,104,74,0,74
17669,8794,8891,0,2,4706,681374,204706,12485,0.978,0.97,1,1,123.395133006,655,390,279,111,0,111
17669,9019,8656,0,0,1831,389071,204232,12487,0.998,0.978,1,1,102.083304779,277,197,124,73,0,73
17669,8917,8871,0,0,4317,639911,203588,12490,1,0.974,1,1,132.658224677,1073,641,505,136,0,136
17669,384,17664,0,62,425,247177,204210,12473,0.996,0.982,0.5460992907801419,NaN,53.595427802,0,47,0,47,0,47
17669,8664,9187,0,0,2138,420654,204310,12479,0.992,0.986,1,1,88.967883968,352,218,138,80,0,80
17669,9136,8785,0,0,3062,513028,204440,12514,0.998,0.974,1,1,176.914510893,541,328,245,83,1,82
17669,8785,8889,2,0,8845,1095215,203480,12497,1,0.982,1,0.9943563558183284,199.503855902,2494,1382,1220,162,7,155
17669,9710,7979,0,0,2138,421042,204948,12487,0.998,0.974,1,1,102.833122036,308,230,145,85,0,85
17669,8011,9664,0,0,3788,586149,203769,12496,0.998,0.982,0.9968,1,237.30754486,661,398,284,114,1,113
17669,7540,10452,0,0,1922,397489,203591,12494,0.998,0.98,1,1,100.514101658,301,194,109,85,0,85
17669,9042,8632,0,0,1531,358806,204275,12499,0.992,0.988,1,1,101.430996953,225,161,92,69,0,69
17669,7769,10071,0,0,1527,357375,203373,12485,0.988,0.988,1,1,90.923204865,160,136,67,69,0,69
17669,9496,8272,0,0,2944,500709,203749,12497,0.99,0.988,1,1,91.551019039,370,262,178,84,0,84
17669,8238,9452,0,0,4078,615459,203544,12486,0.992,0.978,1,1,116.240377756,727,436,329,107,0,107
17669,8487,9270,0,0,1151,319990,203823,12479,1,0.984,1,1,139.974150484,204,153,86,67,0,67
17669,9200,8798,0,0,1105,315463,203957,12489,1,0.974,1,0.9847908745247148,98.999715849,181,148,82,66,0,66
17669,8571,9106,0,0,4212,629049,204488,12481,0.994,0.978,1,1,135.341558722,786,442,338,104,0,104
17669,8331,9352,0,0,4424,650447,204217,12503,1,0.972,1,0.9994359842075579,132.920737968,1256,639,517,122,0,122
17669,8787,8887,0,0,2738,480641,203730,12499,1,0.988,1,1,92.614519003,640,397,294,103,3,100
17669,8916,8835,0,0,1257,330304,203704,12481,0.998,0.97,1,1,85.872163445,156,135,70,65,0,65
17669,8689,9008,0,0,2266,431648,203661,12501,0.994,0.98,1,1,105.340886606,389,228,142,86,0,86
17669,9313,8624,0,0,2232,428592,203627,12502,0.998,0.974,1,1,85.921189174,306,249,159,90,0,90
17669,9124,8552,0,0,1894,400777,203840,12497,0.998,0.976,1,1,98.826547491,298,199,124,75,0,75
17669,9019,8918,2,0,6932,903747,203981,12508,0.99,0.98,1,1,165.984928901,1002,591,476,115,0,115
17669,9828,7894,0,0,3360,543729,203528,12499,0.992,0.988,1,1,113.784627777,511,382,278,104,0,104
17669,9858,7869,0,0,1286,334266,203948,12490,0.994,0.99,1,1,116.870808778,171,134,66,68,0,68
17669,9498,8385,0,0,4920,699909,203545,12488,0.986,0.988,1,1,186.732442218,688,416,326,90,0,90
17669,7470,10212,0,0,1314,337095,204456,12488,1,0.982,1,0.9935483870967742,131.121328576,202,183,107,76,1,75
17669,8859,9099,0,0,2141,420423,204628,12493,0.996,0.984,1,1,91.252916012,317,233,154,79,0,79
17669,8940,8911,0,0,2392,451087,204464,12483,0.99,0.978,1,1,89.334990772,306,209,139,70,0,70
17669,8646,9135,0,0,3038,510734,204461,12493,0.98,0.976,1,1,146.299905278,394,253,159,94,0,94
17669,9147,8542,0,0,1861,392280,204281,12490,0.992,0.982,1,1,75.781918892,266,205,132,73,0,73
17669,9824,7853,0,0,3619,569759,204580,12491,0.998,0.988,1,1,109.227984903,612,377,267,110,0,110
17669,8756,8921,0,0,2682,475199,204782,12481,0.998,0.984,1,1,87.920854949,468,272,180,92,0,92
17669,8691,9078,0,0,1764,381609,203657,12495,0.996,0.978,1,1,108.191656591,255,192,119,73,0,73
17669,8348,9334,0,0,4435,651770,203942,12501,0.994,0.988,1,1,133.425044076,767,477,353,124,0,124
17669,8917,8903,0,0,4041,611934,204350,12493,0.99,0.982,1,1,115.10805583,558,338,235,103,0,103
17669,8317,9398,0,0,4157,623369,203970,12474,0.996,0.992,1,1,122.121078907,912,514,398,116,0,116
17669,8759,8922,0,0,2182,425586,204538,12480,0.998,0.982,1,1,81.703043977,337,234,150,84,0,84
17669,9088,8645,0,0,1444,349339,203604,12491,1,0.984,1,0.9976359338061466,94.159679789,299,196,124,72,0,72
17669,8808,8924,0,0,4624,673145,204167,12493,0.99,0.98,1,1,161.258855729,633,394,277,117,0,117
17669,8390,9296,2,2,2398,446686,203935,12426,0.998,0.998,1,1,96.384920864,530,288,196,92,0,92
17669,8289,9400,2,0,4424,650982,204175,12485,0.996,0.978,1,1,180.970458958,771,481,369,112,1,111
17669,9679,8025,0,0,2619,468492,203798,12488,0.99,0.984,1,1,169.316268612,350,219,140,79,0,79
17669,9173,8509,0,0,3645,572302,204069,12490,0.996,0.984,1,1,111.088642117,619,395,292,103,0,103
17669,1152,16896,0,52,441,248376,203973,12491,0.994,0.986,0.5172413793103449,1,72.3266823,0,49,0,49,2,47
17669,8202,9750,0,0,5864,794913,203905,12489,0.994,0.992,1,1,149.775677408,1279,758,629,129,0,129
17669,8809,9042,0,0,3250,531530,203870,12494,0.996,0.976,1,1,122.809697584,521,353,251,102,1,101
17669,8394,9357,0,0,1839,389743,204684,12490,0.996,0.978,1,1,78.783236201,245,207,130,77,0,77
17669,9082,8604,2,0,2555,462326,204415,12493,0.998,0.986,1,1,132.846554738,417,271,182,89,0,89
17669,8678,9298,0,0,1990,405175,203358,12487,0.986,0.988,1,1,85.173472745,244,173,101,72,1,71
17669,8616,9180,0,0,1379,342864,203811,12487,0.996,0.978,1,1,83.363960919,169,155,89,66,0,66
17669,9653,8038,0,0,1487,354304,204196,12495,0.998,0.984,1,1,68.069183983,190,163,90,73,0,73
17669,9004,8714,0,0,3228,529124,203386,12485,0.988,0.988,1,1,106.212074656,441,271,182,89,0,89
17669,8750,9236,0,0,2079,414052,203816,12490,0.994,0.982,1,1,177.981140952,300,227,143,84,0,84
17669,10432,7283,0,0,1417,346325,203434,12489,1,0.986,1,0.9944903581267218,150.042067092,241,198,122,76,0,76
17669,8917,8761,0,0,21550,2378563,204017,12502,0.994,0.988,1,1,458.350142147,4572,2286,2076,210,0,210
17669,8237,9805,0,0,3042,511998,205135,12490,0.998,0.988,0.9980430528375733,1,99.507262264,459,313,214,99,0,99
17669,1152,16896,3,55,431,247090,203568,12489,1,0.976,0.5384615384615384,0.5,61.743447887,0,49,2,47,0,47
17669,7713,10222,0,0,4004,609434,204920,12487,0.994,0.98,1,1,129.139285682,686,432,320,112,0,112
17669,9001,8939,0,2,2340,440729,204801,12486,0.994,0.982,1,1,157.659296546,329,263,178,85,0,85
17669,9810,8053,0,0,3383,544692,203895,12495,0.998,0.99,1,1,100.80509691500001,641,335,237,98,0,98
17669,9863,8174,0,0,987,303665,203951,12425,0.99,1,1,1,107.141312081,220,182,104,78,0,78
17669,9491,8187,0,0,9013,1114139,203653,12464,0.978,0.988,1,1,273.219017954,1294,780,649,131,0,131
17669,8058,9632,0,0,2814,488409,204182,12496,0.994,0.986,1,1,88.270677791,463,302,215,87,0,87
17669,384,17664,1,61,423,246256,203541,12511,0.998,0.964,0.5319148936170213,NaN,45.981445526,0,47,0,47,0,47
17669,9127,8778,0,0,4317,640447,204385,12500,0.998,0.98,1,1,115.560604481,859,431,327,104,0,104
17669,8937,8932,0,0,1626,367799,203714,12498,0.998,0.984,1,1,80.73124097,224,176,102,74,0,74
17669,9024,8672,0,0,3538,560728,203712,12481,0.98,0.978,1,1,133.214505207,490,294,198,96,0,96
17669,9087,8841,0,0,1661,371737,204021,12465,1,0.99,1,1,95.843562091,464,312,225,87,0,87
17669,10000,7775,0,0,1330,338622,204423,12484,0.998,0.986,1,1,94.80188371,181,140,73,67,0,67
17669,8368,9566,0,0,1525,357769,204140,12488,1,0.982,1,0.9949367088607595,148.239337678,271,208,124,84,0,84
17669,9640,8289,0,0,2533,459291,204175,12485,0.998,0.98,1,1,111.500000511,367,283,192,91,0,91
17669,9537,8171,0,0,2265,433630,205397,12490,1,0.982,1,0.9933065595716198,86.669646207,503,331,244,87,0,87
17669,9313,8369,0,0,1961,402926,204878,12501,0.99,0.986,1,1,81.920621236,251,162,89,73,0,73
17669,384,17664,4,62,423,248108,205472,12494,0.998,0.986,0.524822695035461,NaN,66.657482493,0,47,0,47,0,47
17669,8934,8816,0,0,2148,421208,203787,12504,0.996,0.986,1,1,91.339303731,343,228,150,78,0,78
17669,9336,8620,0,0,1692,374184,203403,12492,0.996,0.982,1,1,114.62903744,256,176,103,73,0,73
17669,8467,9237,0,0,2647,474186,203992,12495,0.998,0.986,1,1,96.840040483,427,278,183,95,0,95
17669,8853,9122,0,0,3252,531565,203524,12505,0.992,0.996,1,1,133.642090652,658,406,302,104,0,104
17669,9172,8635,0,0,1427,349022,205031,12490,0.996,0.98,1,1,99.332351833,219,145,79,66,0,66
17669,7685,10179,0,0,1817,387255,203813,12497,0.998,0.98,0.9971671388101983,1,69.834342752,260,194,114,80,1,79
17669,9569,8374,0,0,4484,659417,203686,12496,0.99,0.974,1,1,143.241354156,610,386,278,108,0,108
17669,8983,8745,2,0,2117,418438,204907,12476,0.998,0.988,1,1,99.204610497,338,219,135,84,0,84
17669,8314,9438,0,0,1425,348880,205249,12497,0.994,0.978,1,1,67.702370756,173,155,90,65,0,65
17669,8315,9403,0,2,2205,426989,204321,12485,1,0.982,1,0.9889349930843707,112.10999494,509,306,213,93,1,92
17669,7134,10710,0,2,5509,762076,204910,12497,0.998,0.982,1,1,149.174654315,1058,584,467,117,1,116
17669,8876,8803,0,0,6357,846546,204793,12504,0.998,0.99,1,1,269.93775714,1177,695,567,128,0,128
17669,8276,9410,0,0,1895,395874,204325,12487,0.996,0.99,1,1,80.464989936,266,201,119,82,0,82
17669,8190,9487,0,0,2880,498084,208048,12493,0.994,0.982,1,1,91.699718375,431,314,213,101,0,101
17669,8825,8861,0,0,4017,609739,204209,12495,0.998,0.988,1,1,156.774978077,678,441,329,112,0,112
17669,9462,8223,0,0,1625,367826,204315,12504,0.998,0.982,1,1,98.251806315,210,185,115,70,0,70
17669,8832,9142,0,0,863,290958,203950,12404,0.998,1,1,1,102.407545909,193,159,90,69,0,69
17669,8440,9265,0,0,1533,359107,203702,12493,0.994,0.984,1,1,65.041210082,204,169,104,65,0,65
17669,9027,8686,0,0,1800,386355,204946,12489,0.99,0.978,1,1,91.442989815,201,160,91,69,0,69
17669,10619,7329,0,0,6331,843024,204069,12497,0.994,0.978,1,1,179.39406354,1246,659,528,131,0,131
17669,8586,9116,0,0,1980,403502,203849,12487,0.998,0.988,1,0.997624703087886,117.1627488,292,209,129,80,0,80
17669,8198,9500,0,0,1417,347538,204656,12477,0.994,0.99,1,1,89.620381266,193,142,73,69,1,68
17669,8560,9151,0,0,2584,466454,204473,12490,0.992,0.982,1,1,90.986222222,404,278,186,92,0,92
17669,9098,8576,0,0,1405,345940,204212,12492,0.996,0.978,1,1,82.284939832,199,145,76,69,0,69
17669,8969,8941,0,0,4412,649174,204286,12504,0.998,0.98,1,1,166.099014694,774,468,342,126,0,126
17669,9082,8757,2,2,8388,1052453,204109,12491,0.988,0.972,1,1,212.794542665,1253,694,550,144,2,142
17669,8811,9111,0,2,1888,395507,205055,12502,0.998,0.982,1,1,104.599034046,311,189,114,75,0,75
17669,8791,9101,0,0,1119,318060,205009,12498,1,0.994,1,0.9903846153846154,121.741337844,299,195,117,78,0,78
17669,9492,8213,0,0,2730,480828,203989,12481,0.996,0.988,1,1,97.78973813,444,296,206,90,0,90
17669,9415,8632,0,0,1837,389544,203905,12496,0.996,0.976,1,1,98.514493173,265,193,111,82,0,82
17669,1152,16896,3,50,443,249511,204872,12496,0.992,0.978,0.5104895104895105,1,51.797207039,0,49,2,47,0,47
17669,9287,8498,0,0,2017,408488,204675,12490,0.994,0.972,1,1,88.653360772,306,211,131,80,0,80
17669,8652,9025,0,0,10541,1267568,204862,12476,0.996,0.976,1,1,228.77116299,2139,1098,939,159,0,159
17669,9592,8114,0,0,2943,500984,204359,12488,1,0.976,0.9573170731707317,0.9875130072840791,96.51401409,643,429,313,116,5,111
17669,8290,9399,0,0,7164,931158,204133,12509,0.998,0.978,1,1,185.883492468,1431,761,639,122,0,122
17669,8370,9464,0,2,3257,533223,203503,12491,0.982,0.986,1,1,117.545876118,434,270,171,99,1,98
17669,9414,8289,0,0,2442,450618,204505,12490,0.998,0.974,1,1,101.109263342,379,262,170,92,0,92
17669,8212,9526,0,0,2183,424088,203804,12479,0.982,0.982,1,1,125.01297286,258,190,109,81,0,81
17669,9380,8297,0,0,1466,351959,204039,12481,1,0.976,1,0.9922879177377892,115.887039553,262,204,127,77,0,77
17669,9697,8283,0,0,3326,539546,204099,12492,0.984,0.978,1,1,110.916443242,431,294,209,85,0,85
17669,9167,8594,0,0,1176,323605,204975,12405,0.994,1,1,1,71.922803492,286,201,127,74,0,74
17669,8369,9506,0,0,1453,350455,203795,12484,0.99,0.984,1,1,95.634954766,151,133,71,62,0,62
17669,9124,8589,0,0,1251,330411,204135,12503,1,0.984,1,1,75.553275239,243,162,90,72,0,72
17669,9566,8123,0,0,1871,393944,204541,12493,0.994,0.974,1,1,131.993885515,269,203,125,78,0,78
17669,9058,8635,0,2,3072,513780,203920,12494,0.996,0.988,1,1,97.824588095,485,340,247,93,0,93
17669,8761,8916,0,0,1270,332711,204498,12498,0.998,0.972,1,1,100.210749749,159,136,68,68,0,68
17669,9748,8199,2,0,5787,789993,204089,12485,0.998,0.97,1,1,167.876147702,1164,589,471,118,0,118
17669,8056,9718,2,0,1230,328914,203924,12491,0.998,0.972,1,1,80.36636459,178,121,55,66,1,65
17669,8863,8852,0,0,4204,627953,203653,12494,0.998,0.982,1,1,117.632836032,720,462,351,111,0,111
17669,9269,8451,0,0,2886,495702,204677,12467,1,0.986,1,0.9878665318503539,96.195937471,684,413,305,108,0,108
17669,8627,9047,0,0,3710,578945,204589,12417,0.998,1,1,0.996551724137931,116.171903388,1019,547,431,116,0,116
17669,8163,9512,0,0,5260,735338,204158,12484,0.994,0.984,1,1,212.282936963,954,570,453,117,0,117
17669,8360,9324,0,0,4681,676882,204159,12501,0.978,0.978,1,1,138.54565834,643,401,295,106,0,106
17669,9029,8745,0,0,1358,342301,204987,12490,0.994,0.988,1,1,66.735005827,163,150,85,65,0,65
17669,8977,8718,0,0,7714,983947,204093,12478,0.988,0.986,1,1,179.5814109,1172,627,495,132,0,132
17669,8660,9225,0,0,1988,405046,204308,12489,1,0.988,1,0.9886363636363636,75.676926414,426,278,189,89,1,88
17669,9303,8586,2,0,1545,361010,204467,12483,0.992,0.982,1,1,178.485090851,209,167,99,68,0,68
17669,8401,9300,2,0,1391,344970,204176,12489,0.996,0.982,1,1,63.15701499,180,149,79,70,0,70
17669,9006,9026,0,2,2291,436330,204974,12495,0.99,0.988,1,1,79.255354872,288,192,116,76,0,76
17669,8256,9424,0,0,3025,509166,203868,12503,1,0.98,1,1,97.194540987,733,433,321,112,0,112
17669,7131,10581,0,2,7966,1009679,205957,12499,0.98,0.994,1,1,189.551266649,1331,754,602,152,1,151
17669,8664,9014,0,0,26035,2831506,204786,12491,0.994,0.984,1,0.9998768017740545,536.508246263,5564,2759,2551,208,2,206
17669,10051,7652,0,0,2560,462875,204014,12497,0.996,0.984,1,1,104.419329794,414,274,186,88,0,88
17669,9618,8133,2,0,1102,316393,205243,12492,1,0.974,1,0.9962546816479401,61.204294921,199,138,68,70,0,70
17669,8046,9667,0,0,1632,369140,204707,12491,0.992,0.984,1,1,71.177226297,210,182,108,74,0,74
17669,8589,9087,0,0,4044,614525,204899,12499,0.996,0.982,1,1,132.360792533,757,418,317,101,0,101
17669,8079,9955,0,0,1089,313785,204007,12502,1,0.99,1,0.9944289693593314,59.843654308,246,196,111,85,2,83
17669,8980,9047,0,0,2110,416751,203784,12486,0.992,0.988,1,1,79.606735129,306,228,141,87,0,87
17669,10463,7212,0,0,1708,375597,203378,12471,0.994,0.99,1,1,98.971077927,225,190,117,73,0,73
17669,8082,9871,0,0,2034,409811,203815,12497,0.998,0.978,1,1,75.731204322,319,210,128,82,0,82
17669,8662,9035,0,2,2299,436532,204192,12484,0.996,0.978,1,1,117.058448312,381,242,162,80,1,79
17669,10151,7545,0,2,3979,606355,204526,12489,0.994,0.982,1,1,143.213697069,702,425,319,106,0,106
17669,8691,9034,0,0,1585,365041,204774,12507,0.998,0.986,1,1,95.099390595,233,165,92,73,0,73
17669,10089,7667,0,0,1390,344484,203966,12477,0.994,0.97,1,1,65.400522872,203,141,78,63,0,63
17669,9429,8593,0,2,5250,733680,203889,12496,0.988,0.976,1,1,133.260382767,723,450,331,119,1,118
17669,9316,8364,0,0,11947,1410726,205513,12489,0.99,0.974,1,1,254.525336624,1894,953,804,149,0,149
17669,8458,9461,4,2,6451,854487,204169,12480,0.986,0.978,0.9946879150066401,1,299.883940758,948,534,423,111,3,108
17669,9019,8691,2,0,7153,927447,203997,12483,0.992,0.978,1,1,172.056337939,1351,755,606,149,6,143
17669,8506,9221,0,0,1505,357388,205402,12485,0.996,0.984,1,1,126.314655976,214,157,86,71,0,71
17669,9341,8340,0,0,3243,531961,203838,12506,0.996,0.97,1,1,153.960442481,564,347,256,91,0,91
17669,9893,7782,0,0,3306,538095,204389,12490,0.996,0.986,1,1,125.144596674,555,355,253,102,1,101
17669,8315,9361,0,0,2631,471636,203918,12502,0.998,0.98,1,1,129.84284165,432,281,193,88,0,88
17669,9282,8729,0,0,1503,357000,204314,12479,0.994,0.976,1,1,97.609108713,207,151,81,70,0,70
17669,8453,9287,2,0,1385,344725,204155,12495,0.994,0.98,1,1,72.148560325,179,148,80,68,1,67
17669,9519,8338,0,0,6187,828108,203809,12489,0.992,0.986,1,1,155.896536441,1241,639,520,119,0,119
17669,8868,8870,0,0,1983,404651,204104,12486,1,0.982,1,0.9791666666666666,105.675768146,428,280,194,86,2,84
17669,9162,8512,0,0,1312,336963,204359,12496,0.998,0.992,1,1,64.608478617,231,173,103,70,2,68
17669,8566,9203,0,2,1434,350114,205322,12485,0.996,0.986,1,1,79.427890673,171,162,93,69,0,69
17669,8147,9527,0,0,7288,940609,204905,12484,0.996,0.988,1,1,186.00020823,1406,780,640,140,0,140
17669,8397,9361,0,0,3550,561871,204072,12495,0.998,0.988,1,1,106.471481115,660,370,278,92,0,92
17669,9159,8516,0,0,2735,479997,203746,12499,0.986,0.976,1,1,90.26664899,390,222,145,77,0,77
17669,9503,8549,0,0,2739,480199,203966,12490,0.992,0.968,1,1,90.414623035,474,269,170,99,0,99
17669,9217,8458,0,0,2324,442507,206624,12489,0.992,0.982,1,1,102.948896877,327,254,162,92,0,92
17669,7990,9734,0,0,1896,395960,204360,12471,0.99,0.984,1,1,118.097302502,226,162,90,72,0,72
17669,8868,8819,0,0,1785,386427,204324,12509,0.998,0.984,1,1,117.999766536,242,191,113,78,0,78
17669,8929,8758,0,2,1446,350264,204374,12482,0.992,0.98,1,1,69.94671464,188,154,90,64,0,64
17669,8445,9239,0,0,1634,370367,205663,12494,0.986,0.98,1,1,73.71661956,165,150,77,73,0,73
17669,8542,9472,0,0,9330,1145613,204075,12477,0.992,0.978,1,1,215.384460081,1823,999,841,158,1,157
17669,8261,9552,0,0,1601,365468,203887,12498,0.994,0.982,1,1,72.119691193,224,173,101,72,0,72
17669,8276,9428,0,0,2229,429082,204236,12497,0.992,0.982,1,0.998003992015968,87.971427091,369,219,132,87,0,87
17669,9568,8114,0,0,5658,774280,203838,12495,0.99,0.994,1,1,141.587332282,953,532,406,126,1,125
17669,9121,8816,0,0,1749,380170,203836,12489,0.992,0.978,1,1,80.61487193,257,184,106,78,1,77
17669,9167,8513,0,0,3387,546195,204688,12502,0.99,0.976,1,1,142.513996585,451,286,198,88,0,88
17669,8939,8751,0,0,2766,483738,203966,12497,0.998,0.984,1,1,102.417865059,485,292,209,83,0,83
17669,9534,8156,0,0,2420,447623,203803,12479,0.986,0.984,1,1,90.963474718,253,232,155,77,1,76
17669,8883,8963,0,0,1830,388444,204043,12488,0.998,0.984,1,1,73.889521314,284,192,117,75,0,75
17669,8749,9118,0,0,4064,614663,204031,12484,0.996,0.982,1,1,119.796461949,696,438,329,109,0,109
17669,7877,10115,2,0,1355,341270,203967,12489,0.994,0.99,1,1,86.11892862,184,141,73,68,0,68
17669,9622,8062,0,0,3382,545263,203974,12498,1,0.976,1,0.9974554707379135,105.153751603,772,515,407,108,0,108
17669,8127,9569,0,0,2917,498655,203747,12491,0.996,0.962,1,1,94.811324045,476,309,213,96,0,96
17669,10229,7467,0,0,1380,343673,204747,12491,0.994,0.978,1,1,73.332428352,172,152,85,67,0,67
17669,8982,8952,0,0,2621,468423,204119,12498,0.99,0.966,1,1,158.192585792,306,238,154,84,0,84
17669,9393,7828,0,0,86640,8957739,204368,12501,0.998,0.972,1,1,1620.853143597,19363,9349,9082,267,3,264
17669,9055,8630,1,1,1774,382370,203485,12490,0.992,0.982,0.9829545454545454,1,70.707764849,242,182,94,88,6,82
17669,10043,7672,0,0,1284,333216,203841,12500,1,0.972,1,0.9970059880239521,80.292402942,234,172,100,72,0,72
17669,7894,9810,0,0,4493,657631,204479,12486,1,0.982,1,0.9964454976303317,138.777459243,1169,657,519,138,0,138
17669,8873,8965,0,0,2073,413775,204593,12485,0.98,0.972,1,1,126.159449858,199,194,122,72,0,72
17669,7785,10244,0,0,1504,359528,204208,12399,0.992,0.998,1,1,111.895279122,257,206,123,83,0,83
17669,9892,7920,0,0,3861,599355,204868,12496,0.996,0.98,1,1,145.888023673,635,403,290,113,0,113
17669,8786,8904,0,0,1782,385531,205289,12482,0.998,0.986,1,1,178.684815344,274,186,111,75,0,75
17669,8448,9234,0,0,1322,338863,205430,12497,0.996,0.978,1,1,63.692223898,181,136,68,68,0,68
17669,9816,8082,2,0,12860,1504107,205770,12479,0.996,0.986,1,0.9997402597402597,390.156389686,2644,1357,1205,152,1,151
17669,8504,9197,0,0,2817,488356,204772,12490,0.998,0.984,1,1,102.857789805,425,318,226,92,1,91
17669,8120,9564,0,0,3257,532266,203963,12493,0.998,0.976,1,0.9987515605493134,107.716025527,522,365,279,86,0,86
17669,8338,9648,0,0,4399,648649,204870,12495,0.982,0.986,1,1,122.145346408,585,361,248,113,0,113
17669,9931,7870,0,0,2661,472024,203580,12481,0.994,0.99,1,1,87.159324226,386,297,200,97,0,97
17669,9832,7846,0,0,1591,365359,205060,12493,1,0.984,1,1,73.720943292,295,229,153,76,0,76
17669,9198,8489,0,0,1290,334030,203845,12493,0.998,0.98,1,1,119.465550707,189,124,57,67,0,67
17669,9034,8888,2,0,1629,367756,203628,12491,0.994,0.976,1,1,84.010826204,234,169,95,74,0,74
17669,9003,8691,0,0,2399,445766,203758,12500,0.996,0.988,1,1,142.853218914,372,257,167,90,0,90
17669,8352,9400,2,0,1804,385866,203680,12498,1,0.98,1,0.9982046678635548,96.425131433,392,248,164,84,1,83
17669,7992,9689,0,0,1511,357420,204665,12501,0.994,0.974,1,1,89.652504865,196,166,96,70,0,70
17669,8158,9548,0,2,2473,454362,204715,12482,0.994,0.978,1,1,163.040984504,408,259,172,87,0,87
17669,9334,8540,6,5,1239,329149,203812,12489,0.996,0.992,0.8439306358381503,1,83.820988375,138,198,115,83,18,65
17669,9359,8342,2,0,3297,535669,203434,12490,0.998,0.978,1,1,159.752300036,546,358,266,92,1,91
17669,8413,9276,0,3,2321,438069,204199,12472,0.992,0.988,0.9975308641975309,1,81.373533222,384,243,162,81,0,81
17669,9618,8073,0,0,2731,479555,204175,12501,1,0.982,1,0.9988518943742825,114.475924639,583,398,287,111,1,110
17669,8668,9032,0,0,1780,383932,204540,12490,0.996,0.982,1,1,70.556718233,251,193,119,74,1,73
17669,9100,8611,0,0,2445,451449,204230,12480,0.998,0.974,1,1,83.163801146,438,244,158,86,0,86
17669,7954,9796,0,0,1842,389787,204152,12491,1,0.978,1,0.9838709677419355,79.742766734,394,250,160,90,4,86
17669,9763,7927,0,0,2192,425580,204558,12493,0.994,0.974,1,1,94.282845554,333,238,155,83,0,83
17669,9935,7749,0,0,1476,352229,203496,12501,0.994,0.982,1,1,114.479231573,214,152,87,65,0,65
17669,8320,9390,2,0,5769,786079,204471,12506,0.998,0.984,1,1,200.455029722,1044,638,519,119,3,116
17669,8412,9618,4,0,1515,357037,204252,12479,1,0.986,1,0.9954337899543378,103.807861668,300,211,137,74,1,73
17669,9295,8464,0,0,774,281785,203858,12495,1,0.992,1,0.9922779922779923,70.551380462,186,134,72,62,1,61
17669,7795,9910,0,0,2386,444897,204040,12492,1,0.984,1,0.9935979513444302,99.410787095,547,334,234,100,0,100
17669,8594,9151,0,0,2090,422318,205959,12490,0.998,0.97,1,1,92.257379562,275,237,155,82,0,82
17669,9470,8256,0,2,2899,497438,204863,12501,0.994,0.984,1,1,138.956439283,455,320,230,90,1,89
17669,7769,9921,0,0,2911,498866,204230,12492,1,0.982,1,0.996993987975952,99.032148724,665,434,333,101,0,101
17669,9690,8002,2,0,989,304403,204381,12423,0.992,1,1,1,128.886484869,228,177,103,74,0,74
17669,9724,8199,4,0,1860,391852,203944,12497,1,0.972,0.964200477326969,0.9957716701902748,97.746390031,297,256,173,83,3,80
17669,8433,9427,2,0,3571,564345,203635,12488,0.988,0.984,1,1,140.210680996,463,306,208,98,0,98
17669,9087,8613,0,0,3751,583715,205241,12489,0.994,0.984,1,1,117.450861853,632,411,311,100,0,100
17669,8922,8757,0,0,5093,720395,204809,12476,0.996,0.98,1,1,161.330330179,989,531,419,112,0,112
17669,8494,9226,2,0,3364,545973,205054,12469,0.994,0.976,1,1,102.730891553,557,368,268,100,2,98
17669,8740,9057,0,0,2507,457232,204197,12490,0.99,0.986,1,1,93.138604545,291,230,151,79,1,78
17669,9275,8675,0,0,3169,523740,204212,12502,0.992,0.982,1,1,101.576777665,529,329,236,93,0,93
17669,8839,8961,0,0,7176,934332,204873,12493,0.998,0.982,1,1,178.850620345,1465,756,643,113,0,113
17669,9029,8693,0,0,1243,330405,204695,12500,1,0.978,1,0.9936507936507937,66.203986046,219,167,96,71,0,71
17669,384,17664,1,56,429,247407,204190,12472,0.992,0.976,0.5390070921985816,NaN,55.028214361,0,47,0,47,0,47
17669,9387,8299,0,2,1649,369989,203648,12427,1,0.996,1,1,67.086321527,491,297,208,89,0,89
17669,9164,8519,0,0,3002,507641,204287,12482,0.984,0.986,1,1,97.125840224,371,263,174,89,0,89
17669,7945,9779,0,0,2426,457469,206425,12487,0.996,0.978,1,1,153.541603801,361,266,179,87,0,87
17669,8280,9416,0,0,1194,324241,203745,12482,0.998,0.986,1,1,63.909712771,136,125,59,66,0,66
17669,9203,8535,0,0,1341,340619,204874,12499,0.998,0.972,1,1,82.168203055,189,140,75,65,0,65
17669,9353,8347,0,0,4840,694435,204337,12496,0.998,0.984,1,1,128.081310494,934,497,382,115,0,115
17669,8762,8932,0,0,2211,427923,204201,12498,0.996,0.986,1,1,78.979254209,339,237,154,83,0,83
17669,9384,8293,2,0,3471,555799,205698,12478,0.99,0.978,1,1,115.567262131,458,290,200,90,0,90
17669,8823,8895,0,0,2573,465345,204889,12487,0.996,0.992,1,1,94.998947076,537,326,233,93,0,93
17669,8985,9037,0,0,1229,332057,204747,12486,1,0.984,1,0.9905956112852664,83.8646215,235,157,84,73,0,73
17669,7861,9813,0,0,17718,1993351,204646,12499,0.998,0.978,1,1,363.84049989,3702,1885,1699,186,0,186
17669,9859,7834,0,0,3080,515457,203849,12497,0.998,0.978,1,1,138.122984614,569,308,212,96,0,96
17669,9136,8573,0,0,9599,1172370,204335,12496,1,0.98,1,0.9920019389238972,232.576509996,2811,1480,1313,167,2,165
17669,9225,8452,0,0,5001,708668,203821,12488,0.996,0.984,1,1,167.185178116,906,539,424,115,0,115
17669,8035,9639,0,0,2539,461481,205415,12486,1,0.978,1,0.9940191387559809,102.64075871,584,356,251,105,1,104
17669,8566,9132,0,0,1392,344678,204196,12480,0.996,0.988,1,1,77.832088527,202,140,73,67,0,67
17669,7354,10436,0,0,2310,436703,203551,12474,0.988,0.978,1,1,79.517498783,256,202,120,82,0,82
17669,9070,8853,0,0,1991,406185,204962,12501,0.996,0.976,1,1,105.793878941,317,205,126,79,0,79
17669,9134,8814,0,2,2184,425585,204648,12490,1,0.99,1,0.9907216494845361,98.593530908,674,399,296,103,0,103
17669,9175,8515,0,0,1875,393812,203997,12492,0.998,0.982,1,1,93.843252567,276,195,111,84,0,84
17669,8251,9442,0,0,1895,395965,204008,12495,0.996,0.968,1,1,73.163132521,267,204,130,74,0,74
17669,10076,7640,0,0,1683,373463,203809,12510,1,0.976,1,0.9912854030501089,107.26661084,309,235,149,86,1,85
17669,9434,8451,0,0,6004,808883,203845,12420,0.994,1,1,1,151.355708375,1665,890,751,139,0,139
17669,9857,7820,0,0,6929,902398,204437,12493,0.986,0.984,1,1,166.895356354,1006,580,463,117,0,117
17669,9236,8452,0,0,2398,447180,205477,12491,0.994,0.984,1,1,162.831466596,376,254,167,87,0,87
17669,9085,8618,0,0,3302,538914,204770,12487,0.994,0.986,1,1,151.107722666,588,345,248,97,1,96
17669,8116,9574,0,0,2180,424379,204178,12488,0.992,0.986,1,1,95.430142838,339,227,142,85,1,84
17669,9203,8825,3,0,2215,428798,204734,12489,1,0.978,0.9762376237623762,0.9985714285714286,97.190705642,487,310,212,98,1,97
17669,8733,8955,0,0,2778,484555,203734,12483,0.998,0.978,1,1,88.76076527,399,315,231,84,0,84
17669,8933,8760,0,0,2443,450653,204130,12473,0.994,0.97,1,1,89.744310511,381,265,180,85,1,84
17669,8064,9635,0,2,1267,336449,205771,12510,0.996,0.984,1,1,69.032516829,147,139,73,66,0,66
17669,9533,8291,0,0,1876,392908,203754,12484,0.964,0.992,1,1,130.150837971,251,193,120,73,0,73
17669,9474,8448,0,2,1532,358164,203358,12488,1,0.972,1,0.9868766404199475,67.163915649,244,218,136,82,1,81
17669,9271,8420,0,0,2579,465473,205102,12486,0.996,0.982,0.9956236323851203,1,97.958232218,411,279,189,90,2,88
17669,9339,8448,0,0,1413,346384,203711,12490,0.984,0.994,1,1,69.149225375,202,146,79,67,0,67
17669,9130,8558,0,0,2595,466720,204216,12495,0.996,0.992,1,1,134.514001164,516,337,237,100,0,100
17669,8827,9187,0,0,1927,398582,204176,12494,0.998,0.974,1,1,138.917822902,300,193,113,80,0,80
17669,1536,16512,3,53,442,249760,205245,12489,0.988,0.984,0.5104895104895105,1,67.556287505,1,49,2,47,0,47
17669,7993,9068,4,2,55302,5793679,204059,12487,1,0.982,1,0.9963368634846946,1087.062563915,19019,8770,8547,223,6,217
17669,9312,8364,0,0,4938,703089,203637,12480,0.994,0.98,1,1,182.647167512,879,528,407,121,0,121
17669,8832,8848,0,0,1943,400260,204246,12496,0.994,0.982,1,1,88.374323821,274,205,119,86,0,86
17669,7498,10484,0,0,4921,703656,206662,12504,0.998,0.978,1,1,189.130315253,882,532,413,119,0,119
17669,9859,8090,0,0,2097,415224,204034,12498,0.996,0.976,1,0.997867803837953,90.409286006,319,227,150,77,0,77
17669,8974,8716,0,0,3884,607724,204899,12493,0.998,0.99,1,1,139.158241905,685,416,310,106,0,106
17669,9021,8654,0,0,3671,574862,203812,12471,0.996,0.986,1,1,112.513989641,621,401,299,102,0,102
17669,9329,8378,0,0,3575,567567,203564,12490,1,0.982,1,0.9984472049689441,106.04730878,885,522,402,120,1,119
17669,8499,9208,0,2,2613,467574,203911,12486,1,0.986,1,0.992196209587514,154.813763493,618,375,276,99,3,96
17669,9950,7727,0,0,1640,371383,205949,12493,1,0.982,1,0.9937369519832986,98.543703352,330,228,149,79,0,79
17669,8973,9064,4,3,4371,645801,203732,12490,1,0.972,1,0.9938309685379395,145.142880231,1099,652,519,133,3,130
17669,9586,8451,0,0,3776,584403,204081,12490,0.998,0.974,1,1,115.401102719,684,380,274,106,0,106
17669,8819,8991,0,0,1212,328069,205387,12483,1,0.978,1,0.9904153354632588,84.541567256,224,158,87,71,2,69
17669,8885,8830,0,0,1547,365728,205575,12501,0.996,0.984,1,1,87.662178852,246,151,77,74,0,74
17669,8095,9590,0,0,2679,474051,203706,12497,0.986,0.976,1,1,97.290921615,322,239,160,79,0,79
17669,8606,9111,0,0,1725,378047,203807,12501,0.99,0.98,1,1,73.84797192,181,157,83,74,0,74
17669,7852,9822,0,0,2451,452522,204637,12476,0.994,0.982,1,1,152.315974996,398,250,154,96,1,95
17669,8891,8826,0,0,1609,366946,203937,12487,1,0.974,1,0.997872340425532,126.237538051,325,223,145,78,0,78
17669,8607,9088,0,0,1634,368862,203878,12469,0.978,0.994,1,1,80.767344282,235,167,97,70,0,70
17669,9944,7959,2,0,2104,416554,204043,12489,1,0.978,1,0.9887323943661972,87.7896132,507,289,202,87,1,86
17669,9393,8287,0,0,3487,558223,205968,12493,0.996,0.978,1,1,126.226905606,577,379,275,104,0,104
17669,8532,9208,0,0,1294,335720,204923,12477,0.996,0.976,1,1,83.132559454,172,135,70,65,0,65
17669,8727,9022,0,2,5621,772026,204299,12493,0.988,0.968,1,1,155.555473081,842,461,365,96,1,95
17669,9019,8659,0,0,8972,1113783,205423,12484,0.992,0.984,1,1,209.749968172,1733,950,788,162,0,162
17669,8985,8733,0,0,1511,356543,203960,12483,0.992,0.99,1,1,93.126499582,208,159,91,68,0,68
17669,9006,8803,0,0,1412,346740,204388,12492,0.998,0.98,1,1,76.551401993,180,154,88,66,0,66
17669,8934,8801,0,0,1360,341939,204719,12418,0.996,0.998,1,1,65.145414036,259,173,99,74,0,74
17669,8798,8878,0,0,5415,752591,206219,12496,0.988,0.974,1,1,138.430412721,777,464,370,94,0,94
17669,8450,9283,0,4,2364,443137,203883,12493,0.996,0.978,1,1,152.735626516,367,256,169,87,0,87
17669,9431,8266,0,0,1351,340526,203816,12488,0.992,0.976,1,1,135.522167,179,143,74,69,0,69
17669,9324,8376,0,0,1678,375572,206108,12493,0.998,0.98,1,1,83.337291223,250,178,107,71,0,71
17669,9232,8731,0,2,1910,399026,204861,12486,1,0.984,1,0.9982394366197183,79.424371478,380,274,187,87,1,86
17669,8804,8879,0,0,8917,1105001,203568,12498,0.996,0.978,1,1,225.932219967,1749,958,805,153,1,152
17669,8886,8808,0,0,2154,427280,208959,12497,0.998,0.988,1,1,97.280594587,338,220,134,86,0,86
17669,8712,8993,0,0,2050,411429,204652,12479,0.996,0.988,1,1,77.124578731,284,224,143,81,0,81
17669,9815,7859,0,0,9467,1157776,203828,12472,1,0.986,1,0.9831307367898784,242.384990136,2751,1446,1270,176,10,166
17669,8946,8763,2,0,2615,471545,204149,12487,1,0.986,1,0.9965870307167235,138.601720725,604,376,275,101,0,101
17669,10297,7493,0,0,3035,511975,205513,12481,0.996,0.984,1,1,181.83081719,520,319,222,97,0,97
17669,8156,9682,2,0,1385,344311,204588,12495,0.994,0.982,1,1,78.453570345,185,148,84,64,1,63
17669,8195,9549,0,0,4880,704290,209586,12478,0.982,0.988,1,1,160.213543548,686,416,319,97,0,97
17669,8282,9395,0,0,1780,383781,203609,12500,0.996,0.982,1,1,110.96695486,278,184,109,75,0,75
17669,10061,7820,0,0,4425,651594,203727,12489,0.994,0.982,1,1,117.305420651,815,469,360,109,0,109
17669,8978,8717,0,0,741,279106,204150,12399,1,1,1,1,52.406657441,263,198,116,82,0,82
17669,9200,8518,0,0,15621,1781296,203653,12485,0.998,0.976,1,1,362.108439719,3187,1693,1504,189,0,189
17669,8471,9216,0,0,3564,565622,205440,12477,0.998,0.982,1,1,162.695737709,688,356,256,100,0,100
17669,8910,8930,0,0,39188,4163776,203826,12485,0.998,0.978,1,1,796.102257443,8656,4165,3942,223,1,222
17669,8822,8853,0,0,4186,628060,205364,12497,0.996,0.978,1,1,160.733714847,754,440,323,117,0,117
17669,9300,8398,0,0,8230,1039312,204978,12467,0.992,0.986,0.9961464354527938,1,196.084269681,1384,746,599,147,2,145
17669,7862,9874,0,0,1299,335094,203541,12499,0.996,0.982,1,1,85.580602736,162,143,79,64,0,64
17669,8673,9161,2,0,6982,909981,204393,12494,0.996,0.974,1,1,165.734534427,1369,736,599,137,2,135
17669,9277,8404,2,0,1807,386466,204275,12477,0.986,0.988,1,1,91.053795481,202,161,93,68,0,68
17669,8902,9088,0,0,2861,493618,204720,12498,0.996,0.982,1,1,106.767406418,519,285,189,96,0,96
17669,8847,8833,0,0,2894,495956,203546,12491,0.99,0.986,1,1,141.731741578,360,255,161,94,0,94
17669,8280,9406,0,2,1171,322099,203871,12496,0.996,0.982,1,1,153.510009997,143,123,57,66,0,66
17669,10173,7582,0,0,1727,380267,204834,12490,1,0.982,1,0.996116504854369,113.159736959,370,231,145,86,0,86
17669,8814,8868,0,0,1409,348075,204813,12497,0.994,0.98,1,1,67.683125883,195,149,83,66,0,66
17669,8759,8927,0,0,4124,621257,204347,12420,0.994,1,1,1,129.295578597,1156,601,457,144,0,144
17669,9250,8439,0,0,3884,598290,204836,12499,0.998,0.99,1,1,108.434067037,673,385,284,101,0,101
17669,9276,8407,0,0,7810,993877,203954,12493,0.998,0.986,1,1,208.985774779,1476,862,727,135,0,135
17669,9495,8187,2,0,6060,820386,205497,12485,0.99,0.976,1,1,148.858912154,847,516,385,131,2,129
17669,8438,9339,0,0,4111,622209,204205,12498,0.994,0.974,1,1,116.282891268,710,426,319,107,0,107
17669,9546,8139,0,0,3267,533968,204480,12502,1,0.97,1,0.9975124378109452,103.693017147,824,483,381,102,1,101
17669,7927,9758,0,2,4926,702971,204950,12498,0.996,0.986,1,1,132.536205316,913,523,411,112,1,111
17669,8574,9112,0,0,2463,452867,204408,12503,1,0.986,1,0.9975369458128078,94.819239327,565,348,247,101,0,101
17669,7570,10268,0,0,1276,334181,205188,12494,0.996,0.982,1,1,88.915104541,165,136,71,65,0,65
17669,9507,8197,0,0,2192,429705,203648,12499,0.998,0.966,1,1,92.104776305,338,235,152,83,0,83
17669,8724,8950,0,0,4818,690364,203912,12472,0.994,0.988,1,1,126.916389564,840,530,418,112,0,112
17669,8740,8994,0,0,1781,383902,204425,12494,0.992,0.976,1,1,134.039593697,291,181,107,74,2,72
17669,7580,10171,0,0,1201,324943,203353,12483,0.998,0.978,1,1,67.009685284,157,122,55,67,0,67
17669,8907,8767,0,0,20736,2298436,203914,12499,1,0.974,1,0.9985689461310436,476.904304154,6784,3214,2998,216,1,215
17669,8784,9219,0,0,1772,382317,203761,12495,0.992,0.984,1,1,101.027856433,258,188,113,75,0,75
17669,8256,9472,0,0,1870,392339,203866,12492,0.98,0.982,1,1,163.725686011,201,168,97,71,0,71
17669,8783,8916,0,0,1659,372624,204226,12480,0.998,0.982,1,1,178.455831832,210,187,112,75,0,75
17669,9027,8673,0,0,1209,327387,205218,12418,1,1,1,1,106.301663324,502,304,205,99,0,99
17669,10511,7436,0,0,2355,442931,205126,12489,1,0.974,1,0.9858429858429858,127.715871814,537,334,240,94,0,94
17669,9209,8468,0,0,1960,402792,204410,12419,0.996,0.998,1,1,73.51871528,374,256,166,90,0,90
17669,8910,8779,0,0,2775,484196,204335,12505,0.996,0.968,1,1,90.971005806,436,305,216,89,0,89
17669,8861,8827,0,0,4986,710745,203975,12498,0.996,0.992,1,1,182.911647607,1120,608,484,124,0,124
17669,8924,8827,0,0,781,282867,203932,12432,0.996,1,1,1,61.492783069,177,142,76,66,0,66
17669,7600,10109,0,0,2346,441721,203885,12499,0.996,0.972,1,1,91.138448222,383,243,154,89,0,89
17669,7998,9858,0,0,1036,309045,204375,12491,1,0.974,1,0.9959514170040485,102.397234686,180,132,66,66,1,65
17669,9103,8606,0,0,2849,492611,204832,12494,0.998,0.984,1,1,138.36223415,434,319,227,92,0,92
17669,10180,7841,0,0,3087,516993,205308,12478,0.996,0.986,1,1,120.415961209,518,333,241,92,0,92
17669,7997,9682,0,0,1663,372781,203901,12484,0.992,0.99,1,1,73.250376677,245,169,97,72,0,72
17669,9712,7907,0,0,88080,9103640,204275,12501,0.998,0.98,1,0.9999305941143809,1662.540896651,19758,9321,9058,263,0,263
17669,8424,9262,0,0,2037,409947,204245,12482,0.988,0.98,1,1,79.900361994,249,177,106,71,0,71
17669,8788,9043,0,0,1550,360272,203994,12416,0.996,1,1,1,65.853139382,386,259,180,79,0,79
17669,8962,8734,0,0,1791,384673,203866,12503,0.996,0.988,1,1,97.038939485,241,199,122,77,0,77
17669,9231,8445,0,0,1830,389428,204625,12411,0.996,0.996,1,1,92.793877674,349,242,162,80,0,80
17669,7985,9964,0,0,3048,511320,203958,12498,0.998,0.984,1,1,134.511695519,510,324,225,99,0,99
17669,8535,9139,0,0,1497,355091,204152,12492,0.996,0.982,1,0.9966555183946488,78.872555277,212,154,87,67,0,67
17669,8712,8971,0,0,2830,489922,204025,12491,1,0.984,1,0.9946466809421841,137.003710072,626,415,307,108,1,107
17669,8154,9541,0,0,3485,558377,205260,12475,1,0.982,1,0.9977358490566037,106.126677152,945,493,380,113,0,113
17669,8556,9129,0,0,848,289452,203771,12498,0.992,0.992,1,1,90.851909593,130,115,52,63,0,63
17669,9009,8703,0,0,3138,520534,204252,12469,0.988,0.958,1,1,122.603943704,402,277,192,85,0,85
17669,8732,8947,0,0,8020,1015221,204414,12484,0.988,0.982,1,1,184.068340253,1183,676,563,113,0,113
17669,7457,10247,0,0,2274,433877,204293,12476,0.998,0.978,1,1,80.506491153,356,236,148,88,0,88
17669,9147,8878,0,0,1716,377321,204222,12488,0.994,0.98,1,1,168.438979902,245,182,111,71,0,71
17669,8008,9709,0,0,1511,356911,204348,12495,1,0.984,1,0.9792147806004619,115.183439516,307,203,126,77,0,77
17669,7754,9938,0,2,7347,946029,204149,12485,0.998,0.988,1,1,199.580024618,1326,818,669,149,1,148
17669,8200,9483,0,0,2749,481700,204512,12479,0.998,0.97,1,1,101.767950773,416,303,204,99,0,99
17669,9940,7969,0,0,3268,535414,203808,12496,0.994,0.984,1,1,98.789286351,588,343,251,92,1,91
17669,8425,9249,0,0,1422,348019,204087,12483,0.992,0.982,1,1,102.577607363,191,152,83,69,0,69
17669,8903,8960,0,0,8128,1028573,204165,12488,0.998,0.996,1,1,216.54389745,1967,972,830,142,0,142
17669,8765,8966,0,0,1756,381326,203945,12504,1,0.97,1,1,182.193433265,372,236,148,88,0,88
17669,8871,8809,0,0,3417,551959,204454,12482,0.998,0.984,1,1,126.401111537,571,371,271,100,0,100
17669,8732,9024,0,0,1029,308692,204352,12484,0.998,0.982,1,1,62.213592709,123,109,52,57,0,57
17669,8874,8942,0,0,1418,347856,204563,12498,0.998,0.984,1,1,71.924943689,177,160,94,66,0,66
17669,9885,7987,0,0,14736,1694152,205447,12481,1,0.992,1,0.999284862932062,312.070972255,5784,2794,2604,190,2,188
17669,8373,9409,0,0,4255,636211,204415,12496,0.998,0.976,1,1,117.510899329,746,462,351,111,0,111
17669,8892,9072,0,0,4313,640635,204363,12488,1,0.972,1,0.9957932692307693,116.342396625,1164,626,498,128,2,126
17669,9796,7909,0,0,4297,638328,204383,12504,1,0.972,1,1,122.026899497,1150,638,519,119,0,119
17669,9633,8048,0,0,3603,569862,205171,12487,1,0.968,1,0.9765990639625585,108.317943488,876,522,399,123,7,116
17669,9932,7949,0,2,2780,484572,204032,12489,1,0.986,1,0.9935344827586207,87.332432179,623,408,304,104,1,103
17669,9620,8282,2,4,4391,648585,204693,12497,0.998,0.982,0.992721979621543,1,134.617863115,819,458,342,116,3,113
17669,9135,8543,2,0,6510,870517,204174,12484,0.994,0.982,1,1,166.359519909,1204,690,542,148,5,143
17669,8371,9616,0,2,25008,2727142,203765,12482,0.978,0.978,1,1,515.556350881,3827,2086,1877,209,2,207
17669,7767,10020,0,0,1301,335179,204035,12504,0.996,0.974,1,1,122.140028695,161,140,76,64,0,64
17669,7759,9922,0,0,1466,352602,204195,12499,0.998,0.978,1,1,82.275716224,213,151,82,69,0,69
17669,9349,8446,0,0,2026,408315,203650,12487,0.998,0.984,1,1,78.72271106,325,205,119,86,1,85
17669,8723,9024,0,1,33286,3567945,204755,12488,0.994,0.98,1,0.9998086124401914,649.687279138,7033,3630,3417,213,0,213
17669,8498,9215,0,2,3309,539584,203880,12496,0.996,0.98,1,1,113.364421884,556,357,257,100,0,100
17669,9110,8913,0,0,3219,529038,204114,12487,0.998,0.98,1,1,103.025880254,548,345,248,97,0,97
17669,9914,7760,0,0,3982,605834,204337,12480,0.994,0.978,1,1,177.194403305,749,412,310,102,0,102
17669,7914,9860,0,0,1626,368791,204057,12499,1,0.994,1,0.9984779299847792,96.549391134,449,300,208,92,0,92
17669,9229,8445,0,0,1961,402279,204356,12498,0.998,0.98,1,1,95.251995565,300,209,132,77,0,77
17669,9405,8306,2,0,2312,439351,204528,12487,1,0.982,1,0.9972972972972973,117.69788657,496,337,244,93,0,93
17669,9240,8446,0,0,2801,487516,204349,12496,0.986,0.982,1,1,94.806973084,366,242,161,81,0,81
17669,9344,8330,0,0,4414,650617,204392,12494,0.988,0.988,1,1,120.824429943,595,379,280,99,0,99
17669,9144,8549,2,0,2152,421882,204613,12480,0.998,0.976,1,1,80.591115715,329,233,153,80,0,80
17669,8298,9402,0,0,7472,958316,204133,12493,0.982,0.986,1,1,179.311238887,1099,635,524,111,0,111
17669,8150,9541,0,0,2325,438933,204155,12492,0.998,0.984,1,1,80.986838422,360,250,172,78,0,78
17669,9892,7907,0,0,1341,339286,203734,12501,1,0.978,1,0.9972144846796658,86.265403278,254,179,105,74,0,74
17669,8772,8941,0,2,1904,395998,203970,12502,1,0.976,1,0.9982905982905983,77.70694161,407,265,178,87,0,87
17669,9372,8611,2,0,4423,650916,204034,12504,0.988,0.986,1,1,135.419751519,637,366,266,100,1,99
17669,8781,8906,0,0,3490,555416,203763,12485,0.994,0.982,1,1,109.429058808,624,360,252,108,0,108
17669,8745,8929,0,0,5421,750989,203573,12498,0.99,0.986,1,1,158.555554348,741,463,343,120,1,119
17669,9251,8509,3,0,80968,8401242,205023,12478,0.992,0.97,1,1,1561.40715255,18349,8591,8342,249,1,248
17669,8430,9247,0,0,2254,431807,204210,12498,0.99,0.976,1,1,79.60694358800001,282,193,117,76,0,76
17669,10569,7426,0,0,2824,489330,203800,12505,0.998,0.982,1,1,140.188391704,497,296,209,87,0,87
17669,9510,8399,0,0,5430,752161,203751,12484,0.998,0.988,1,1,168.735896763,1034,576,457,119,0,119
17669,8183,9824,0,0,2828,489414,203777,12481,1,0.978,1,0.9989743589743589,112.569966376,667,411,308,103,0,103
17669,8384,9305,0,0,1491,355522,204400,12494,1,0.982,1,0.9975490196078431,117.552209284,272,211,136,75,0,75
17669,8796,8896,0,0,1588,364798,204502,12493,0.994,0.974,1,1,166.657976552,202,176,103,73,0,73
17669,8408,9270,0,0,2025,408966,203640,12499,1,0.978,1,0.9968503937007874,83.049940878,437,286,197,89,1,88
17669,8845,8833,0,0,3096,517066,204725,12486,1,0.984,1,0.9942252165543792,123.644291012,690,460,347,113,2,111
17669,9513,8453,0,0,1648,370827,204454,12489,0.996,0.982,1,1,69.81201254,244,174,104,70,0,70
17669,8423,9257,0,0,2705,476425,204038,12496,0.994,0.974,1,1,91.466477138,425,298,212,86,0,86
17669,7725,9953,0,2,14388,1658524,203832,12492,0.992,0.98,1,1,378.469063965,2953,1552,1379,173,0,173
17669,8635,9047,0,0,1608,366399,204029,12497,0.998,0.984,1,1,85.42675648,221,168,88,80,0,80
17669,9046,8778,0,0,1118,317262,204358,12412,0.996,1,1,1,79.93487305,268,194,119,75,0,75
17669,9036,8981,0,0,5231,733811,203686,12500,0.99,0.984,1,1,131.821404733,758,419,298,121,0,121
17669,8732,9016,0,0,1302,336498,205033,12420,0.988,0.998,1,1,61.834545101,177,140,75,65,0,65
17669,8338,9458,0,0,4257,635430,204582,12487,0.998,0.974,1,1,167.909446284,744,464,356,108,0,108
17669,8401,9313,0,0,1900,395615,203871,12487,0.986,0.984,1,1,82.334478511,205,173,98,75,0,75
17669,9864,8165,0,0,7746,984622,203818,12512,0.994,0.984,1,1,213.224485334,1516,825,681,144,1,143
17669,9090,8625,2,0,2608,468623,204695,12475,0.99,0.988,1,1,97.91569479099999,312,231,151,80,0,80
17669,8527,9147,0,0,5487,757947,204146,12479,0.996,0.98,1,1,219.285668875,1045,579,457,122,0,122
17669,8339,9539,0,0,2900,497144,203943,12486,0.988,0.988,1,1,121.320675617,372,250,166,84,0,84
17669,9114,8560,0,0,2986,505265,203526,12478,0.992,0.982,1,1,106.596336345,529,308,216,92,0,92
17669,9057,8625,0,0,1593,364627,204202,12485,0.992,0.976,1,1,101.086979137,254,155,84,71,1,70
17669,7656,10025,0,0,1997,407287,205512,12496,0.996,0.982,1,1,163.431184369,291,214,130,84,1,83
17669,8589,9136,0,0,3369,543747,204192,12486,1,0.974,1,0.9991482112436116,114.014641488,797,495,377,118,0,118
17669,8327,9349,0,0,1690,374319,203540,12486,1,0.99,1,0.9986111111111111,71.468362534,487,317,233,84,0,84
17669,9029,8983,0,0,2082,413719,203662,12496,0.988,0.978,1,1,103.448622408,226,195,122,73,0,73
17669,9699,7983,0,0,10602,1277870,204029,12482,0.988,0.986,1,1,283.038115793,1517,923,780,143,1,142
17669,8497,9197,0,0,4090,615646,203560,12477,0.996,0.982,1,1,110.228536601,743,432,326,106,0,106
17669,7952,9724,0,0,3148,522678,204490,12489,0.994,0.982,1,1,113.968745813,515,332,222,110,0,110
17669,8503,9538,0,0,2329,438689,204173,12490,1,0.974,1,0.9973787680209698,112.833907357,520,335,241,94,2,92
17669,7941,9740,0,0,3250,531760,204244,12490,0.996,0.974,1,1,168.866523393,488,367,267,100,0,100
17669,8361,9327,0,0,1623,369263,204816,12490,0.996,0.974,1,1,70.268961485,214,169,92,77,0,77
17669,10018,7659,0,0,3367,544972,203701,12476,0.994,0.98,1,1,151.199628222,573,369,276,93,0,93
17669,8272,9409,0,0,2736,481735,205138,12479,0.992,0.972,1,1,92.665985965,414,298,210,88,0,88
17669,8799,8913,0,0,3425,549743,203939,12491,0.994,0.98,1,1,168.815562283,631,351,255,96,0,96
17669,8985,8997,0,2,4660,673353,203530,12490,0.988,0.984,1,1,139.51235251,650,400,302,98,1,97
17669,9194,8503,0,0,4512,659034,204252,12508,0.988,0.986,1,1,122.060001307,605,384,277,107,0,107
17669,8820,9237,2,0,2838,490223,204278,12503,0.992,0.978,1,1,144.880267877,485,294,201,93,0,93
17669,8453,9257,0,0,1881,394017,203896,12487,0.994,0.988,1,1,88.724149735,262,207,132,75,0,75
17669,9651,8074,0,0,1624,368540,204614,12492,0.998,0.99,1,1,125.034247534,241,170,97,73,0,73
17669,9065,8609,0,0,3604,566920,203322,12480,1,0.984,1,0.9955784819454679,102.954176996,952,519,405,114,0,114
17669,8932,8827,0,0,1287,333629,203897,12495,0.994,0.98,1,1,89.189024398,169,125,62,63,0,63
17669,9853,7822,0,0,2460,452381,204349,12507,0.994,0.968,1,1,108.049942832,391,271,191,80,0,80
17669,7830,9874,0,2,2769,485936,205118,12503,1,0.986,1,1,97.468811833,628,394,281,113,0,113
17669,9855,7863,0,0,2075,414600,204335,12505,0.994,0.974,1,1,83.14177517,333,216,136,80,1,79
17669,8776,8929,0,0,1651,371127,204568,12423,0.99,1,1,1,100.928536196,388,290,197,93,1,92
17669,8800,8888,0,2,5414,750824,204002,12494,0.99,0.984,1,1,135.643848615,766,447,320,127,0,127
17669,7595,9782,0,1,88661,9163153,204986,12483,0.994,0.984,1,0.9999311721384817,1667.753106728,19844,9487,9212,275,2,273
17669,8142,9755,0,0,4863,695530,203892,12500,0.992,0.968,1,1,249.721865619,857,534,419,115,0,115
17669,8665,9388,0,0,2298,436349,204176,12489,0.996,0.988,1,1,95.703284324,343,250,162,88,0,88
17669,8735,8957,0,0,1398,345199,204243,12489,0.996,0.988,1,1,86.021293241,192,148,80,68,0,68
17669,9426,8251,0,0,2088,414745,203899,12478,0.978,0.982,1,1,82.169705891,258,175,101,74,0,74
17669,9460,8219,0,0,2850,491786,203746,12491,0.988,0.98,1,1,110.067401222,361,247,160,87,0,87
17669,8419,9320,4,0,1845,390669,204335,12479,1,0.984,1,0.9842931937172775,105.671124356,393,260,177,83,3,80
17669,8136,9590,0,0,1906,397201,204598,12504,0.998,0.978,1,1,75.957888792,281,204,123,81,0,81
17669,9890,7785,0,0,2632,470944,204281,12491,0.998,0.974,1,1,86.435449199,431,273,174,99,0,99
17669,8453,9239,0,0,1777,383644,204204,12494,0.996,0.99,1,1,75.541631473,251,199,130,69,0,69
17669,8684,9308,0,0,1450,350943,204479,12429,0.998,1,1,1,67.054364451,359,244,159,85,0,85
17669,7848,10174,0,0,4008,610081,204453,12500,0.992,0.98,1,1,171.054498812,754,414,309,105,0,105
17669,8553,9131,0,0,7221,933056,204123,12482,1,0.98,1,0.9989936262998994,183.190093602,2056,1087,925,162,0,162
17669,8722,9242,0,0,1245,331111,204788,12482,0.994,0.958,1,1,84.057571296,175,126,62,64,0,64
17669,7708,9980,0,0,4948,707330,205001,12495,0.994,0.982,1,1,136.365108603,892,531,412,119,1,118
17669,8644,9031,2,0,2529,459686,203882,12496,1,0.98,1,0.9800235017626322,84.229567846,603,348,243,105,5,100
17669,8709,8980,0,2,1325,338421,204555,12491,0.998,0.97,1,1,96.834172991,172,139,69,70,0,70
17669,9878,8075,2,0,20196,2241409,204470,12510,0.99,0.982,1,1,408.161532574,3233,1660,1507,153,0,153
17669,9218,8471,0,2,1989,405020,204143,12476,0.998,0.984,1,1,89.140863946,296,215,135,80,0,80
17669,10106,7805,2,0,1934,399259,203953,12495,0.988,0.978,1,1,71.908932043,223,172,97,75,0,75
17669,7910,9765,0,0,6810,891539,203983,12488,0.996,0.984,1,1,168.82728903,1278,730,587,143,0,143
17669,9395,8563,0,0,1627,368041,203991,12488,1,0.986,1,0.9914529914529915,68.489514238,323,225,145,80,0,80
17669,8497,9188,0,0,4600,668992,204218,12491,0.998,0.982,1,1,128.293235916,824,490,370,120,0,120
17669,8524,9151,0,0,6778,897426,205853,12417,0.994,0.998,1,1,187.995526995,1532,849,705,144,0,144
17669,8463,9392,0,0,4417,648992,203924,12478,0.996,0.962,1,1,153.249481763,771,478,371,107,0,107
17669,9295,8380,0,0,3808,587925,204256,12405,0.996,1,1,1,109.720429151,1032,581,463,118,0,118
17669,9046,8632,0,0,5184,728515,204448,12498,0.998,0.984,1,1,158.57183381,989,540,415,125,0,125
17669,9213,8464,0,0,11832,1404121,208364,12502,1,0.98,1,0.9944688155636087,252.712028155,3618,1811,1620,191,5,186
17669,9436,8295,0,0,8334,1042768,203934,12480,1,0.992,1,0.9982006297795771,202.105813092,3026,1593,1418,175,2,173
17669,8632,9154,0,2,1857,392631,204359,12483,1,0.986,1,0.9933333333333333,207.259303369,426,255,174,81,0,81
17669,9542,8161,0,0,2585,466835,204593,12491,0.98,0.98,1,1,169.162913451,328,225,150,75,0,75
17669,9261,8635,0,0,2390,447016,205535,12492,0.994,0.974,1,1,126.856339572,380,252,163,89,0,89
17669,8492,9183,0,0,2083,414529,204349,12504,0.994,0.976,1,1,81.242310429,342,215,138,77,0,77
17669,9687,8187,2,0,5272,735265,203609,12494,0.998,0.986,1,1,159.575453977,1009,556,439,117,0,117
17669,9018,8666,0,0,5784,786727,203492,12491,1,0.984,1,0.999578947368421,162.379388245,1638,870,737,133,0,133
17669,8618,9077,2,0,5475,755985,204132,12485,0.992,0.988,1,1,172.255922277,984,577,446,131,0,131
17669,9920,7826,0,0,1416,346753,203924,12418,0.992,0.998,1,1,73.130288382,256,184,109,75,0,75
17669,8746,8958,0,0,3324,539168,203518,12485,0.992,0.99,1,1,97.440895337,536,364,259,105,0,105
17669,9016,8709,0,0,1410,346550,204347,12501,0.996,0.982,1,1,126.859882955,206,144,75,69,0,69
17669,9584,8108,0,0,1473,352957,204115,12501,1,0.982,1,0.9925,113.013058576,265,209,135,74,0,74
17669,8440,9316,0,0,983,303915,204468,12495,1,0.972,1,0.9956521739130435,81.7296018,162,129,68,61,0,61
17669,9156,8743,0,0,3777,587887,206005,12427,0.986,1,1,1,139.088397028,719,432,324,108,0,108
17669,8440,9268,0,0,2574,463809,204192,12490,0.988,0.99,1,1,111.813626539,318,222,139,83,0,83
17669,8295,9547,0,0,4921,701652,203544,12497,0.998,0.98,1,1,177.998862651,874,533,409,124,0,124
17669,1152,16896,2,58,429,246576,203450,12499,0.996,0.984,0.46808510638297873,1,51.113667016,2,47,0,47,0,47
17669,8737,9121,0,0,1621,367375,204086,12496,0.998,0.984,1,1,79.715693833,206,181,108,73,0,73
17669,9671,8018,0,0,670,271357,203578,12419,1,1,1,1,112.387543931,243,176,101,75,0,75
17669,9140,8553,0,0,1037,309140,203750,12427,0.996,1,1,1,69.826380738,249,179,106,73,0,73
17669,8985,8727,0,0,3658,573305,204373,12487,0.996,0.976,1,1,128.154901724,665,389,295,94,1,93
17669,8850,8826,0,0,2418,447930,204051,12498,1,0.984,1,0.9937578027465668,115.353915361,564,337,237,100,0,100
17669,7981,8354,0,0,59564,6214483,203544,12491,1,0.98,1,0.9962508520790729,1127.651065009,20081,9517,9255,262,4,258
17669,9226,8758,0,2,1486,354518,204059,12508,0.998,0.988,1,1,175.817739744,195,161,88,73,1,72
17669,7465,10242,0,7,1641,369822,203958,12492,0.988,0.978,0.9528985507246377,1,114.255877807,196,136,61,75,10,65
17669,8456,9283,0,0,1648,371030,204083,12492,0.992,0.978,1,1,84.560940552,234,171,96,75,1,74
17669,8940,8740,0,0,2474,453278,203577,12486,0.99,0.978,1,1,100.451590644,297,221,138,83,0,83
17669,9795,7913,0,0,2095,420925,209209,12494,0.996,0.986,1,1,87.173461039,332,221,144,77,0,77
17669,9447,8239,0,0,2856,492002,203917,12487,0.996,0.976,1,1,102.192666136,481,302,209,93,0,93
17669,9421,8274,0,0,2060,411905,203810,12483,0.98,0.978,1,1,89.194453023,240,175,93,82,0,82
17669,9800,7880,0,0,2142,420068,204115,12425,0.996,0.998,1,1,91.818210525,425,277,191,86,0,86
17669,8558,9118,0,0,1778,383906,203986,12501,0.976,0.986,1,1,82.678297752,209,154,85,69,0,69
17669,9283,8392,0,0,1758,381144,203610,12497,0.998,0.98,1,1,71.202273621,271,174,98,76,0,76
17669,9223,8707,2,0,11052,1317964,203800,12484,0.994,0.976,1,1,250.186441983,2266,1171,1012,159,3,156
17669,8561,9121,0,0,1329,338099,203966,12497,0.996,0.99,1,1,142.264460497,155,151,85,66,0,66
17669,8898,8926,0,0,2001,423172,221239,12481,1,0.984,1,0.9922360248447205,97.11676275,452,278,191,87,1,86
17669,9136,8693,0,0,3470,553915,204000,12479,0.992,0.988,1,1,110.02645789,594,376,285,91,0,91
17669,8731,9093,0,0,2595,466360,204163,12481,0.998,0.99,1,1,86.916889587,413,281,190,91,0,91
17669,8425,9249,0,0,2682,475432,203864,12491,1,0.988,1,0.9893276414087513,125.488386993,671,370,265,105,1,104
17669,7859,9838,0,0,1972,402394,203629,12497,0.996,0.984,1,1,95.760682011,279,224,152,72,0,72
17669,8402,9502,0,0,2238,429359,203610,12500,0.992,0.974,1,1,138.383244843,373,228,141,87,0,87
17669,9106,8569,0,0,3631,570258,203777,12491,0.998,0.99,1,1,107.51333951,644,385,281,104,0,104
17669,7926,9751,2,0,6783,891157,203798,12489,0.998,0.982,1,1,161.787319021,1349,708,576,132,1,131
17669,9091,8586,0,0,1985,404948,203920,12486,0.99,0.988,1,1,97.645494181,213,183,109,74,0,74
17669,8701,9193,0,0,1602,365162,203455,12474,0.992,0.992,1,1,70.247286915,267,226,148,78,0,78
17669,8434,9273,5,5,5819,791270,204082,12506,0.998,0.98,0.9746974697469747,1,150.747965742,1004,661,536,125,2,123
17669,7824,9885,0,2,3199,525694,203627,12419,0.978,1,1,1,135.144366642,579,388,284,104,1,103
17669,9613,8080,0,0,5461,757439,206231,12477,0.978,0.98,1,1,218.399112671,750,460,341,119,0,119
17669,9220,8656,0,0,2180,423554,203711,12422,0.99,1,1,1,134.085160958,551,358,260,98,0,98
17669,9185,8543,0,0,1374,342565,204105,12486,0.992,0.984,1,1,71.290191487,191,142,76,66,0,66
17669,7798,9897,0,0,1192,323680,203575,12490,1,0.982,1,0.9966887417218543,115.804111452,211,159,90,69,1,68
17669,9601,8078,0,0,5385,746930,203484,12481,0.998,0.98,1,1,179.974817574,1004,579,462,117,0,117
17669,9360,8330,0,0,1961,403420,205205,12503,1,0.966,1,0.9982758620689656,82.998985984,402,272,178,94,0,94
17669,9326,8639,0,0,2356,441579,203806,12484,1,0.976,1,0.9986541049798116,99.562352804,507,336,236,100,0,100
17669,8845,9078,0,0,1569,362822,204299,12508,0.998,0.98,1,1,88.870439411,219,167,97,70,0,70
17669,8927,8878,2,7,16121,1832502,204004,12486,1,0.982,0.998240675580577,0.9975780409041981,336.443199658,5097,2503,2332,171,3,168
17669,8915,9007,0,0,4217,629903,203917,12487,0.996,0.99,1,1,222.342619981,761,446,335,111,1,110
17669,8450,9326,2,0,3340,542146,204179,12488,0.998,0.978,1,1,99.268351027,564,365,272,93,0,93
17669,8197,9531,0,0,1566,361841,203991,12492,0.992,0.976,1,1,75.278488464,217,172,105,67,0,67
17669,8056,9695,0,0,1240,330086,204628,12495,0.996,0.986,1,1,105.123424378,161,130,64,66,0,66
17669,9511,8165,0,0,9804,1206720,216314,12487,0.956,0.99,1,1,236.489226902,1456,821,682,139,0,139
17669,8146,9674,0,0,1366,341537,203661,12474,0.994,0.984,1,1,88.281173847,187,142,74,68,0,68
17669,9321,8370,0,0,10870,1299415,203917,12474,0.994,0.982,1,0.9996839443742098,289.423336057,2177,1146,987,159,0,159
17669,8407,9376,0,0,7345,947086,203544,12498,0.994,0.986,1,1,174.835227797,1507,767,647,120,0,120
17669,8535,9180,0,0,1831,391814,206852,12486,0.998,0.982,1,1,98.503355535,248,205,128,77,0,77
17669,9164,8762,0,0,2813,498334,214237,12486,0.99,0.982,1,1,94.659394377,354,240,149,91,0,91
17669,384,17664,3,63,427,247023,203903,12491,0.996,0.984,0.44680851063829785,NaN,54.97609607,0,47,0,47,0,47
17669,9213,8465,0,0,4620,670520,203983,12490,0.996,0.988,1,0.9991379310344828,145.771097707,802,487,357,130,1,129
17669,8146,9549,0,0,7901,1008484,203718,12475,0.988,0.982,1,1,210.165840403,1116,671,538,133,0,133
17669,8793,9081,0,0,4388,647790,204340,12426,0.998,1,1,1,116.815127473,1179,676,545,131,0,131
17669,8351,9340,0,2,8345,1050469,204042,12489,1,0.972,1,1,209.784175115,2307,1302,1136,166,0,166
17669,8443,9234,0,0,1530,375979,221513,12477,0.992,0.988,1,1,67.879742535,209,160,90,70,0,70
17669,9423,8282,0,0,1054,309996,203765,12489,1,0.984,1,0.9874476987447699,64.270429214,169,137,70,67,0,67
17669,8100,9582,0,3,1502,355350,203738,12491,1,0.978,1,1,83.703965709,298,206,130,76,0,76
17669,7714,9970,0,0,2474,453508,203734,12491,0.996,0.98,1,1,86.293503628,378,272,186,86,0,86
17669,9544,8131,0,0,9075,1119023,204403,12469,0.99,0.972,1,1,209.417378272,1338,750,605,145,0,145
17669,8067,9639,0,0,3691,588521,216690,12490,0.992,0.98,1,1,121.712415031,664,387,282,105,0,105
17669,8124,9562,0,0,2473,454145,204528,12499,1,0.992,1,1,120.137126616,754,461,349,112,0,112
17669,10037,7939,0,0,9516,1165222,204628,12499,0.992,0.992,1,0.9993863148204971,219.856023931,2249,1152,1009,143,1,142
17669,8963,8758,0,0,3508,559655,203971,12492,1,0.98,1,0.996,166.688346926,824,531,426,105,0,105
17669,9069,8614,0,0,2191,429842,208623,12499,0.976,0.984,1,1,82.189682543,261,193,115,78,0,78
17669,8087,9865,0,0,3874,594604,203631,12488,0.994,0.99,1,1,128.032439022,659,414,295,119,0,119
17669,8469,9342,0,0,1689,377672,205479,12486,0.998,0.978,1,1,69.850094908,225,183,107,76,0,76
17669,9433,8464,0,0,3337,541600,204216,12487,0.998,0.98,1,1,100.423473051,596,357,268,89,0,89
17669,9798,7890,0,0,3199,526629,204028,12486,0.994,0.988,1,1,153.0768102,543,333,241,92,0,92
17669,7743,9940,0,2,1758,383203,204759,12477,0.996,0.984,1,1,80.373933399,236,194,117,77,0,77
17669,9235,8442,0,2,8932,1105034,203920,12490,0.998,0.986,1,1,260.414961919,1896,913,776,137,1,136
17669,8791,8917,0,0,2847,511992,209435,12496,0.992,0.982,1,1,124.559206556,458,293,190,103,0,103
17669,8723,9277,2,0,7301,942673,205338,12483,0.984,0.992,1,1,193.501208118,1202,688,553,135,0,135
17669,8895,8791,0,0,2955,501995,203841,12476,0.984,0.99,1,1,132.890337726,363,261,166,95,0,95
17669,1152,16896,4,56,439,247739,203487,12481,0.998,0.972,0.496551724137931,1,48.737491285,0,49,0,49,2,47
17669,9522,8189,2,0,1667,371655,203511,12487,1,0.976,1,0.9960861056751468,68.296888409,372,220,137,83,2,81
17669,8067,9613,0,0,1536,362082,206854,12483,0.984,0.98,1,1,124.062885608,169,134,69,65,0,65
17669,8632,9224,0,0,1341,338519,203390,12487,0.996,0.974,1,1,100.095284824,159,151,84,67,0,67
17669,8117,9566,0,0,4853,695317,205869,12489,0.986,0.984,1,1,153.743361553,686,403,298,105,0,105
17669,8202,9487,0,0,2215,427231,203325,12489,0.998,0.982,1,1,97.873077522,363,234,154,80,1,79
17669,768,17280,3,58,424,249029,205217,12484,1,0.986,0.49645390070921985,1,90.621956207,1,47,0,47,0,47
17669,7335,10351,0,0,10996,1312166,204318,12487,0.992,0.984,1,1,269.196504181,2151,1195,1034,161,1,160
17669,8536,9400,1,0,3325,540437,204610,12483,0.998,0.988,0.9980988593155894,1,227.17613096,549,328,229,99,0,99
17669,8713,9284,0,0,3512,558384,203976,12488,0.988,0.996,1,1,102.897298968,557,345,242,103,1,102
17669,9003,8850,0,0,1270,332188,204051,12494,0.998,0.98,1,1,68.491563381,155,142,81,61,0,61
17669,9181,8499,2,0,3665,575223,205391,12417,0.994,1,1,1,115.48486974,976,570,454,116,2,114
17669,8826,9138,0,2,2631,471608,205211,12488,1,0.988,1,0.9772234273318872,98.711302787,653,366,266,100,3,97
17669,9517,8328,2,0,2757,483179,204240,12479,0.996,0.984,1,1,108.805720899,439,303,216,87,0,87
17669,8349,9640,2,2,20010,2225359,204006,12483,0.996,0.99,1,1,401.318908477,4255,2117,1907,210,3,207
17669,8018,9661,0,2,1766,381730,203422,12491,0.994,0.978,1,1,70.286251321,271,180,103,77,2,75
17669,8740,9115,0,0,2839,490499,204045,12485,0.998,0.986,1,1,89.72404578,426,321,227,94,0,94
17669,9626,8073,0,0,2321,438347,203933,12465,0.998,0.978,1,1,105.427591924,358,252,168,84,0,84
17669,9022,8672,0,0,2766,484853,204710,12497,0.998,0.974,1,1,100.46075123,439,301,212,89,0,89
17669,8517,9163,0,0,3705,579381,204110,12479,0.984,0.982,1,1,109.18277205,498,306,205,101,0,101
17669,9202,8732,0,0,3005,507228,203788,12495,0.996,0.97,1,1,151.725861241,479,330,232,98,0,98
17669,8563,9265,0,0,1718,377744,204146,12475,0.998,0.986,1,1,92.823735603,242,182,104,78,0,78
17669,8388,9599,0,0,2307,437939,203918,12480,0.998,0.98,1,1,83.721172601,381,233,143,90,0,90
17669,7932,9780,0,2,2433,449691,203932,12491,0.996,0.99,1,1,96.518008621,393,255,164,91,0,91
17669,9296,8548,0,0,4403,649916,205199,12484,0.988,0.982,1,1,119.036289738,628,351,244,107,0,107
17669,8137,9843,0,0,3390,546082,203704,12512,0.996,0.976,1,1,101.79808056,612,356,260,96,0,96
17669,8581,9110,0,2,3365,544447,204188,12495,0.998,0.984,1,1,108.173539452,551,367,264,103,1,102
17669,9305,8702,0,0,7928,1005280,204283,12489,0.998,0.964,1,1,199.865659954,1533,854,718,136,0,136
17669,9936,7745,0,0,4134,622213,204489,12501,0.998,0.966,1,1,146.288771586,710,448,339,109,0,109
17669,9313,8381,0,0,1698,379163,206807,12490,0.992,0.984,1,1,81.166450733,236,182,104,78,0,78
17669,9165,8510,0,0,4363,644052,203929,12480,0.992,0.974,1,1,116.246748183,854,435,325,110,0,110
17669,8938,8741,0,0,3131,521648,203926,12485,0.998,0.992,1,1,100.95389408,628,412,306,106,1,105
17669,384,17664,0,60,423,246680,204011,12486,0.996,0.986,0.46808510638297873,NaN,56.629023817,0,47,0,47,0,47
17669,8851,9160,0,0,5087,717413,203900,12486,0.996,0.982,1,1,166.04860548,916,528,393,135,0,135
17669,8873,9045,2,0,8253,1052364,205613,12487,0.996,0.984,1,1,213.430693168,1584,886,732,154,1,153
17669,9550,8141,0,0,3074,515922,205022,12494,0.994,0.972,1,1,117.995411297,506,329,230,99,0,99
17669,8451,9575,2,0,57808,6030554,203896,12474,0.996,0.988,1,1,1085.079085115,12872,6190,5966,224,2,222
17669,7945,9752,0,2,3218,534162,204164,12499,0.992,0.986,1,1,121.328031234,530,336,232,104,2,102
17669,9168,8518,0,2,2394,444688,203580,12492,0.992,0.972,1,1,82.380042786,361,245,153,92,1,91
17669,8932,8824,0,0,1230,328509,204221,12495,0.996,0.966,1,1,89.438559811,162,125,57,68,0,68
17669,3072,14976,10,49,481,253565,204766,12487,0.978,0.988,0.4900662251655629,1,53.850106381,0,54,4,50,3,47
17669,8558,9160,0,0,1463,351755,204375,12499,1,0.976,1,0.9725,141.973321323,279,197,119,78,2,76
17669,9298,8755,2,0,1787,384370,204214,12488,0.992,0.988,1,1,69.370455169,261,183,105,78,0,78
17669,8163,9632,0,0,12257,1445709,204343,12481,0.992,0.982,1,1,297.994908593,2400,1353,1190,163,0,163
17669,8447,9519,0,2,22796,2504833,204208,12494,0.996,0.98,1,1,466.696664417,4861,2431,2211,220,1,219
17669,9205,8653,0,0,1173,321782,203551,12471,1,0.966,1,0.9869281045751634,60.01966887,219,154,87,67,0,67
17669,8806,8878,0,0,1274,332330,203845,12497,1,0.98,1,1,95.250962685,203,174,99,75,0,75
17669,8922,8880,0,2,8622,1085761,214003,12487,0.948,0.99,1,1,228.127035788,1008,599,484,115,2,113
17669,8597,9101,0,0,1650,370653,203891,12484,0.994,0.978,1,1,111.431714252,247,170,95,75,0,75
17669,8097,9612,0,0,4253,632533,203683,12476,0.988,0.98,1,1,127.980623785,590,365,268,97,1,96
17669,8969,8707,0,0,2390,444708,203473,12484,0.994,0.988,1,1,87.276550201,375,256,168,88,0,88
17669,8665,9124,0,0,1892,395027,203789,12477,0.996,0.974,1,1,135.131046465,254,214,137,77,0,77
17669,8863,8831,0,0,4401,648555,204288,12495,0.996,0.98,1,1,119.832869165,774,474,361,113,1,112
17669,8454,9296,0,0,12693,1491065,204472,12502,0.994,0.978,1,1,303.706915125,2561,1354,1189,165,0,165
17669,9629,8364,0,0,2792,484920,203624,12493,1,0.974,1,0.9968017057569296,114.448539849,644,402,294,108,0,108
17669,8228,9746,0,0,1262,331391,203863,12504,1,0.97,1,0.9907407407407407,63.183986671,234,164,90,74,0,74
17669,8798,8927,0,0,3558,562602,203452,12480,0.998,0.974,1,1,111.679579556,590,391,291,100,0,100
17669,8363,9346,0,0,1731,381427,204673,12422,1,1,1,0.9972144846796658,75.44335641,744,440,333,107,0,107
17669,9141,8564,0,0,1528,358381,204030,12398,1,1,1,1,184.60867045,658,380,270,110,0,110
17669,7920,9772,0,0,1649,371325,204238,12482,0.996,0.986,1,1,120.001440192,234,175,103,72,0,72
17669,8102,9829,0,5,3569,565230,204580,12475,0.988,0.982,0.9493670886075949,1,127.345655978,321,228,140,88,9,79
17669,10230,7683,2,0,7155,934503,211138,12498,0.986,0.984,1,1,209.457121886,1052,596,467,129,2,127
17669,8824,8929,0,0,975,302150,204002,12492,0.996,0.992,1,1,70.614868476,168,128,69,59,0,59
17669,8097,9880,0,0,3990,607922,204158,12496,0.998,0.978,1,1,112.988209257,705,422,306,116,0,116
17669,8562,9235,0,0,2450,455388,205357,12496,0.996,0.986,1,1,92.698608919,389,264,179,85,0,85
17669,8325,9367,0,0,2659,472067,203814,12491,0.988,0.97,1,1,91.527065064,323,234,147,87,1,86
17669,9789,7894,0,0,1775,390415,210739,12495,1,0.976,1,0.9902912621359223,73.202783814,355,246,160,86,0,86
17669,7780,9907,7,3,1469,352099,203868,12499,0.996,0.982,0.8723404255319149,1,81.591837393,119,182,99,83,19,64
17669,8875,8806,0,2,8183,1029714,204350,12499,0.992,0.972,1,1,186.985393708,1603,861,718,143,1,142
17669,9253,8430,0,2,3558,562921,203936,12471,1,0.98,1,0.9992260061919505,121.933918451,880,526,411,115,1,114
17669,8593,9221,0,0,1802,385904,203778,12418,0.996,1,1,1,106.905523366,452,299,211,88,0,88
17669,8822,8879,0,0,5454,753909,203835,12488,0.986,0.98,1,1,144.849726656,781,447,338,109,0,109
17669,8356,9324,0,0,3002,506963,203875,12498,0.998,0.974,1,1,134.354205986,489,327,232,95,0,95
17669,9423,8359,0,0,5224,731328,203649,12483,0.994,0.982,1,1,210.898363238,956,551,424,127,1,126
17669,8082,9608,0,0,1232,327911,203897,12497,1,0.988,1,1,61.827951825,212,168,98,70,1,69
17669,9303,8389,0,0,4549,662525,203755,12488,0.992,0.98,1,1,127.364439201,823,483,368,115,0,115
17669,9177,8499,0,2,1493,354606,203585,12502,0.998,0.986,1,1,93.483347098,204,157,85,72,0,72
17669,8540,9190,0,0,1192,324537,203862,12495,0.998,0.98,1,1,68.894248334,166,122,61,61,0,61
17669,8670,9015,0,0,6598,872507,204585,12498,1,0.968,1,0.9938091769847051,175.824925833,1909,984,835,149,2,147
17669,9551,8136,0,2,1724,377745,203967,12501,0.996,0.982,1,1,77.912632477,250,182,106,76,0,76
17669,8858,8822,0,0,1928,398506,203849,12400,0.998,1,1,1,117.247027589,523,294,209,85,0,85
17669,8466,9216,0,0,1818,387964,204585,12477,0.996,0.986,1,1,109.263773322,242,202,126,76,0,76
17669,9336,8422,2,0,1412,347289,203922,12487,0.992,0.98,1,1,66.407798565,188,150,82,68,0,68
17669,8361,9495,0,0,1616,367340,203858,12488,0.998,0.984,1,1,73.724526028,244,166,92,74,0,74
17669,8707,8990,0,0,1158,320770,203937,12479,1,0.99,1,0.9880668257756563,110.307158654,296,205,123,82,0,82
17669,9186,8503,5,0,6891,898735,203942,12483,0.994,0.99,0.9989949748743718,1,163.772527529,1342,723,587,136,0,136
17669,9311,8370,0,0,3467,554081,204080,12499,0.992,0.982,1,1,101.403845008,568,379,275,104,0,104
17669,9936,7740,0,0,4289,636460,203564,12481,0.998,0.976,1,1,120.108026677,748,451,330,121,0,121
17669,8205,9469,0,0,5992,809650,203830,12483,1,0.982,1,0.9867735470941884,150.589099783,1747,883,745,138,3,135
17669,7816,10176,2,0,2341,441145,204250,12500,0.992,0.98,1,1,121.368117222,349,254,163,91,1,90
17669,7413,10277,0,0,6124,824308,203900,12483,0.998,0.98,1,1,178.749136379,1153,662,539,123,0,123
17669,8189,9496,0,0,8728,1084898,203651,12490,0.998,0.982,1,1,269.214732424,1688,938,789,149,0,149
17669,8042,9753,0,0,9805,1193022,204011,12483,0.986,0.986,1,1,214.112580267,1460,822,691,131,1,130
17669,8333,9398,0,0,1949,401086,203805,12494,0.998,0.978,1,1,74.564691328,276,214,135,79,0,79
17669,9122,8583,0,0,1881,394055,204375,12504,0.998,0.99,1,1,121.829175713,275,201,120,81,0,81
17669,7985,9751,0,2,14769,1695895,204011,12488,0.988,0.974,1,1,353.395958352,2371,1163,1019,144,0,144
17669,8977,8725,0,0,6525,863419,204238,12500,0.98,0.984,1,1,172.64391599,965,532,416,116,0,116
17669,8604,9283,0,0,1470,353331,204794,12505,0.998,0.978,1,1,81.645361755,205,160,95,65,0,65
17669,8240,9475,0,0,2800,488023,204699,12485,0.998,0.968,1,1,93.856974033,438,304,217,87,0,87
17669,9786,8066,0,0,4497,658361,204232,12482,0.988,0.96,1,1,201.449270644,623,381,272,109,0,109
17669,9380,8333,2,0,5007,709606,203623,12495,0.99,0.984,1,1,128.988777982,679,428,312,116,2,114
17669,8416,9269,0,0,2008,406550,203950,12481,1,0.978,1,0.9916943521594684,80.181688465,413,281,187,94,2,92
17669,8356,9326,0,0,1260,330495,203600,12482,0.996,0.984,1,1,60.316107218,155,138,77,61,0,61
17669,8063,9617,2,0,16672,1888359,203942,12484,0.998,0.978,1,1,405.345983184,3491,1797,1628,169,6,163
17669,7913,9940,0,2,1771,383617,204961,12489,0.998,0.98,1,1,125.684256193,257,187,109,78,0,78
17669,9665,8040,0,0,3653,572784,203985,12484,0.996,0.99,1,1,167.12289947,592,407,300,107,0,107
17669,8111,9593,0,0,5240,732050,203752,12489,1,0.98,1,0.9980343980343981,138.880775624,1386,788,648,140,1,139
17669,7798,9960,0,0,3366,544492,204289,12481,0.994,0.986,1,1,163.233759099,559,362,260,102,0,102
17669,8090,9646,0,2,2383,444086,203656,12488,0.974,0.978,1,1,89.437873955,305,203,127,76,0,76
17669,9075,8634,0,0,2022,408753,204248,12497,0.988,0.99,1,1,123.994500852,241,178,104,74,0,74
17669,8622,9287,0,0,1411,346052,203658,12498,0.996,0.976,1,1,63.590801243,190,148,80,68,0,68
17669,9173,8282,0,0,54834,5940772,206547,12496,1,0.988,1,0.9993079584775086,1113.921735912,19022,8661,8432,229,1,228
17669,10300,7718,0,0,3409,548534,204189,12490,0.994,0.982,1,1,134.038444994,608,359,264,95,0,95
17669,8585,9090,0,0,11275,1348737,205439,12478,0.98,0.99,1,1,273.038362234,1740,931,787,144,0,144
17669,9900,7801,0,0,2232,431208,205180,12502,0.998,0.978,1,1,79.123765356,375,225,137,88,0,88
17669,9269,8453,0,0,1494,354775,203821,12498,0.996,0.982,1,1,70.03112615,187,163,88,75,1,74
17669,8622,9062,0,0,2212,429226,205332,12494,0.998,0.978,1,1,98.222186757,335,239,153,86,0,86
17669,8331,9372,2,0,1803,387472,204957,12480,0.998,0.986,1,1,198.245511817,281,183,102,81,0,81
17669,8486,9215,0,0,2163,425141,206036,12490,0.996,0.988,1,1,92.384551812,340,231,151,80,0,80
17669,8353,9403,0,0,2278,434251,204204,12485,0.996,0.99,1,1,81.237835688,387,228,142,86,0,86
17669,8520,9206,0,0,1539,359127,203996,12502,0.998,0.976,1,1,73.024953868,214,161,86,75,0,75
17669,1920,16128,5,50,460,250406,203859,12472,0.994,0.986,0.5066666666666667,1,62.605160178,0,52,1,51,4,47
17669,8906,8797,0,0,3261,534373,204166,12482,0.998,0.982,1,1,116.69950999,589,338,243,95,1,94
17669,9138,8544,0,2,4802,692067,205286,12498,0.998,0.986,1,1,191.750474759,849,532,424,108,2,106
17669,8974,8996,1,0,4878,696649,204163,12497,1,0.982,1,0.9930997876857749,137.973864668,1300,711,581,130,3,127
17669,9247,8431,0,0,19821,2206263,203779,12482,0.986,0.978,1,1,421.419653954,3183,1604,1426,178,0,178
17669,8978,9042,0,0,1632,369617,204498,12493,0.994,0.984,1,1,133.816305753,244,168,94,74,0,74
17669,7551,10127,0,0,2500,456723,204000,12492,0.996,0.984,1,1,99.729776752,378,276,186,90,0,90
17669,8574,9479,0,2,5151,724057,203790,12496,0.992,0.976,1,1,199.850003801,950,549,428,121,2,119
17669,9152,8566,2,0,1566,361804,203845,12490,0.996,0.984,1,1,66.323086228,198,172,103,69,0,69
17669,8959,8867,0,0,4290,638189,204977,12490,0.996,0.984,1,1,120.237417004,761,454,338,116,0,116
17669,9154,8520,0,0,2031,408939,203751,12494,0.996,0.986,1,1,78.48267992,293,221,140,81,0,81
17669,8261,9497,0,0,1538,360573,203926,12488,0.984,0.982,1,1,91.470851723,184,131,65,66,0,66
17669,9249,8481,2,0,1284,334869,205231,12402,0.996,0.998,1,1,89.557330758,222,173,101,72,0,72
17669,9218,8456,0,0,45511,4801458,203897,12467,0.984,0.988,1,1,865.654724521,7720,3589,3373,216,0,216
17669,8772,8916,2,0,3814,589192,203648,12470,1,0.982,1,0.9885468861846815,116.690537102,974,548,420,128,3,125
17669,8466,9208,0,0,3093,516963,204184,12494,1,0.966,1,0.9912280701754386,147.382415759,690,452,333,119,3,116
17669,7877,9918,0,2,1382,343068,203722,12491,0.994,0.982,1,1,80.650407672,200,139,68,71,1,70
17669,10490,7540,0,0,2696,476109,203973,12487,0.992,0.98,1,1,85.77300361,448,286,196,90,0,90
17669,9354,8404,0,0,1204,330312,208813,12428,1,0.996,1,0.9976958525345622,94.069546845,304,215,130,85,0,85
17669,9076,8632,0,0,3693,577407,204087,12495,1,0.982,1,1,141.886811901,863,545,415,130,0,130
17669,9799,8137,0,0,2770,483732,203648,12495,1,0.974,1,0.9945593035908596,106.706947578,627,400,292,108,0,108
17669,9136,8893,0,0,3137,520444,203879,12500,0.994,0.974,1,1,115.017073145,543,331,234,97,0,97
17669,8135,9887,0,0,1597,365861,204078,12477,0.994,0.978,1,1,69.96005255,239,161,84,77,0,77
17669,9054,8628,2,0,2621,469100,204534,12481,1,0.97,1,0.9966996699669967,163.398577675,642,368,267,101,0,101
17669,9633,8051,0,0,3066,512856,203852,12480,0.992,0.982,1,1,95.89796326,577,310,225,85,0,85
17669,9057,8631,0,0,1869,392613,204075,12492,0.996,0.978,1,1,98.333459274,317,182,103,79,1,78
17669,8212,9464,0,0,5687,781937,207512,12494,0.998,0.978,1,1,171.813927304,1093,594,472,122,0,122
17669,8456,9219,0,0,1908,397425,204522,12499,0.984,0.972,1,1,106.6572676,202,171,99,72,0,72
17669,8330,9575,0,0,4189,626601,204171,12492,0.994,0.982,1,1,123.448701997,705,453,345,108,0,108
17669,8256,9423,0,0,3385,546540,204280,12488,0.998,0.99,1,1,98.936397755,581,363,263,100,0,100
17669,9298,8561,2,0,6548,865674,203719,12494,0.998,0.986,1,1,192.48818527,1213,714,577,137,4,133
17669,8667,9137,0,0,2249,438748,211697,12399,0.994,1,1,1,91.061173341,580,363,265,98,0,98
17669,8676,9011,0,0,1355,341588,204193,12499,0.998,0.978,1,1,66.56864203,178,144,75,69,0,69
17669,8980,8698,0,0,9127,1126198,204655,12474,0.986,0.976,1,1,227.598655692,1408,752,631,121,0,121
17669,9141,8667,0,0,2589,466282,204196,12492,1,0.978,1,0.9874285714285714,86.04552788,612,364,260,104,3,101
17669,9769,8009,0,0,85553,8843319,203730,12499,0.996,0.98,1,1,1621.523262748,19227,9150,8857,293,3,290
17669,9345,8550,0,0,5444,754556,203928,12494,0.99,0.976,1,1,165.666784341,749,470,357,113,1,112
17669,7655,10053,0,0,3169,529722,209726,12489,0.998,0.978,1,1,124.49836617,516,342,240,102,0,102
17669,8807,8986,2,0,1986,405278,203962,12483,0.996,0.984,1,1,88.960993672,326,202,124,78,2,76
17669,7286,10583,0,4,3263,536136,205991,12489,0.998,0.974,1,1,120.721600805,544,354,255,99,0,99
17669,8636,9042,0,0,5397,750836,204154,12491,0.976,0.978,1,1,148.641173563,770,446,331,115,0,115
17669,9058,8617,0,0,8244,1038388,203776,12500,0.988,0.97,1,1,222.326185458,1223,691,558,133,0,133
17669,8467,9208,0,0,4248,635817,204467,12480,1,0.984,1,0.9960185799601858,121.625322027,986,651,520,131,1,130
17669,8488,9216,0,0,2860,494973,205762,12484,0.998,0.982,1,1,93.718836594,473,305,208,97,1,96
17669,9884,7811,0,2,2935,500694,204463,12479,0.988,0.984,1,1,90.912138997,319,253,171,82,0,82
17669,8591,9125,0,0,2143,421704,205134,12479,0.994,0.968,1,1,76.840909786,336,228,149,79,0,79
17669,8623,9060,0,0,11694,1383263,204235,12489,0.99,0.984,1,1,249.48469477,1837,954,809,145,0,145
17669,8208,9478,0,0,2622,469658,204078,12480,0.992,0.994,1,1,84.683354592,522,344,246,98,0,98
17669,9498,8266,0,0,2205,428366,204235,12497,1,0.99,1,0.9921798631476051,86.25302146,723,396,298,98,2,96
17669,8732,8993,0,0,1353,341202,204416,12493,0.998,0.982,1,1,74.698889078,177,149,86,63,0,63
17669,8942,8023,0,0,114239,11734744,204062,12502,0.984,0.984,1,1,2108.090433734,19561,9014,8756,258,4,254
17669,8461,9250,0,0,2063,412604,204368,12480,0.982,0.99,1,1,109.934096829,243,177,102,75,0,75
17669,8199,9770,0,2,4185,629088,207235,12491,0.994,0.982,1,1,119.663380908,718,458,346,112,3,109
17669,8555,9421,0,0,1821,387071,203724,12490,0.998,0.99,1,1,74.355671847,267,195,120,75,0,75
17669,8352,9517,0,0,6928,903952,203812,12492,0.994,0.984,1,0.9994810586403736,165.530788503,1278,771,648,123,1,122
17669,8204,9486,0,0,2372,442654,203425,12482,0.998,0.984,1,1,80.499441786,365,262,182,80,0,80
17669,8584,9163,0,0,2152,429003,211849,12485,0.988,0.99,1,1,80.868286931,262,186,107,79,0,79
17669,8863,8866,0,2,872,292532,204518,12487,1,0.994,1,1,116.473590307,201,155,87,68,1,67
17669,9823,7867,0,0,1861,391668,203673,12491,0.994,0.984,1,0.9975124378109452,101.99980693,288,190,113,77,1,76
17669,8207,9475,0,0,1514,359389,206505,12484,1,0.986,1,0.9976133651551312,168.617917649,306,197,113,84,0,84
17669,8652,9341,0,0,4053,612556,203651,12492,1,0.984,1,0.9987593052109182,133.108546602,1139,586,472,114,1,113
17669,8775,8912,0,0,1789,384997,204090,12433,0.998,1,1,1,72.416985079,460,289,198,91,0,91
17669,7725,10019,2,0,3272,534235,203928,12477,0.99,0.97,1,1,190.417311608,439,274,184,90,3,87
17669,8946,8910,0,0,5700,778483,204109,12502,1,0.974,1,0.9943007452871547,163.007548338,1549,865,730,135,2,133
17669,8252,9711,0,2,2882,494441,203512,12495,1,0.984,1,0.995987963891675,102.558318949,705,403,290,113,2,111
17669,7657,10097,0,0,1775,383971,204939,12494,0.998,0.98,1,1,114.825606624,275,193,128,65,0,65
17669,8904,8778,0,0,1594,365099,203880,12482,0.992,0.978,1,1,66.985280748,225,170,100,70,0,70
17669,9406,8286,0,0,2655,472586,204222,12488,0.998,0.984,1,1,93.056084219,427,287,197,90,0,90
17669,8593,9106,0,0,3314,539051,203668,12496,0.998,0.984,1,1,110.911274621,511,374,271,103,0,103
17669,8723,8962,0,2,2109,416063,203796,12491,0.998,0.974,1,1,81.330863197,342,220,140,80,0,80
17669,8602,9081,0,0,2088,414056,203749,12498,0.968,0.98,1,1,131.584267804,217,196,117,79,0,79
17669,8150,9712,0,0,2322,446362,212449,12495,0.998,0.968,1,1,202.674002054,334,253,164,89,0,89
17669,8217,9457,0,0,3224,529114,204002,12481,0.996,0.982,1,1,95.059603674,541,342,247,95,0,95
17669,9385,8302,0,0,1941,399368,203530,12501,0.996,0.988,1,1,73.282713206,281,216,142,74,1,73
17669,8215,9478,2,0,1911,396809,203887,12495,0.998,0.978,1,1,136.19661169,281,207,130,77,0,77
17669,8068,9797,0,0,4866,695142,203611,12495,0.996,0.984,1,1,131.858278665,856,518,390,128,0,128
17669,9656,8029,0,0,5334,743389,204257,12486,0.996,0.988,0.9864364981504316,1,198.101420566,945,574,454,120,3,117
17669,8940,8881,0,2,6995,916937,211135,12488,0.994,0.984,1,1,174.42490731,1314,767,638,129,0,129
17669,8628,9051,0,0,3149,521589,204168,12496,0.99,0.986,1,1,208.859818092,423,267,180,87,0,87
17669,9105,8727,0,0,4240,632706,204121,12411,0.998,1,1,1,122.665554961,1130,659,532,127,0,127
17669,9222,8607,0,0,3860,594994,204439,12477,0.992,0.984,1,1,125.103331931,651,414,305,109,0,109
17669,8692,8989,0,0,5973,808713,205038,12493,0.992,0.984,1,1,186.595480458,1195,615,494,121,0,121
17669,7562,10125,0,0,1408,351430,209277,12511,1,0.982,1,0.9974489795918368,69.985538642,288,182,104,78,0,78
17669,7895,9779,0,0,1792,385525,204181,12487,0.998,0.984,1,1,73.246632687,269,188,111,77,0,77
17669,9272,8404,0,0,1895,395199,204063,12486,0.992,0.978,1,1,83.23809098,273,197,116,81,0,81
17669,8405,9281,0,0,3435,551091,204439,12483,0.996,0.982,1,1,105.598027658,566,377,277,100,0,100
17669,9200,8768,0,0,8303,1042286,204285,12504,0.988,0.982,1,1,227.096520516,1266,683,554,129,1,128
17669,8408,9269,0,0,3382,547186,203816,12500,0.992,0.98,1,1,101.830999726,588,364,273,91,0,91
17669,8276,9691,0,2,2267,434419,205287,12492,1,0.966,1,0.9986541049798116,111.04817906,518,319,224,95,1,94
17669,8047,9629,0,0,10046,1226890,204456,12489,0.98,0.972,1,1,245.909336119,1468,843,701,142,2,140
17669,8990,8864,0,0,2223,428791,204354,12402,0.982,1,1,1,114.915196005,392,282,195,87,0,87
17669,768,17280,2,55,289,236761,207591,12491,0.99,0.996,0.49295774647887325,1,48.202778894,0,48,1,47,0,47
17669,7639,10068,0,0,7713,983716,203981,12506,0.996,0.98,1,1,219.871972462,1443,849,728,121,0,121
17669,8719,8957,2,2,2297,435823,204220,12482,0.986,0.986,1,1,80.935621923,251,201,119,82,0,82
17669,8101,9855,0,0,1861,392867,204807,12485,1,0.986,1,0.998158379373849,88.495429679,389,249,154,95,0,95
17669,8349,9328,2,0,4941,702548,204183,12480,0.998,0.986,1,1,162.849315118,902,521,395,126,0,126
17669,8147,9778,0,0,25624,2792446,204184,12484,0.984,0.986,1,1,531.863960313,4133,2090,1917,173,2,171
17669,9065,8837,0,0,1606,366870,205338,12488,0.996,0.992,1,1,73.631354124,300,207,127,80,0,80
17669,9359,8474,0,2,4118,632513,205189,12493,1,0.988,1,0.9968808484092326,117.236331217,1112,605,489,116,2,114
17669,7488,10263,0,0,485,253368,204368,12424,1,1,1,1,95.780998297,155,131,63,68,0,68
17669,9871,7972,0,0,2169,423489,204472,12475,0.986,0.984,1,1,76.161565211,252,191,116,75,0,75
17669,8374,9320,2,0,5313,739131,203456,12493,0.994,0.982,1,1,174.839652198,974,567,439,128,2,126
17669,9245,8600,0,0,2780,485654,204475,12496,0.994,0.984,1,1,169.553401124,457,290,198,92,0,92
17669,7583,10147,0,0,5022,713094,205309,12489,0.998,0.972,1,1,143.685125439,984,516,405,111,0,111
17669,9806,7872,0,0,7743,985570,203753,12485,0.998,0.98,1,1,198.592440958,1510,833,695,138,0,138
17669,9851,8145,0,2,8462,1060077,203696,12492,0.998,0.97,1,1,205.925347558,1577,942,799,143,0,143
17669,8740,8993,0,2,1391,346348,205780,12495,0.992,0.976,1,1,113.178056796,174,150,80,70,1,69
17669,8497,9178,0,0,7454,977496,205391,12489,0.986,0.984,1,1,184.339762115,1130,615,495,120,0,120
17669,9052,8747,0,0,3096,517566,204883,12491,0.996,0.976,1,1,116.550909001,487,338,238,100,0,100
17669,9457,8220,0,0,6264,836507,204098,12478,0.996,0.982,1,1,151.359207876,1191,634,513,121,0,121
17669,9826,7866,0,0,4029,611906,205462,12501,0.994,0.988,1,1,116.923031831,744,417,313,104,0,104
17669,7995,10038,0,0,4319,640141,204002,12502,0.994,0.974,1,1,121.340357484,755,460,341,119,0,119
17669,9379,8309,0,0,2714,481016,204327,12510,1,0.982,1,0.9979360165118679,88.576774916,682,385,287,98,0,98
17669,8276,9403,0,0,2091,415216,203949,12491,1,0.986,1,0.9926686217008798,80.636163789,484,288,197,91,1,90
17669,8434,9255,0,0,2475,453726,203815,12496,1,0.982,1,0.9988066825775657,124.585531925,590,347,248,99,0,99
17669,8829,9116,0,0,1387,345196,205252,12498,0.986,0.978,1,1,92.066522011,140,124,59,65,0,65
17669,10378,7329,2,0,5609,771771,204277,12496,0.996,0.98,1,1,139.164270868,1054,605,487,118,0,118
17669,8120,9587,0,0,7967,1015576,212682,12502,0.998,0.986,1,1,183.260423919,1587,853,733,120,0,120
17669,8224,9778,0,2,3852,593530,204366,12430,0.998,0.998,1,1,108.334861115,826,492,377,115,2,113
17669,3840,14208,14,42,504,254653,203860,12488,0.982,0.982,0.5,1,50.535808947,0,57,5,52,5,47
17669,9229,8509,0,0,1654,370834,203982,12484,0.964,0.982,1,1,74.985226871,186,135,67,68,0,68
17669,8689,8998,0,2,3604,569344,204907,12500,0.998,0.97,1,1,103.777908045,652,370,268,102,0,102
17669,10526,7155,0,0,1656,371258,204044,12507,0.992,0.974,1,0.996996996996997,74.116223908,233,171,100,71,0,71
17669,8846,8902,2,0,2491,457007,204680,12481,1,0.98,1,0.995221027479092,110.26013141,585,351,252,99,0,99
17669,8408,9269,0,0,5018,711757,204770,12489,0.998,0.984,1,1,134.453282153,940,534,428,106,0,106
17669,8114,9939,0,0,4394,648337,204039,12487,0.998,0.972,1,1,119.095637341,794,463,343,120,0,120
17669,8683,9344,0,0,4536,671456,214046,12460,0.984,0.978,0.9982935153583617,1,134.100763513,622,379,275,104,1,103
17669,8042,9635,0,0,4296,646026,203877,12498,1,0.97,1,0.9957212713936431,165.212809128,1132,631,504,127,0,127
17669,9850,8148,0,2,6400,857424,204568,12491,0.998,0.98,1,1,184.954842053,1297,660,538,122,0,122
17669,8540,9168,0,0,1774,382808,204116,12489,0.998,0.982,1,1,75.772169514,233,198,120,78,0,78
17669,8964,8755,0,0,2783,484997,204323,12496,0.996,0.98,1,1,92.339820159,456,293,201,92,0,92
17669,10322,7424,2,0,2571,464255,204951,12486,0.992,0.982,1,1,88.261977447,417,271,184,87,0,87
17669,8464,9216,0,0,2244,433891,204454,12483,0.986,0.986,1,1,86.14959494,292,188,114,74,0,74
17669,7103,10914,2,0,3822,589229,204092,12486,1,0.978,1,0.9963820549927641,107.05793666,950,557,428,129,4,125
17669,8797,8922,0,2,1285,334135,204317,12492,1,0.97,0.98125,1,68.803854746,231,169,93,76,1,75
17669,8795,9079,0,2,2796,486449,203783,12490,0.998,0.982,1,1,92.341651557,456,300,207,93,0,93
17669,8432,9278,0,0,2637,470145,203811,12505,0.994,0.982,1,1,107.520441934,451,279,195,84,0,84
17669,8911,9129,0,0,1273,332485,203921,12492,0.998,0.988,1,1,61.128044314,186,131,70,61,0,61
17669,9336,8686,0,0,1521,358829,204142,12491,0.998,0.978,1,1,67.511115751,231,155,84,71,0,71
17669,8093,9943,0,3,3544,562071,204041,12501,0.992,0.98,1,1,126.05148292,614,372,267,105,0,105
17669,8082,9637,0,0,2121,418919,204207,12498,1,0.978,1,1,94.857694538,488,292,199,93,0,93
17669,8748,9022,0,0,828,291700,207949,12419,1,0.998,1,1,102.911842467,195,145,79,66,0,66
17669,8724,9331,0,0,1813,387258,204030,12479,0.996,0.976,1,1,92.458086929,268,193,117,76,0,76
17669,8492,9183,0,0,8391,1059985,207462,12484,0.998,0.978,1,1,238.777969851,1596,904,765,139,2,137
17669,7880,9795,0,0,1342,339843,203673,12498,0.994,0.978,1,1,63.069264433,157,150,82,68,0,68
17669,9624,8419,0,0,2728,479272,204220,12478,0.998,0.986,1,1,88.802009286,442,280,189,91,0,91
17669,9298,8408,0,0,4986,711085,205555,12406,0.974,1,1,1,129.338645499,942,571,443,128,0,128
17669,8200,9550,0,0,2037,414099,208066,12489,0.998,0.982,1,1,104.948986515,317,217,142,75,0,75
17669,8345,9473,0,0,3658,573521,203672,12480,0.98,0.98,1,1,109.133488148,492,305,213,92,0,92
17669,8984,8715,0,0,4683,677515,203751,12479,0.994,0.978,1,1,165.530083485,865,493,377,116,0,116
17669,9678,7996,0,0,4975,705870,204102,12500,0.994,0.984,1,1,128.676438948,876,525,396,129,0,129
17669,8723,8977,0,2,2538,460509,204444,12485,1,0.976,1,0.9988636363636364,180.516524554,616,360,264,96,0,96
17669,9125,8560,0,0,5255,736513,204752,12490,0.988,0.988,1,1,142.516308178,725,446,326,120,1,119
17669,9757,7918,0,0,13533,1573750,204456,12504,1,0.966,1,0.9985588470776622,284.021985617,4328,2086,1916,170,1,169
17669,8237,9441,0,0,3381,550520,209203,12490,0.99,0.972,0.9937888198757764,1,101.323513827,445,290,192,98,3,95
17669,9209,8842,0,0,4953,710041,204425,12488,1,0.962,1,0.9994606256742179,128.781309295,1234,757,619,138,1,137
17669,8842,8939,0,0,1837,390712,204903,12475,0.996,0.98,1,1,91.957779635,270,197,120,77,0,77
17669,9150,8545,3,0,3574,564633,203569,12503,0.994,0.99,1,1,121.500927429,623,386,287,99,2,97
17669,9158,8521,0,0,2304,437483,204737,12506,1,0.98,1,0.9974160206718347,108.170487417,541,325,233,92,0,92
17669,8439,9244,0,0,2417,447749,203605,12497,0.998,0.994,1,1,111.050150685,511,303,213,90,0,90
17669,8302,9388,0,0,3335,539780,203589,12503,0.998,0.99,1,1,147.15186678,554,364,262,102,1,101
17669,8117,9769,0,2,2367,443475,204433,12495,0.992,0.98,1,1,81.837265227,342,262,172,90,1,89
17669,8699,9172,2,2,4778,685522,203968,12494,0.986,0.99,1,1,189.069092645,636,416,309,107,1,106
17669,8946,9018,0,0,2174,425670,203568,12484,0.998,0.974,1,1,157.411938728,330,234,151,83,0,83
17669,8861,9134,0,0,1181,323839,204439,12504,1,0.98,1,0.9823943661971831,104.21205239,197,157,86,71,1,70
17669,8681,9169,2,0,2436,449848,204041,12438,0.998,1,1,1,108.806311211,652,377,283,94,1,93
17669,8461,9518,0,2,2120,418022,204360,12481,0.986,0.982,1,1,144.787587039,243,188,113,75,0,75
17669,8717,9088,0,0,1479,354178,205017,12477,0.998,0.988,1,1,93.039582828,213,149,78,71,0,71
17669,7213,10796,2,0,7317,946692,205751,12487,1,0.984,1,0.9864777849323889,195.303297711,2155,1097,948,149,3,146
17669,8258,9618,0,2,2851,492187,203770,12487,0.996,0.974,1,1,92.195606462,429,323,233,90,0,90
17669,384,17664,3,56,429,247316,204004,12499,0.996,0.974,0.48226950354609927,NaN,68.586604687,0,47,0,47,0,47
17669,8251,9444,2,0,1555,361218,203766,12493,0.998,0.976,1,1,70.424819512,203,174,104,70,1,69
17669,10314,7369,2,0,3092,517701,203873,12498,0.998,0.978,1,1,121.507884877,491,335,230,105,0,105
17669,9034,8665,0,0,1418,347699,203821,12484,0.992,0.982,1,1,73.947074425,200,146,77,69,0,69
17669,384,17664,2,54,429,247272,203984,12487,0.986,0.978,0.48226950354609927,NaN,56.522272155,0,47,0,47,0,47
17669,8816,9162,0,0,4105,617779,204280,12482,0.978,0.978,1,1,164.259528941,524,354,253,101,0,101
17669,9986,7785,0,0,1381,344446,203991,12475,0.994,0.982,1,1,117.967625447,203,138,71,67,1,66
17669,8515,9355,0,2,6848,893963,203673,12495,0.99,0.974,1,1,160.499330799,995,580,461,119,0,119
17669,8635,9072,2,0,2832,490471,203969,12493,0.992,0.99,0.9901185770750988,1,103.8064337,441,309,210,99,1,98
17669,9250,8450,0,0,3865,593897,203892,12494,0.998,0.97,1,1,141.054863,675,418,314,104,0,104
17669,8556,9208,0,0,1182,324020,204370,12482,1,0.986,1,0.9888059701492538,239.788372762,171,166,97,69,0,69
17669,8834,8963,0,0,1320,338788,205320,12495,0.992,0.984,1,1,79.554597387,169,142,76,66,0,66
17669,9328,8646,2,0,7030,913869,203748,12483,0.994,0.99,1,1,183.569491836,1367,744,608,136,0,136
17669,7997,9677,0,0,11472,1362854,203641,12493,0.996,0.978,1,1,245.562186731,2399,1190,1028,162,1,161
17669,8481,9211,0,1,5334,741269,204067,12481,0.99,0.982,1,1,143.327388141,703,474,355,119,0,119
17669,10108,7592,2,0,4495,658503,204717,12491,1,0.988,1,0.9994044073853484,168.529550873,1133,676,544,132,2,130
17669,7502,10185,0,0,1782,383957,203763,12431,0.998,1,1,1,69.004064011,415,317,222,95,1,94
17669,9329,8353,0,0,1698,375852,204314,12487,0.988,0.968,1,1,96.046396078,181,159,94,65,0,65
17669,8653,9121,0,0,951,300415,203970,12504,1,0.984,1,0.9950738916256158,75.467240475,144,122,58,64,1,63
17669,8137,9844,0,2,2391,446107,204400,12479,0.992,0.986,1,1,150.829592698,421,239,154,85,0,85
17669,8170,9746,0,0,4148,622604,203899,12491,0.996,0.974,1,1,181.237690165,772,425,312,113,0,113
17669,9211,8486,0,2,872,293134,204954,12398,0.998,1,1,1,76.268188481,210,150,84,66,0,66
17669,9195,8689,4,0,1429,347661,203871,12488,1,0.984,1,0.9974937343358395,107.009685531,279,194,119,75,1,74
17669,9488,8230,0,0,2841,491995,203998,12486,0.992,0.978,1,1,89.608150384,455,309,215,94,2,92
17669,9656,8033,0,2,5990,809535,204218,12483,0.99,0.982,1,1,165.535382114,890,492,381,111,1,110
17669,8832,8842,0,0,11878,1404512,204487,12496,1,0.984,1,0.9944177093358999,256.26389905,3562,1828,1633,195,0,195
17669,8761,8972,0,0,1353,343077,206183,12489,0.992,0.98,1,1,136.272137249,172,145,76,69,0,69
17669,8352,9366,0,0,1808,388426,204666,12497,0.994,0.992,1,1,96.965379517,382,222,145,77,0,77
17669,9738,7961,2,0,2431,449944,204356,12492,0.984,0.988,0.9973753280839895,1,160.792252352,298,211,126,85,0,85
17669,9011,8671,0,0,4381,647145,204272,12501,0.986,0.976,1,1,119.654396671,637,357,251,106,0,106
17669,9257,8648,0,0,2237,431539,204759,12485,1,0.976,0.9681274900398407,0.9985380116959064,78.972939223,459,316,221,95,4,91
17669,9712,8058,0,0,2959,505294,204448,12488,0.99,0.978,1,1,110.761522748,375,261,176,85,0,85
17669,9277,8747,0,0,3058,513550,203899,12492,1,0.99,1,0.9964080459770115,92.765279141,922,590,469,121,1,120
17669,8733,8966,0,0,2509,458073,204103,12495,0.986,0.992,1,1,83.488804259,364,256,166,90,3,87
17669,9099,8768,4,0,5343,745199,206448,12482,0.984,0.994,1,1,142.040803779,902,504,402,102,3,99
17669,9195,8535,0,0,1329,338572,204292,12485,0.998,0.98,1,1,93.236082313,178,143,80,63,0,63
17669,9778,7897,0,0,3898,596535,203812,12486,0.996,0.988,1,1,124.642483137,695,414,313,101,0,101
17669,9178,8498,0,0,13819,1598092,204104,12483,0.998,0.978,1,1,330.412518821,2947,1456,1300,156,0,156
17669,9315,8652,0,0,4577,666372,203822,12496,0.998,0.986,0.9986033519553073,1,129.500171003,818,488,374,114,0,114
17669,8976,8970,0,0,4474,657631,204237,12486,0.994,0.978,1,1,139.926032022,836,470,362,108,0,108
17669,9195,8827,2,0,57221,5981341,217359,12474,0.994,0.978,1,0.9998404679606487,1078.02473762,13037,5974,5764,210,4,206
17669,9057,8637,0,0,3096,521764,205900,12487,0.998,0.974,1,1,160.813167032,543,326,234,92,0,92
17669,9290,8517,0,0,5409,750606,203902,12409,0.99,1,1,1,135.939231952,1506,799,679,120,0,120
17669,8458,9378,0,0,4001,608527,204152,12482,0.994,0.976,1,1,109.614085707,680,433,325,108,0,108
17669,9376,8300,0,2,7261,935564,203843,12492,0.992,0.986,1,1,198.554784642,1436,760,622,138,1,137
17669,8038,9713,0,0,1407,348985,206080,12496,0.998,0.984,1,1,66.286988362,182,152,85,67,1,66
17669,8491,9347,0,2,2098,426032,214766,12504,1,0.974,1,0.9897510980966325,86.877433266,472,297,210,87,1,86
17669,8939,8735,0,0,1589,363925,203767,12485,0.998,0.988,1,1,74.091652327,221,173,103,70,0,70
17669,8519,9453,0,0,4541,663953,204935,12491,0.986,0.986,1,1,333.393476604,652,377,278,99,0,99
17669,8868,8814,0,0,1366,342373,204248,12489,1,0.964,1,1,61.74267077,222,196,124,72,0,72
17669,8864,8814,0,0,4810,689059,204048,12497,0.996,0.978,1,1,146.611313931,907,510,401,109,0,109
17669,9055,8681,2,0,1903,407616,216084,12487,0.992,0.982,1,1,76.912122617,292,198,121,77,1,76
17669,8174,9587,0,0,2605,467382,204563,12493,0.982,0.978,1,1,129.616408247,300,234,155,79,0,79
17669,8630,9191,0,0,1422,348938,205201,12402,1,1,1,0.9988290398126464,90.928739425,581,371,272,99,1,98
17669,9297,8638,0,2,5315,740730,204228,12488,0.994,0.968,1,1,217.671189457,980,568,446,122,2,120
17669,8623,9119,0,0,5760,792421,205472,12493,0.99,0.984,1,1,146.441828401,846,482,378,104,0,104
17669,9037,8706,2,0,1090,315803,205707,12488,1,0.982,1,0.9846743295019157,58.464805262,175,149,86,63,0,63
17669,8440,9382,0,0,1695,374844,203902,12492,0.99,0.984,1,1,145.766606268,194,146,79,67,0,67
17669,8868,8863,0,0,2363,448512,210267,12479,0.988,0.986,1,1,84.449552074,279,206,124,82,0,82
17669,8541,9133,0,0,2936,500549,204342,12498,0.994,0.978,1,1,116.945078011,464,323,232,91,0,91
17669,9713,7973,0,0,2629,469203,204348,12500,1,0.982,1,0.9889746416758545,86.018394495,617,383,289,94,1,93
17669,8435,9321,0,0,1851,392147,205674,12487,0.99,0.99,1,1,70.546195626,208,165,92,73,0,73
17669,9827,7857,0,0,2186,427409,205662,12488,0.994,0.976,1,1,107.161375878,366,228,151,77,0,77
17669,8570,9161,0,0,2461,452087,203808,12497,0.998,0.978,1,1,91.433139992,405,263,179,84,0,84
17669,8260,9423,0,2,6870,899466,204368,12479,0.99,0.986,1,1,231.800386304,949,595,462,133,1,132
17669,8743,8960,0,0,3063,512590,203755,12490,0.998,0.986,1,1,125.932957539,500,331,231,100,0,100
17669,8854,8829,0,0,2772,497377,217367,12474,0.998,0.986,1,1,130.913215865,503,274,181,93,0,93
17669,9792,7949,0,0,1284,336120,205875,12483,0.996,0.976,1,1,92.650419027,167,136,70,66,0,66
17669,9380,8648,0,0,2483,455916,204898,12497,0.984,0.986,1,1,103.07564641,310,213,132,81,0,81
17669,7623,10083,0,0,2142,420636,204270,12496,0.996,0.986,1,1,77.725988876,349,216,130,86,0,86
17669,9142,8545,0,0,4534,661915,204583,12495,0.996,0.982,1,1,126.911983637,826,488,380,108,0,108
17669,768,17280,4,58,431,260643,217177,12483,0.998,0.978,0.4825174825174825,1,48.946120721,0,48,0,48,1,47
17669,9417,8276,0,0,7697,982374,204366,12503,0.978,0.986,1,1,203.386568401,1122,655,536,119,1,118
17669,8881,9054,0,0,3368,544396,204234,12501,0.996,0.974,1,1,111.053339806,599,358,266,92,0,92
17669,9166,8520,0,2,4813,692000,204285,12495,0.996,0.98,0.9971671388101983,1,126.924373264,765,482,370,112,0,112
17669,9370,8304,0,2,1721,377689,204006,12487,0.996,0.992,1,1,71.584018175,294,243,164,79,0,79
17669,9645,8037,2,0,2460,452695,204227,12510,1,0.978,1,0.9974651457541192,85.201739913,549,345,239,106,1,105
17669,9777,7912,0,0,2518,460320,205454,12419,1,0.998,1,0.9982456140350877,108.381329965,775,473,365,108,0,108
17669,8014,9665,0,0,5781,787759,204799,12488,0.994,0.98,1,0.9993476842791911,147.314623036,1034,626,497,129,2,127
17669,8161,9820,2,0,2132,419713,204702,12499,0.994,0.992,1,0.998330550918197,80.839179348,408,281,190,91,1,90
17669,9009,8744,0,0,2079,424367,214712,12499,0.998,0.982,1,1,121.126595026,326,219,140,79,1,78
17669,9011,8707,0,0,1996,407487,205840,12506,0.998,0.978,1,1,81.989413599,305,206,120,86,0,86
17669,10019,7956,0,2,4892,701470,204203,12482,0.996,0.99,1,1,129.228748521,894,516,399,117,0,117
17669,9547,8163,0,0,3375,545401,204543,12484,0.994,0.982,1,0.9987893462469734,122.311673542,574,355,252,103,0,103
17669,7977,9703,0,0,1092,323149,213213,12492,1,0.984,1,0.99609375,74.771191599,180,143,75,68,1,67
17669,9031,8647,0,0,4568,664930,204522,12483,0.996,0.978,1,0.9991617770326907,148.789422121,809,495,383,112,1,111
17669,10329,7347,0,2,3941,602300,204464,12490,0.998,0.982,0.9745627980922098,1,110.908318408,697,425,321,104,4,100
17669,7873,9899,0,0,2758,482431,204750,12491,0.994,0.986,1,1,117.881980747,440,296,199,97,0,97
17669,9095,8606,2,0,7566,968566,203968,12484,0.99,0.98,1,1,188.957139486,1103,644,521,123,1,122
17669,8136,9892,0,2,4619,675291,204965,12417,0.988,1,1,1,155.750289422,892,510,391,119,1,118
17669,8551,9134,2,0,2234,429182,204223,12491,0.994,0.978,1,1,142.960735025,370,230,145,85,0,85
17669,9083,8625,0,0,1681,377103,207792,12492,0.998,0.984,1,1,109.521598312,223,185,109,76,0,76
17669,9871,7804,0,0,2492,455602,204650,12501,1,0.974,1,0.998805256869773,95.961346577,583,353,254,99,0,99
17669,8937,9001,0,0,1307,335480,203699,12502,0.998,0.974,1,1,151.788239104,178,133,65,68,1,67
17669,9408,8360,2,2,3455,552190,203659,12486,0.992,0.982,1,1,141.230180409,612,365,266,99,2,97
17669,8554,9142,0,0,1292,334303,204031,12423,0.994,0.998,1,1,69.305646807,231,171,99,72,0,72
17669,9928,7914,0,0,2188,425677,204371,12488,0.996,0.976,1,1,167.938279488,316,244,163,81,0,81
17669,8284,9437,2,0,2389,450612,210078,12500,1,0.988,1,0.9869960988296489,100.039463965,531,337,236,101,2,99
17669,8310,9739,0,0,3975,607558,203879,12502,0.998,0.984,1,1,149.938697682,736,409,298,111,2,109
17669,8779,9164,0,0,5078,715769,204257,12506,0.996,0.986,1,1,140.291969449,926,536,411,125,0,125
17669,8971,8982,2,0,7583,969461,204120,12500,0.994,0.988,1,1,213.954334958,1572,788,668,120,1,119
